UNPLANNED_DOWNTIME,PLANNED_DOWNTIME,TOTAL_COUNT,GOOD_COUNT,REJECTED_COUNT,RUNTIME,ACTUAL_CYCLE_TIME,TS
false,false,3,2,1,94,00:00:31.000,2025-04-14 10:27:19.945
false,true,24,22,2,0,00:00:00.000,2025-04-14 10:28:13.980
false,false,54,50,4,158,00:00:33.000,2025-04-14 10:29:26.034
false,false,68,64,4,601,00:00:33.000,2025-04-14 10:29:54.054
false,true,70,66,4,0,00:00:00.000,2025-04-14 10:30:02.061
false,true,74,70,4,0,00:00:00.000,2025-04-14 10:30:20.071
false,false,99,94,5,667,00:00:33.000,2025-04-14 10:31:32.120
false,false,114,109,5,1138,00:00:30.000,2025-04-14 10:32:02.146
false,false,115,110,5,1170,00:00:32.000,2025-04-14 10:32:04.146
false,false,136,131,5,32,00:00:32.000,2025-04-14 10:32:58.189
false,false,141,136,5,194,00:00:33.000,2025-04-14 10:33:08.200
false,true,156,151,5,0,00:00:00.000,2025-04-14 10:34:04.231
false,true,180,171,9,0,00:00:00.000,2025-04-14 10:35:12.281
false,false,178,170,8,691,00:00:33.000,2025-04-14 10:34:58.273
false,false,23,21,2,719,00:00:30.000,2025-04-14 10:27:59.976
false,false,13,12,1,403,00:00:31.000,2025-04-14 10:27:39.961
false,true,49,45,4,0,00:00:00.000,2025-04-14 10:29:06.022
false,false,61,57,4,377,00:00:31.000,2025-04-14 10:29:40.045
false,false,64,60,4,473,00:00:32.000,2025-04-14 10:29:46.047
false,true,70,66,4,0,00:00:00.000,2025-04-14 10:30:10.064
false,false,72,68,4,62,00:00:30.000,2025-04-14 10:30:14.068
false,false,88,84,4,315,00:00:30.000,2025-04-14 10:31:10.105
false,false,90,86,4,381,00:00:33.000,2025-04-14 10:31:14.110
false,false,103,98,5,789,00:00:30.000,2025-04-14 10:31:40.126
false,false,96,92,4,570,00:00:32.000,2025-04-14 10:31:26.116
false,false,83,79,4,161,00:00:33.000,2025-04-14 10:31:00.099
false,false,122,117,5,1394,00:00:33.000,2025-04-14 10:32:18.158
false,false,140,135,5,161,00:00:33.000,2025-04-14 10:33:06.198
false,false,143,138,5,258,00:00:33.000,2025-04-14 10:33:12.201
false,true,151,146,5,0,00:00:00.000,2025-04-14 10:33:44.222
false,false,177,169,8,658,00:00:30.000,2025-04-14 10:34:56.270
false,true,24,22,2,0,00:00:00.000,2025-04-14 10:28:09.978
false,false,57,53,4,251,00:00:32.000,2025-04-14 10:29:32.044
false,false,51,47,4,64,00:00:31.000,2025-04-14 10:29:20.029
false,false,46,42,4,696,00:00:33.000,2025-04-14 10:28:58.014
false,false,104,99,5,820,00:00:31.000,2025-04-14 10:31:42.127
false,false,97,93,4,603,00:00:33.000,2025-04-14 10:31:28.117
false,false,107,102,5,915,00:00:32.000,2025-04-14 10:31:48.134
false,false,110,105,5,1011,00:00:33.000,2025-04-14 10:31:54.139
false,false,123,118,5,1425,00:00:31.000,2025-04-14 10:32:20.161
false,false,128,123,5,1578,00:00:30.000,2025-04-14 10:32:30.170
false,false,131,126,5,1673,00:00:32.000,2025-04-14 10:32:36.177
false,false,132,127,5,1705,00:00:32.000,2025-04-14 10:32:38.180
false,false,135,130,5,1801,00:00:32.000,2025-04-14 10:32:44.183
false,true,135,130,5,0,00:00:00.000,2025-04-14 10:32:50.185
false,true,151,146,5,0,00:00:00.000,2025-04-14 10:33:46.224
false,false,175,168,7,595,00:00:31.000,2025-04-14 10:34:52.265
false,false,190,180,10,311,00:00:30.000,2025-04-14 10:35:34.299
false,false,1,1,0,33,00:00:33.000,2025-04-14 10:27:15.942
false,false,31,28,3,219,00:00:33.000,2025-04-14 10:28:27.992
false,false,26,24,2,65,00:00:33.000,2025-04-14 10:28:17.984
false,true,24,22,2,0,00:00:00.000,2025-04-14 10:28:07.978
false,true,24,22,2,0,00:00:00.000,2025-04-14 10:28:11.979
false,false,43,39,4,600,00:00:30.000,2025-04-14 10:28:52.011
false,false,65,61,4,505,00:00:32.000,2025-04-14 10:29:48.048
false,false,69,65,4,632,00:00:31.000,2025-04-14 10:29:56.056
false,true,70,66,4,0,00:00:00.000,2025-04-14 10:30:00.060
false,true,74,70,4,0,00:00:00.000,2025-04-14 10:30:22.072
false,false,92,88,4,443,00:00:31.000,2025-04-14 10:31:18.111
false,false,81,77,4,98,00:00:32.000,2025-04-14 10:30:56.096
false,false,108,103,5,947,00:00:32.000,2025-04-14 10:31:50.135
false,false,116,111,5,1200,00:00:30.000,2025-04-14 10:32:06.148
false,false,139,134,5,128,00:00:32.000,2025-04-14 10:33:04.196
false,false,142,137,5,225,00:00:31.000,2025-04-14 10:33:10.201
false,false,146,141,5,351,00:00:31.000,2025-04-14 10:33:18.205
false,true,147,142,5,0,00:00:00.000,2025-04-14 10:33:28.212
false,false,168,161,7,380,00:00:32.000,2025-04-14 10:34:38.258
false,false,189,179,10,281,00:00:31.000,2025-04-14 10:35:32.298
false,false,21,19,2,659,00:00:30.000,2025-04-14 10:27:55.974
false,false,6,5,1,185,00:00:31.000,2025-04-14 10:27:25.952
false,false,16,15,1,500,00:00:33.000,2025-04-14 10:27:45.965
false,false,34,31,3,316,00:00:33.000,2025-04-14 10:28:33.997
false,true,49,45,4,0,00:00:00.000,2025-04-14 10:29:14.026
false,true,70,66,4,0,00:00:00.000,2025-04-14 10:30:04.062
false,true,74,70,4,0,00:00:00.000,2025-04-14 10:30:28.078
false,true,78,74,4,0,00:00:00.000,2025-04-14 10:30:48.090
false,false,94,90,4,506,00:00:33.000,2025-04-14 10:31:22.115
false,false,124,119,5,1455,00:00:30.000,2025-04-14 10:32:22.162
false,false,125,120,5,1485,00:00:30.000,2025-04-14 10:32:24.163
false,false,113,108,5,1108,00:00:33.000,2025-04-14 10:32:00.145
false,true,135,130,5,0,00:00:00.000,2025-04-14 10:32:48.185
false,false,137,132,5,65,00:00:33.000,2025-04-14 10:33:00.192
false,false,149,144,5,63,00:00:32.000,2025-04-14 10:33:36.217
false,true,156,151,5,0,00:00:00.000,2025-04-14 10:34:12.237
false,false,172,165,7,502,00:00:30.000,2025-04-14 10:34:46.262
true,false,47,43,4,728,00:00:32.000,2025-04-14 10:29:00.017
true,false,56,52,4,219,00:00:31.000,2025-04-14 10:29:30.041
true,false,173,166,7,533,00:00:31.000,2025-04-14 10:34:48.264
false,false,158,152,6,65,00:00:32.000,2025-04-14 10:34:18.241
false,false,181,172,9,31,00:00:31.000,2025-04-14 10:35:16.284
false,false,182,173,9,62,00:00:31.000,2025-04-14 10:35:18.286
false,false,22,20,2,689,00:00:30.000,2025-04-14 10:27:57.975
false,false,42,38,4,570,00:00:33.000,2025-04-14 10:28:50.010
false,false,70,66,4,665,00:00:33.000,2025-04-14 10:29:58.059
false,false,71,67,4,32,00:00:32.000,2025-04-14 10:30:12.065
false,false,86,82,4,255,00:00:30.000,2025-04-14 10:31:06.104
false,false,80,76,4,66,00:00:33.000,2025-04-14 10:30:54.095
false,false,98,93,5,634,00:00:31.000,2025-04-14 10:31:30.118
false,true,135,130,5,0,00:00:00.000,2025-04-14 10:32:54.188
false,true,147,142,5,0,00:00:00.000,2025-04-14 10:33:32.215
false,false,163,156,7,219,00:00:30.000,2025-04-14 10:34:28.249
false,false,184,175,9,127,00:00:32.000,2025-04-14 10:35:22.288
false,true,180,171,9,0,00:00:00.000,2025-04-14 10:35:04.276
false,false,188,178,10,250,00:00:30.000,2025-04-14 10:35:30.297
false,false,191,181,10,341,00:00:30.000,2025-04-14 10:35:36.300
false,false,20,18,2,629,00:00:33.000,2025-04-14 10:27:53.973
false,true,49,45,4,0,00:00:00.000,2025-04-14 10:29:16.026
false,false,52,48,4,94,00:00:30.000,2025-04-14 10:29:22.031
false,true,70,66,4,0,00:00:00.000,2025-04-14 10:30:08.064
false,false,79,75,4,33,00:00:33.000,2025-04-14 10:30:52.095
false,false,100,95,5,698,00:00:31.000,2025-04-14 10:31:34.121
false,false,106,101,5,883,00:00:32.000,2025-04-14 10:31:46.132
false,false,150,145,5,93,00:00:30.000,2025-04-14 10:33:38.219
false,false,167,160,7,348,00:00:32.000,2025-04-14 10:34:36.256
false,false,162,156,6,189,00:00:30.000,2025-04-14 10:34:26.248
false,false,165,158,7,283,00:00:32.000,2025-04-14 10:34:32.253
false,false,174,167,7,564,00:00:31.000,2025-04-14 10:34:50.265
false,false,160,154,6,129,00:00:31.000,2025-04-14 10:34:22.245
false,false,180,171,9,752,00:00:31.000,2025-04-14 10:35:02.276
false,false,186,176,10,189,00:00:32.000,2025-04-14 10:35:26.291
false,true,24,22,2,0,00:00:00.000,2025-04-14 10:28:03.977
false,false,25,23,2,32,00:00:32.000,2025-04-14 10:28:15.982
false,false,44,40,4,630,00:00:30.000,2025-04-14 10:28:54.012
false,false,50,46,4,33,00:00:33.000,2025-04-14 10:29:18.027
false,true,78,74,4,0,00:00:00.000,2025-04-14 10:30:42.089
false,false,75,71,4,30,00:00:30.000,2025-04-14 10:30:32.082
false,false,76,72,4,62,00:00:32.000,2025-04-14 10:30:34.082
false,false,74,70,4,126,00:00:32.000,2025-04-14 10:30:18.071
false,false,95,91,4,538,00:00:32.000,2025-04-14 10:31:24.115
false,false,85,81,4,225,00:00:33.000,2025-04-14 10:31:04.102
false,false,119,114,5,1298,00:00:32.000,2025-04-14 10:32:12.153
false,true,135,130,5,0,00:00:00.000,2025-04-14 10:32:56.189
false,true,147,142,5,0,00:00:00.000,2025-04-14 10:33:22.207
false,true,147,142,5,0,00:00:00.000,2025-04-14 10:33:26.208
false,true,156,151,5,0,00:00:00.000,2025-04-14 10:34:08.235
false,false,169,162,7,411,00:00:31.000,2025-04-14 10:34:40.258
false,false,166,159,7,316,00:00:33.000,2025-04-14 10:34:34.253
false,false,176,168,8,628,00:00:33.000,2025-04-14 10:34:54.267
false,true,180,171,9,0,00:00:00.000,2025-04-14 10:35:08.279
false,false,193,183,10,406,00:00:32.000,2025-04-14 10:35:40.302
false,false,7,6,1,216,00:00:31.000,2025-04-14 10:27:27.954
false,false,59,55,4,314,00:00:30.000,2025-04-14 10:29:36.044
false,false,39,36,3,474,00:00:31.000,2025-04-14 10:28:44.003
false,false,66,62,4,536,00:00:31.000,2025-04-14 10:29:50.049
false,true,74,70,4,0,00:00:00.000,2025-04-14 10:30:30.079
false,true,78,74,4,0,00:00:00.000,2025-04-14 10:30:50.093
false,false,102,97,5,759,00:00:30.000,2025-04-14 10:31:38.126
false,false,117,112,5,1233,00:00:33.000,2025-04-14 10:32:08.150
false,false,127,122,5,1548,00:00:31.000,2025-04-14 10:32:28.167
false,false,133,128,5,1737,00:00:32.000,2025-04-14 10:32:40.181
false,true,151,146,5,0,00:00:00.000,2025-04-14 10:33:48.224
false,true,156,151,5,0,00:00:00.000,2025-04-14 10:34:10.235
false,false,161,155,6,159,00:00:30.000,2025-04-14 10:34:24.247
false,true,180,171,9,0,00:00:00.000,2025-04-14 10:35:10.280
false,false,8,7,1,249,00:00:33.000,2025-04-14 10:27:29.956
false,false,17,16,1,532,00:00:32.000,2025-04-14 10:27:47.968
false,false,30,28,2,186,00:00:30.000,2025-04-14 10:28:25.990
false,false,32,29,3,252,00:00:33.000,2025-04-14 10:28:29.994
false,false,45,41,4,663,00:00:33.000,2025-04-14 10:28:56.013
false,false,37,34,3,410,00:00:31.000,2025-04-14 10:28:40.001
false,true,74,70,4,0,00:00:00.000,2025-04-14 10:30:26.076
false,false,93,89,4,473,00:00:30.000,2025-04-14 10:31:20.112
false,false,84,80,4,192,00:00:31.000,2025-04-14 10:31:02.102
false,false,121,116,5,1361,00:00:31.000,2025-04-14 10:32:16.157
false,false,112,107,5,1075,00:00:33.000,2025-04-14 10:31:58.142
false,true,135,130,5,0,00:00:00.000,2025-04-14 10:32:52.186
false,true,151,146,5,0,00:00:00.000,2025-04-14 10:33:42.221
false,false,153,148,5,65,00:00:33.000,2025-04-14 10:33:56.227
false,false,147,142,5,381,00:00:30.000,2025-04-14 10:33:20.206
false,true,147,142,5,0,00:00:00.000,2025-04-14 10:33:24.207
false,false,171,164,7,472,00:00:30.000,2025-04-14 10:34:44.260
false,false,185,175,10,157,00:00:30.000,2025-04-14 10:35:24.290
false,false,9,8,1,280,00:00:31.000,2025-04-14 10:27:31.957
false,true,49,45,4,0,00:00:00.000,2025-04-14 10:29:10.022
false,false,58,54,4,284,00:00:33.000,2025-04-14 10:29:34.043
false,false,53,49,4,125,00:00:31.000,2025-04-14 10:29:24.032
false,false,49,45,4,790,00:00:30.000,2025-04-14 10:29:04.020
false,false,77,73,4,94,00:00:32.000,2025-04-14 10:30:36.083
false,true,78,74,4,0,00:00:00.000,2025-04-14 10:30:46.089
false,false,101,96,5,729,00:00:31.000,2025-04-14 10:31:36.123
false,false,82,78,4,128,00:00:30.000,2025-04-14 10:30:58.097
false,false,109,104,5,978,00:00:31.000,2025-04-14 10:31:52.136
false,false,120,115,5,1330,00:00:32.000,2025-04-14 10:32:14.154
false,false,183,174,9,95,00:00:33.000,2025-04-14 10:35:20.287
false,false,15,14,1,467,00:00:31.000,2025-04-14 10:27:43.963
false,false,27,25,2,96,00:00:31.000,2025-04-14 10:28:19.987
false,false,28,26,2,126,00:00:30.000,2025-04-14 10:28:21.987
false,false,40,37,3,505,00:00:31.000,2025-04-14 10:28:46.004
false,false,35,32,3,348,00:00:32.000,2025-04-14 10:28:35.999
false,false,87,83,4,285,00:00:30.000,2025-04-14 10:31:08.105
false,false,89,85,4,348,00:00:33.000,2025-04-14 10:31:12.108
false,false,105,100,5,851,00:00:31.000,2025-04-14 10:31:44.130
false,false,129,124,5,1611,00:00:33.000,2025-04-14 10:32:32.174
false,false,130,125,5,1641,00:00:30.000,2025-04-14 10:32:34.174
false,false,134,129,5,1769,00:00:32.000,2025-04-14 10:32:42.181
false,false,155,150,5,127,00:00:30.000,2025-04-14 10:34:00.229
false,true,156,151,5,0,00:00:00.000,2025-04-14 10:34:14.238
false,false,159,153,6,98,00:00:33.000,2025-04-14 10:34:20.242
false,false,179,170,9,721,00:00:30.000,2025-04-14 10:35:00.274
false,false,194,184,10,438,00:00:32.000,2025-04-14 10:35:42.303
false,false,24,22,2,752,00:00:33.000,2025-04-14 10:28:01.976
false,false,18,16,2,565,00:00:33.000,2025-04-14 10:27:49.969
false,false,19,17,2,596,00:00:31.000,2025-04-14 10:27:51.971
false,false,33,30,3,283,00:00:31.000,2025-04-14 10:28:31.997
false,true,49,45,4,0,00:00:00.000,2025-04-14 10:29:08.022
false,false,63,59,4,441,00:00:31.000,2025-04-14 10:29:44.047
false,false,36,33,3,379,00:00:31.000,2025-04-14 10:28:38.001
false,true,70,66,4,0,00:00:00.000,2025-04-14 10:30:06.062
false,false,73,69,4,94,00:00:32.000,2025-04-14 10:30:16.069
false,true,74,70,4,0,00:00:00.000,2025-04-14 10:30:24.073
false,false,118,113,5,1266,00:00:33.000,2025-04-14 10:32:10.151
false,true,135,130,5,0,00:00:00.000,2025-04-14 10:32:46.184
false,true,151,146,5,0,00:00:00.000,2025-04-14 10:33:50.225
false,true,151,146,5,0,00:00:00.000,2025-04-14 10:33:52.226
false,false,152,147,5,32,00:00:32.000,2025-04-14 10:33:54.227
false,false,148,143,5,31,00:00:31.000,2025-04-14 10:33:34.215
false,false,11,10,1,342,00:00:30.000,2025-04-14 10:27:35.960
false,false,12,11,1,372,00:00:30.000,2025-04-14 10:27:37.961
false,false,14,13,1,436,00:00:33.000,2025-04-14 10:27:41.962
false,false,29,27,2,156,00:00:30.000,2025-04-14 10:28:23.989
false,false,41,37,4,537,00:00:32.000,2025-04-14 10:28:48.007
false,true,49,45,4,0,00:00:00.000,2025-04-14 10:29:12.023
false,false,60,56,4,346,00:00:32.000,2025-04-14 10:29:38.044
false,false,67,63,4,568,00:00:32.000,2025-04-14 10:29:52.052
false,false,111,106,5,1042,00:00:31.000,2025-04-14 10:31:56.141
false,false,138,133,5,96,00:00:31.000,2025-04-14 10:33:02.195
false,false,151,146,5,125,00:00:32.000,2025-04-14 10:33:40.219
false,true,147,142,5,0,00:00:00.000,2025-04-14 10:33:30.213
false,true,156,151,5,0,00:00:00.000,2025-04-14 10:34:06.233
false,false,164,157,7,251,00:00:32.000,2025-04-14 10:34:30.250
false,false,157,152,5,33,00:00:33.000,2025-04-14 10:34:16.239
false,false,187,177,10,220,00:00:31.000,2025-04-14 10:35:28.293
false,false,5,4,1,154,00:00:30.000,2025-04-14 10:27:23.950
false,false,10,9,1,312,00:00:32.000,2025-04-14 10:27:33.959
false,true,24,22,2,0,00:00:00.000,2025-04-14 10:28:05.977
false,false,55,51,4,188,00:00:30.000,2025-04-14 10:29:28.037
false,false,48,44,4,760,00:00:32.000,2025-04-14 10:29:02.019
false,false,78,74,4,125,00:00:31.000,2025-04-14 10:30:38.086
false,true,78,74,4,0,00:00:00.000,2025-04-14 10:30:40.087
false,false,91,87,4,412,00:00:31.000,2025-04-14 10:31:16.111
false,false,144,139,5,290,00:00:32.000,2025-04-14 10:33:14.202
false,false,156,151,5,157,00:00:30.000,2025-04-14 10:34:02.230
false,false,170,163,7,442,00:00:31.000,2025-04-14 10:34:42.259
false,true,180,171,9,0,00:00:00.000,2025-04-14 10:35:14.283
false,false,2,2,0,63,00:00:30.000,2025-04-14 10:27:17.944
false,false,4,3,1,124,00:00:30.000,2025-04-14 10:27:21.948
false,false,62,58,4,410,00:00:33.000,2025-04-14 10:29:42.046
false,false,38,35,3,443,00:00:33.000,2025-04-14 10:28:42.001
false,true,78,74,4,0,00:00:00.000,2025-04-14 10:30:44.089
false,false,126,121,5,1517,00:00:32.000,2025-04-14 10:32:26.165
false,false,154,149,5,97,00:00:32.000,2025-04-14 10:33:58.228
false,false,145,140,5,320,00:00:30.000,2025-04-14 10:33:16.203
false,true,180,171,9,0,00:00:00.000,2025-04-14 10:35:06.278
false,false,192,182,10,374,00:00:33.000,2025-04-14 10:35:38.301
false,false,195,185,10,468,00:00:30.000,2025-04-14 10:35:44.306
false,false,201,190,11,657,00:00:31.000,2025-04-14 10:35:56.318
false,false,203,192,11,717,00:00:30.000,2025-04-14 10:36:00.319
false,false,207,196,11,131,00:00:32.000,2025-04-14 10:36:20.337
false,false,209,198,11,194,00:00:32.000,2025-04-14 10:36:24.341
false,true,252,235,17,0,00:00:00.000,2025-04-14 10:37:56.422
false,false,237,223,14,1071,00:00:30.000,2025-04-14 10:37:20.387
false,false,252,235,17,1542,00:00:33.000,2025-04-14 10:37:50.416
false,false,260,242,18,253,00:00:31.000,2025-04-14 10:38:18.438
false,false,263,244,19,347,00:00:32.000,2025-04-14 10:38:24.442
false,false,296,274,22,796,00:00:33.000,2025-04-14 10:39:42.503
false,false,302,279,23,985,00:00:33.000,2025-04-14 10:39:54.510
false,true,304,281,23,0,00:00:00.000,2025-04-14 10:40:02.517
false,false,309,286,23,157,00:00:31.000,2025-04-14 10:40:20.531
false,false,310,287,23,190,00:00:33.000,2025-04-14 10:40:22.532
false,false,347,323,24,254,00:00:31.000,2025-04-14 10:42:00.606
false,false,352,328,24,63,00:00:33.000,2025-04-14 10:42:22.619
false,false,360,336,24,315,00:00:31.000,2025-04-14 10:42:38.627
false,false,378,352,26,191,00:00:31.000,2025-04-14 10:43:26.656
false,false,392,366,26,32,00:00:32.000,2025-04-14 10:44:06.688
false,true,400,373,27,0,00:00:00.000,2025-04-14 10:44:34.708
false,false,405,378,27,164,00:00:33.000,2025-04-14 10:44:44.716
false,false,445,418,27,1005,00:00:33.000,2025-04-14 10:46:16.789
false,true,447,420,27,0,00:00:00.000,2025-04-14 10:46:24.795
false,false,443,416,27,942,00:00:30.000,2025-04-14 10:46:12.784
false,false,459,432,27,377,00:00:32.000,2025-04-14 10:46:56.813
false,false,472,444,28,784,00:00:31.000,2025-04-14 10:47:22.833
false,false,482,453,29,60,00:00:30.000,2025-04-14 10:48:06.859
false,true,508,477,31,0,00:00:00.000,2025-04-14 10:49:00.903
false,false,524,491,33,505,00:00:31.000,2025-04-14 10:49:42.932
false,false,530,497,33,690,00:00:30.000,2025-04-14 10:49:54.940
false,true,533,500,33,0,00:00:00.000,2025-04-14 10:50:12.959
false,false,566,532,34,1044,00:00:32.000,2025-04-14 10:51:19.006
false,false,581,546,35,1520,00:00:33.000,2025-04-14 10:51:49.033
false,false,670,632,38,222,00:00:30.000,2025-04-14 10:55:47.193
false,false,229,215,14,825,00:00:30.000,2025-04-14 10:37:04.376
false,true,252,235,17,0,00:00:00.000,2025-04-14 10:38:00.426
false,false,294,272,22,732,00:00:31.000,2025-04-14 10:39:38.499
false,true,304,281,23,0,00:00:00.000,2025-04-14 10:40:06.521
false,false,349,325,24,319,00:00:32.000,2025-04-14 10:42:04.607
false,false,375,349,26,97,00:00:33.000,2025-04-14 10:43:20.653
false,false,376,350,26,130,00:00:33.000,2025-04-14 10:43:22.654
false,true,400,373,27,0,00:00:00.000,2025-04-14 10:44:24.700
false,false,402,375,27,66,00:00:33.000,2025-04-14 10:44:38.711
false,false,441,414,27,881,00:00:33.000,2025-04-14 10:46:08.782
false,false,442,415,27,912,00:00:31.000,2025-04-14 10:46:10.783
false,true,447,420,27,0,00:00:00.000,2025-04-14 10:46:26.797
false,false,461,434,27,439,00:00:30.000,2025-04-14 10:47:00.814
false,false,464,437,27,533,00:00:33.000,2025-04-14 10:47:06.818
false,false,477,448,29,93,00:00:33.000,2025-04-14 10:47:44.849
false,false,507,476,31,854,00:00:31.000,2025-04-14 10:48:56.901
false,true,508,477,31,0,00:00:00.000,2025-04-14 10:49:08.911
false,false,521,488,33,413,00:00:32.000,2025-04-14 10:49:36.927
false,false,531,498,33,723,00:00:33.000,2025-04-14 10:49:56.940
false,false,553,519,34,631,00:00:31.000,2025-04-14 10:50:52.986
false,false,560,526,34,853,00:00:30.000,2025-04-14 10:51:06.996
false,false,577,542,35,1393,00:00:33.000,2025-04-14 10:51:41.029
false,false,673,635,38,317,00:00:33.000,2025-04-14 10:55:53.196
false,false,679,641,38,508,00:00:33.000,2025-04-14 10:56:05.204
false,false,687,649,38,757,00:00:32.000,2025-04-14 10:56:21.215
false,false,202,191,11,687,00:00:30.000,2025-04-14 10:35:58.318
false,true,203,192,11,0,00:00:00.000,2025-04-14 10:36:06.323
false,false,213,200,13,323,00:00:32.000,2025-04-14 10:36:32.351
false,false,222,208,14,602,00:00:33.000,2025-04-14 10:36:50.367
false,false,226,212,14,729,00:00:31.000,2025-04-14 10:36:58.374
false,false,245,230,15,1323,00:00:31.000,2025-04-14 10:37:36.403
false,false,283,262,21,383,00:00:33.000,2025-04-14 10:39:16.481
false,false,287,266,21,507,00:00:30.000,2025-04-14 10:39:24.487
false,false,313,290,23,286,00:00:32.000,2025-04-14 10:40:28.536
false,true,304,281,23,0,00:00:00.000,2025-04-14 10:40:10.524
false,false,326,303,23,153,00:00:33.000,2025-04-14 10:41:06.560
false,false,332,309,23,345,00:00:33.000,2025-04-14 10:41:18.571
false,false,339,315,24,571,00:00:32.000,2025-04-14 10:41:32.581
false,false,348,324,24,287,00:00:33.000,2025-04-14 10:42:02.607
false,false,362,338,24,377,00:00:30.000,2025-04-14 10:42:42.630
false,false,355,331,24,156,00:00:31.000,2025-04-14 10:42:28.622
false,false,396,369,27,160,00:00:31.000,2025-04-14 10:44:14.694
false,true,391,365,26,0,00:00:00.000,2025-04-14 10:44:00.685
false,false,387,361,26,469,00:00:31.000,2025-04-14 10:43:44.669
false,true,400,373,27,0,00:00:00.000,2025-04-14 10:44:30.706
false,false,413,386,27,413,00:00:31.000,2025-04-14 10:45:00.728
false,false,426,399,27,411,00:00:30.000,2025-04-14 10:45:38.761
false,false,424,397,27,348,00:00:32.000,2025-04-14 10:45:34.757
false,true,508,477,31,0,00:00:00.000,2025-04-14 10:49:10.912
false,true,533,500,33,0,00:00:00.000,2025-04-14 10:50:06.952
false,false,534,501,33,31,00:00:31.000,2025-04-14 10:50:14.959
false,false,540,507,33,222,00:00:31.000,2025-04-14 10:50:26.966
false,false,558,524,34,790,00:00:32.000,2025-04-14 10:51:02.995
false,true,663,626,37,0,00:00:00.000,2025-04-14 10:55:27.186
false,false,680,642,38,538,00:00:30.000,2025-04-14 10:56:07.204
false,false,682,644,38,601,00:00:33.000,2025-04-14 10:56:11.208
false,true,203,192,11,0,00:00:00.000,2025-04-14 10:36:04.321
false,false,221,207,14,569,00:00:30.000,2025-04-14 10:36:48.366
false,false,223,209,14,635,00:00:33.000,2025-04-14 10:36:52.368
false,false,251,234,17,1509,00:00:32.000,2025-04-14 10:37:48.414
false,false,270,251,19,563,00:00:33.000,2025-04-14 10:38:38.455
false,true,271,252,19,0,00:00:00.000,2025-04-14 10:38:48.462
false,false,312,289,23,254,00:00:33.000,2025-04-14 10:40:26.535
false,false,317,294,23,412,00:00:32.000,2025-04-14 10:40:36.542
false,false,321,298,23,535,00:00:30.000,2025-04-14 10:40:44.550
false,true,339,315,24,0,00:00:00.000,2025-04-14 10:41:40.585
false,false,351,327,24,30,00:00:30.000,2025-04-14 10:42:20.618
false,true,372,346,26,0,00:00:00.000,2025-04-14 10:43:10.646
false,true,372,346,26,0,00:00:00.000,2025-04-14 10:43:14.649
false,false,393,367,26,64,00:00:32.000,2025-04-14 10:44:08.689
false,true,391,365,26,0,00:00:00.000,2025-04-14 10:44:02.686
false,false,384,358,26,376,00:00:32.000,2025-04-14 10:43:38.664
false,true,372,346,26,0,00:00:00.000,2025-04-14 10:43:04.644
false,false,407,380,27,227,00:00:31.000,2025-04-14 10:44:48.720
false,true,413,386,27,0,00:00:00.000,2025-04-14 10:45:04.731
false,false,425,398,27,381,00:00:33.000,2025-04-14 10:45:36.760
false,false,463,436,27,500,00:00:30.000,2025-04-14 10:47:04.816
false,true,474,446,28,0,00:00:00.000,2025-04-14 10:47:34.842
false,true,480,451,29,0,00:00:00.000,2025-04-14 10:47:52.851
false,false,496,467,29,507,00:00:30.000,2025-04-14 10:48:34.883
false,false,505,475,30,790,00:00:30.000,2025-04-14 10:48:52.898
false,false,506,475,31,823,00:00:33.000,2025-04-14 10:48:54.900
false,false,512,480,32,127,00:00:32.000,2025-04-14 10:49:18.915
false,false,513,481,32,160,00:00:33.000,2025-04-14 10:49:20.916
false,false,537,504,33,127,00:00:33.000,2025-04-14 10:50:20.963
false,false,549,516,33,504,00:00:30.000,2025-04-14 10:50:44.979
false,false,663,626,37,1174,00:00:33.000,2025-04-14 10:55:21.179
false,false,665,627,38,61,00:00:30.000,2025-04-14 10:55:37.190
false,false,684,646,38,665,00:00:33.000,2025-04-14 10:56:15.212
false,true,203,192,11,0,00:00:00.000,2025-04-14 10:36:02.320
false,false,232,218,14,917,00:00:31.000,2025-04-14 10:37:10.380
false,false,233,219,14,948,00:00:31.000,2025-04-14 10:37:12.380
false,false,224,210,14,666,00:00:31.000,2025-04-14 10:36:54.369
false,false,250,233,17,1477,00:00:31.000,2025-04-14 10:37:46.411
false,false,256,238,18,127,00:00:30.000,2025-04-14 10:38:10.434
false,false,276,256,20,158,00:00:33.000,2025-04-14 10:39:02.471
false,false,280,260,20,285,00:00:32.000,2025-04-14 10:39:10.473
false,false,327,304,23,185,00:00:32.000,2025-04-14 10:41:08.562
false,false,329,306,23,248,00:00:33.000,2025-04-14 10:41:12.565
false,false,346,322,24,223,00:00:32.000,2025-04-14 10:41:58.603
false,false,340,316,24,33,00:00:33.000,2025-04-14 10:41:46.591
false,false,365,340,25,473,00:00:31.000,2025-04-14 10:42:48.637
false,true,372,346,26,0,00:00:00.000,2025-04-14 10:43:12.646
false,false,394,367,27,96,00:00:32.000,2025-04-14 10:44:10.690
false,false,395,368,27,129,00:00:33.000,2025-04-14 10:44:12.691
false,false,383,357,26,344,00:00:30.000,2025-04-14 10:43:36.663
false,false,386,360,26,438,00:00:31.000,2025-04-14 10:43:42.667
false,false,401,374,27,33,00:00:33.000,2025-04-14 10:44:36.710
false,false,427,400,27,441,00:00:30.000,2025-04-14 10:45:40.762
false,false,423,396,27,316,00:00:31.000,2025-04-14 10:45:32.757
false,false,440,413,27,848,00:00:31.000,2025-04-14 10:46:06.781
false,true,447,420,27,0,00:00:00.000,2025-04-14 10:46:30.798
false,false,448,421,27,33,00:00:33.000,2025-04-14 10:46:34.800
false,false,455,428,27,251,00:00:30.000,2025-04-14 10:46:48.807
false,false,466,439,27,595,00:00:30.000,2025-04-14 10:47:10.821
false,true,474,446,28,0,00:00:00.000,2025-04-14 10:47:28.837
false,false,509,478,31,32,00:00:32.000,2025-04-14 10:49:12.913
false,false,519,487,32,350,00:00:31.000,2025-04-14 10:49:32.924
false,true,533,500,33,0,00:00:00.000,2025-04-14 10:50:04.949
false,true,533,500,33,0,00:00:00.000,2025-04-14 10:50:10.956
false,false,580,545,35,1487,00:00:31.000,2025-04-14 10:51:47.033
false,false,678,640,38,475,00:00:31.000,2025-04-14 10:56:03.204
false,false,686,648,38,725,00:00:30.000,2025-04-14 10:56:19.213
false,false,208,197,11,162,00:00:31.000,2025-04-14 10:36:22.338
false,false,211,199,12,258,00:00:31.000,2025-04-14 10:36:28.345
false,false,218,205,13,477,00:00:30.000,2025-04-14 10:36:42.360
false,false,247,231,16,1386,00:00:31.000,2025-04-14 10:37:40.407
false,false,244,229,15,1292,00:00:32.000,2025-04-14 10:37:34.401
false,true,271,252,19,0,00:00:00.000,2025-04-14 10:38:44.458
false,false,315,292,23,349,00:00:32.000,2025-04-14 10:40:32.541
false,false,336,312,24,474,00:00:33.000,2025-04-14 10:41:26.576
false,true,321,298,23,0,00:00:00.000,2025-04-14 10:40:56.556
false,true,350,326,24,0,00:00:00.000,2025-04-14 10:42:18.615
false,false,367,342,25,535,00:00:31.000,2025-04-14 10:42:52.640
false,true,391,365,26,0,00:00:00.000,2025-04-14 10:44:04.686
false,true,400,373,27,0,00:00:00.000,2025-04-14 10:44:28.704
false,false,436,409,27,722,00:00:30.000,2025-04-14 10:45:58.774
false,false,444,417,27,972,00:00:30.000,2025-04-14 10:46:14.785
false,false,470,443,27,723,00:00:33.000,2025-04-14 10:47:18.829
false,true,508,477,31,0,00:00:00.000,2025-04-14 10:49:04.905
false,false,515,483,32,222,00:00:30.000,2025-04-14 10:49:24.919
false,false,525,492,33,535,00:00:30.000,2025-04-14 10:49:44.933
false,false,535,502,33,61,00:00:30.000,2025-04-14 10:50:16.962
false,false,542,509,33,287,00:00:32.000,2025-04-14 10:50:30.967
false,false,547,514,33,441,00:00:30.000,2025-04-14 10:50:40.974
false,false,561,527,34,883,00:00:30.000,2025-04-14 10:51:08.998
false,false,661,624,37,1109,00:00:32.000,2025-04-14 10:55:17.179
false,true,663,626,37,0,00:00:00.000,2025-04-14 10:55:33.189
false,false,206,195,11,99,00:00:33.000,2025-04-14 10:36:18.336
false,false,219,206,13,507,00:00:30.000,2025-04-14 10:36:44.362
false,false,234,220,14,981,00:00:33.000,2025-04-14 10:37:14.383
false,false,249,232,17,1446,00:00:30.000,2025-04-14 10:37:44.410
false,false,242,227,15,1227,00:00:31.000,2025-04-14 10:37:30.399
false,true,252,235,17,0,00:00:00.000,2025-04-14 10:37:54.421
false,false,258,240,18,192,00:00:32.000,2025-04-14 10:38:14.436
false,false,273,254,19,65,00:00:33.000,2025-04-14 10:38:56.466
false,false,288,267,21,540,00:00:33.000,2025-04-14 10:39:26.489
false,false,291,270,21,637,00:00:33.000,2025-04-14 10:39:32.494
false,false,297,275,22,827,00:00:31.000,2025-04-14 10:39:44.503
false,false,301,278,23,952,00:00:32.000,2025-04-14 10:39:52.509
false,false,320,297,23,505,00:00:30.000,2025-04-14 10:40:42.548
false,false,341,317,24,64,00:00:31.000,2025-04-14 10:41:48.592
false,true,372,346,26,0,00:00:00.000,2025-04-14 10:43:06.645
false,true,391,365,26,0,00:00:00.000,2025-04-14 10:43:54.679
false,false,369,344,25,598,00:00:33.000,2025-04-14 10:42:56.641
false,false,399,372,27,254,00:00:32.000,2025-04-14 10:44:20.697
false,false,400,373,27,286,00:00:32.000,2025-04-14 10:44:22.698
false,false,412,385,27,382,00:00:32.000,2025-04-14 10:44:58.726
false,true,413,386,27,0,00:00:00.000,2025-04-14 10:45:02.730
false,false,420,393,27,220,00:00:33.000,2025-04-14 10:45:26.749
false,false,446,419,27,1037,00:00:32.000,2025-04-14 10:46:18.791
false,true,480,451,29,0,00:00:00.000,2025-04-14 10:47:58.855
false,false,527,494,33,598,00:00:32.000,2025-04-14 10:49:48.936
false,false,529,496,33,660,00:00:30.000,2025-04-14 10:49:52.939
false,false,543,510,33,317,00:00:30.000,2025-04-14 10:50:32.968
false,false,551,517,34,567,00:00:30.000,2025-04-14 10:50:48.980
false,false,554,520,34,664,00:00:33.000,2025-04-14 10:50:54.989
false,false,556,522,34,726,00:00:31.000,2025-04-14 10:50:58.993
false,false,568,534,34,1110,00:00:33.000,2025-04-14 10:51:23.012
false,false,572,538,34,1235,00:00:30.000,2025-04-14 10:51:31.018
false,false,668,630,38,159,00:00:33.000,2025-04-14 10:55:43.192
false,false,676,638,38,411,00:00:32.000,2025-04-14 10:55:59.202
false,false,685,647,38,695,00:00:30.000,2025-04-14 10:56:17.213
false,false,230,216,14,855,00:00:30.000,2025-04-14 10:37:06.377
false,false,253,236,17,32,00:00:32.000,2025-04-14 10:38:04.429
false,false,238,224,14,1102,00:00:31.000,2025-04-14 10:37:22.389
false,false,262,244,18,315,00:00:32.000,2025-04-14 10:38:22.439
false,false,304,281,23,1050,00:00:33.000,2025-04-14 10:39:58.513
false,false,308,285,23,126,00:00:33.000,2025-04-14 10:40:18.530
false,false,306,283,23,61,00:00:31.000,2025-04-14 10:40:14.527
false,false,328,305,23,215,00:00:30.000,2025-04-14 10:41:10.563
false,false,337,313,24,506,00:00:32.000,2025-04-14 10:41:28.577
false,false,368,343,25,565,00:00:30.000,2025-04-14 10:42:54.641
false,false,404,377,27,131,00:00:32.000,2025-04-14 10:44:42.714
false,false,447,420,27,1068,00:00:31.000,2025-04-14 10:46:20.792
false,false,460,433,27,409,00:00:32.000,2025-04-14 10:46:58.814
false,false,495,466,29,477,00:00:31.000,2025-04-14 10:48:32.882
false,false,501,471,30,667,00:00:31.000,2025-04-14 10:48:44.892
false,false,508,477,31,885,00:00:31.000,2025-04-14 10:48:58.901
false,false,514,482,32,192,00:00:32.000,2025-04-14 10:49:22.918
false,false,528,495,33,630,00:00:32.000,2025-04-14 10:49:50.937
false,false,536,503,33,94,00:00:33.000,2025-04-14 10:50:18.962
false,false,565,531,34,1012,00:00:32.000,2025-04-14 10:51:17.006
false,false,216,203,13,416,00:00:31.000,2025-04-14 10:36:38.356
false,false,248,231,17,1416,00:00:30.000,2025-04-14 10:37:42.408
false,false,254,236,18,65,00:00:33.000,2025-04-14 10:38:06.430
false,false,261,243,18,283,00:00:30.000,2025-04-14 10:38:20.439
false,true,271,252,19,0,00:00:00.000,2025-04-14 10:38:52.464
false,false,277,257,20,188,00:00:30.000,2025-04-14 10:39:04.472
false,false,290,269,21,604,00:00:31.000,2025-04-14 10:39:30.493
false,false,311,288,23,221,00:00:31.000,2025-04-14 10:40:24.533
false,true,321,298,23,0,00:00:00.000,2025-04-14 10:40:50.554
false,true,321,298,23,0,00:00:00.000,2025-04-14 10:40:52.554
false,false,318,295,23,445,00:00:33.000,2025-04-14 10:40:38.545
false,true,339,315,24,0,00:00:00.000,2025-04-14 10:41:42.588
false,true,350,326,24,0,00:00:00.000,2025-04-14 10:42:16.615
false,false,342,318,24,95,00:00:31.000,2025-04-14 10:41:50.595
false,false,359,335,24,284,00:00:31.000,2025-04-14 10:42:36.626
false,true,350,326,24,0,00:00:00.000,2025-04-14 10:42:10.610
false,true,372,346,26,0,00:00:00.000,2025-04-14 10:43:08.646
false,false,390,364,26,562,00:00:32.000,2025-04-14 10:43:50.674
false,false,370,345,25,631,00:00:33.000,2025-04-14 10:42:58.642
false,false,408,381,27,258,00:00:31.000,2025-04-14 10:44:50.722
false,false,433,406,27,631,00:00:30.000,2025-04-14 10:45:52.770
false,false,438,411,27,786,00:00:32.000,2025-04-14 10:46:02.777
false,true,447,420,27,0,00:00:00.000,2025-04-14 10:46:22.792
false,false,453,426,27,189,00:00:31.000,2025-04-14 10:46:44.803
false,false,462,435,27,470,00:00:31.000,2025-04-14 10:47:02.816
false,false,465,438,27,565,00:00:32.000,2025-04-14 10:47:08.820
false,false,468,441,27,660,00:00:32.000,2025-04-14 10:47:14.826
false,false,471,444,27,753,00:00:30.000,2025-04-14 10:47:20.831
false,false,493,464,29,414,00:00:33.000,2025-04-14 10:48:28.879
false,false,503,473,30,729,00:00:32.000,2025-04-14 10:48:48.895
false,false,532,499,33,755,00:00:32.000,2025-04-14 10:49:58.943
false,false,541,508,33,255,00:00:33.000,2025-04-14 10:50:28.967
false,false,544,511,33,348,00:00:31.000,2025-04-14 10:50:34.969
false,false,582,547,35,1553,00:00:33.000,2025-04-14 10:51:51.035
false,false,583,548,35,1584,00:00:31.000,2025-04-14 10:51:53.035
false,false,664,626,38,31,00:00:31.000,2025-04-14 10:55:35.190
false,false,240,226,14,1166,00:00:33.000,2025-04-14 10:37:26.394
false,false,236,222,14,1041,00:00:30.000,2025-04-14 10:37:18.386
false,false,257,239,18,160,00:00:33.000,2025-04-14 10:38:12.435
false,false,289,268,21,573,00:00:33.000,2025-04-14 10:39:28.489
false,false,285,264,21,445,00:00:31.000,2025-04-14 10:39:20.484
false,false,293,271,22,701,00:00:33.000,2025-04-14 10:39:36.497
false,false,334,311,23,408,00:00:31.000,2025-04-14 10:41:22.575
false,true,339,315,24,0,00:00:00.000,2025-04-14 10:41:34.581
false,false,324,301,23,90,00:00:30.000,2025-04-14 10:41:02.559
false,true,350,326,24,0,00:00:00.000,2025-04-14 10:42:12.613
false,false,358,334,24,253,00:00:32.000,2025-04-14 10:42:34.626
false,false,380,354,26,252,00:00:31.000,2025-04-14 10:43:30.660
false,false,389,363,26,530,00:00:31.000,2025-04-14 10:43:48.672
false,false,409,382,27,288,00:00:30.000,2025-04-14 10:44:52.723
false,true,400,373,27,0,00:00:00.000,2025-04-14 10:44:26.702
false,false,439,412,27,817,00:00:31.000,2025-04-14 10:46:04.779
false,false,451,424,27,125,00:00:30.000,2025-04-14 10:46:40.802
false,false,454,427,27,221,00:00:32.000,2025-04-14 10:46:46.806
false,false,456,429,27,284,00:00:33.000,2025-04-14 10:46:50.809
false,false,458,431,27,345,00:00:30.000,2025-04-14 10:46:54.813
false,true,480,451,29,0,00:00:00.000,2025-04-14 10:48:00.856
false,false,476,448,28,60,00:00:30.000,2025-04-14 10:47:42.849
false,false,498,469,29,570,00:00:31.000,2025-04-14 10:48:38.885
false,false,520,488,32,381,00:00:31.000,2025-04-14 10:49:34.925
false,true,533,500,33,0,00:00:00.000,2025-04-14 10:50:02.947
false,true,533,500,33,0,00:00:00.000,2025-04-14 10:50:08.954
false,false,548,515,33,474,00:00:33.000,2025-04-14 10:50:42.977
false,false,667,629,38,126,00:00:32.000,2025-04-14 10:55:41.192
false,false,671,633,38,254,00:00:32.000,2025-04-14 10:55:49.193
false,false,672,634,38,284,00:00:30.000,2025-04-14 10:55:51.194
false,false,196,186,10,500,00:00:32.000,2025-04-14 10:35:46.308
false,false,198,188,10,564,00:00:31.000,2025-04-14 10:35:50.312
false,false,210,198,12,227,00:00:33.000,2025-04-14 10:36:26.343
false,false,217,204,13,447,00:00:31.000,2025-04-14 10:36:40.357
false,false,225,211,14,698,00:00:32.000,2025-04-14 10:36:56.371
false,false,246,231,15,1355,00:00:32.000,2025-04-14 10:37:38.405
false,false,239,225,14,1133,00:00:31.000,2025-04-14 10:37:24.392
false,true,252,235,17,0,00:00:00.000,2025-04-14 10:37:52.418
false,false,264,245,19,377,00:00:30.000,2025-04-14 10:38:26.443
false,false,269,250,19,530,00:00:30.000,2025-04-14 10:38:36.453
false,true,271,252,19,0,00:00:00.000,2025-04-14 10:38:46.460
false,false,286,265,21,477,00:00:32.000,2025-04-14 10:39:22.485
false,false,303,280,23,1017,00:00:32.000,2025-04-14 10:39:56.510
false,false,323,300,23,60,00:00:30.000,2025-04-14 10:41:00.558
false,false,354,330,24,125,00:00:30.000,2025-04-14 10:42:26.621
false,false,356,332,24,189,00:00:33.000,2025-04-14 10:42:30.623
false,false,357,333,24,221,00:00:32.000,2025-04-14 10:42:32.625
false,false,382,356,26,314,00:00:30.000,2025-04-14 10:43:34.661
false,false,406,379,27,196,00:00:32.000,2025-04-14 10:44:46.718
false,true,400,373,27,0,00:00:00.000,2025-04-14 10:44:32.708
false,true,413,386,27,0,00:00:00.000,2025-04-14 10:45:06.733
false,false,421,394,27,253,00:00:33.000,2025-04-14 10:45:28.751
false,false,450,423,27,95,00:00:32.000,2025-04-14 10:46:38.801
false,false,457,430,27,315,00:00:31.000,2025-04-14 10:46:52.811
false,true,474,446,28,0,00:00:00.000,2025-04-14 10:47:36.845
false,false,492,463,29,381,00:00:33.000,2025-04-14 10:48:26.878
false,false,494,465,29,446,00:00:32.000,2025-04-14 10:48:30.880
false,false,502,472,30,697,00:00:30.000,2025-04-14 10:48:46.893
false,false,510,479,31,62,00:00:30.000,2025-04-14 10:49:14.914
false,false,511,480,31,95,00:00:33.000,2025-04-14 10:49:16.914
false,false,584,549,35,1615,00:00:31.000,2025-04-14 10:51:55.035
false,true,663,626,37,0,00:00:00.000,2025-04-14 10:55:23.182
false,true,203,192,11,0,00:00:00.000,2025-04-14 10:36:10.327
false,false,271,252,19,593,00:00:30.000,2025-04-14 10:38:40.455
false,false,295,273,22,763,00:00:31.000,2025-04-14 10:39:40.501
false,false,298,276,22,857,00:00:30.000,2025-04-14 10:39:46.503
false,false,300,278,22,920,00:00:31.000,2025-04-14 10:39:50.508
false,true,304,281,23,0,00:00:00.000,2025-04-14 10:40:04.519
false,true,304,281,23,0,00:00:00.000,2025-04-14 10:40:08.522
false,true,339,315,24,0,00:00:00.000,2025-04-14 10:41:36.583
false,false,374,348,26,64,00:00:31.000,2025-04-14 10:43:18.653
false,false,397,370,27,190,00:00:30.000,2025-04-14 10:44:16.695
false,false,410,383,27,319,00:00:31.000,2025-04-14 10:44:54.724
false,false,417,390,27,124,00:00:30.000,2025-04-14 10:45:20.744
false,false,418,391,27,154,00:00:30.000,2025-04-14 10:45:22.745
false,false,419,392,27,187,00:00:33.000,2025-04-14 10:45:24.747
false,true,413,386,27,0,00:00:00.000,2025-04-14 10:45:12.739
false,false,414,387,27,31,00:00:31.000,2025-04-14 10:45:14.739
false,false,430,403,27,538,00:00:31.000,2025-04-14 10:45:46.764
false,false,428,401,27,474,00:00:33.000,2025-04-14 10:45:42.762
false,false,429,402,27,507,00:00:33.000,2025-04-14 10:45:44.763
false,false,467,440,27,628,00:00:33.000,2025-04-14 10:47:12.826
false,true,480,451,29,0,00:00:00.000,2025-04-14 10:47:54.853
false,true,480,451,29,0,00:00:00.000,2025-04-14 10:48:02.858
false,false,550,517,33,537,00:00:33.000,2025-04-14 10:50:46.979
false,false,570,536,34,1175,00:00:32.000,2025-04-14 10:51:27.015
false,false,574,540,34,1295,00:00:30.000,2025-04-14 10:51:35.023
false,false,677,639,38,444,00:00:33.000,2025-04-14 10:56:01.204
false,false,197,187,10,533,00:00:33.000,2025-04-14 10:35:48.310
false,true,252,235,17,0,00:00:00.000,2025-04-14 10:38:02.428
false,false,255,237,18,97,00:00:32.000,2025-04-14 10:38:08.433
false,false,268,249,19,500,00:00:31.000,2025-04-14 10:38:34.449
false,true,271,252,19,0,00:00:00.000,2025-04-14 10:38:50.463
false,false,275,255,20,125,00:00:30.000,2025-04-14 10:39:00.469
false,true,321,298,23,0,00:00:00.000,2025-04-14 10:40:54.555
false,false,330,307,23,279,00:00:31.000,2025-04-14 10:41:14.567
false,true,339,315,24,0,00:00:00.000,2025-04-14 10:41:44.590
false,false,363,339,24,409,00:00:32.000,2025-04-14 10:42:44.631
false,true,350,326,24,0,00:00:00.000,2025-04-14 10:42:14.615
false,false,381,355,26,284,00:00:32.000,2025-04-14 10:43:32.661
false,false,377,351,26,160,00:00:30.000,2025-04-14 10:43:24.655
false,false,371,345,26,664,00:00:33.000,2025-04-14 10:43:00.643
false,false,416,389,27,94,00:00:30.000,2025-04-14 10:45:18.742
false,true,413,386,27,0,00:00:00.000,2025-04-14 10:45:10.737
false,false,431,404,27,570,00:00:32.000,2025-04-14 10:45:48.765
false,false,474,446,28,848,00:00:33.000,2025-04-14 10:47:26.835
false,true,474,446,28,0,00:00:00.000,2025-04-14 10:47:30.839
false,false,480,451,29,188,00:00:32.000,2025-04-14 10:47:50.851
false,true,480,451,29,0,00:00:00.000,2025-04-14 10:47:56.855
false,true,474,446,28,0,00:00:00.000,2025-04-14 10:47:38.847
false,false,499,470,29,603,00:00:33.000,2025-04-14 10:48:40.887
false,true,508,477,31,0,00:00:00.000,2025-04-14 10:49:02.905
false,true,508,477,31,0,00:00:00.000,2025-04-14 10:49:06.908
false,false,533,500,33,786,00:00:31.000,2025-04-14 10:50:00.945
false,false,552,518,34,600,00:00:33.000,2025-04-14 10:50:50.983
false,false,567,533,34,1077,00:00:33.000,2025-04-14 10:51:21.009
false,false,575,541,34,1328,00:00:33.000,2025-04-14 10:51:37.025
false,false,576,542,34,1360,00:00:32.000,2025-04-14 10:51:39.027
false,true,663,626,37,0,00:00:00.000,2025-04-14 10:55:25.184
false,true,663,626,37,0,00:00:00.000,2025-04-14 10:55:31.188
false,false,683,645,38,632,00:00:31.000,2025-04-14 10:56:13.210
false,false,214,201,13,355,00:00:32.000,2025-04-14 10:36:34.352
false,false,228,214,14,795,00:00:33.000,2025-04-14 10:37:02.376
false,false,241,227,14,1196,00:00:30.000,2025-04-14 10:37:28.396
false,false,259,241,18,222,00:00:30.000,2025-04-14 10:38:16.437
false,false,266,247,19,437,00:00:30.000,2025-04-14 10:38:30.447
false,false,272,253,19,32,00:00:32.000,2025-04-14 10:38:54.465
false,false,278,258,20,220,00:00:32.000,2025-04-14 10:39:06.472
false,false,299,277,22,889,00:00:32.000,2025-04-14 10:39:48.506
false,true,304,281,23,0,00:00:00.000,2025-04-14 10:40:00.515
false,false,307,284,23,93,00:00:32.000,2025-04-14 10:40:16.527
false,true,321,298,23,0,00:00:00.000,2025-04-14 10:40:46.552
false,false,305,282,23,30,00:00:30.000,2025-04-14 10:40:12.526
false,false,353,329,24,95,00:00:32.000,2025-04-14 10:42:24.621
false,false,344,320,24,158,00:00:31.000,2025-04-14 10:41:54.598
false,false,361,337,24,347,00:00:32.000,2025-04-14 10:42:40.628
false,true,391,365,26,0,00:00:00.000,2025-04-14 10:43:56.681
false,false,434,407,27,661,00:00:30.000,2025-04-14 10:45:54.771
false,false,437,410,27,754,00:00:32.000,2025-04-14 10:46:00.777
false,true,447,420,27,0,00:00:00.000,2025-04-14 10:46:28.798
false,false,469,442,27,690,00:00:30.000,2025-04-14 10:47:16.826
false,true,474,446,28,0,00:00:00.000,2025-04-14 10:47:32.841
false,false,491,462,29,348,00:00:32.000,2025-04-14 10:48:24.876
false,false,523,490,33,474,00:00:31.000,2025-04-14 10:49:40.930
false,false,579,544,35,1456,00:00:30.000,2025-04-14 10:51:45.032
false,false,662,625,37,1141,00:00:32.000,2025-04-14 10:55:19.179
false,false,666,628,38,94,00:00:33.000,2025-04-14 10:55:39.191
false,true,203,192,11,0,00:00:00.000,2025-04-14 10:36:08.325
false,true,203,192,11,0,00:00:00.000,2025-04-14 10:36:12.329
false,false,199,189,10,594,00:00:30.000,2025-04-14 10:35:52.314
false,false,205,194,11,66,00:00:33.000,2025-04-14 10:36:16.334
false,false,212,200,12,291,00:00:33.000,2025-04-14 10:36:30.348
false,false,231,217,14,886,00:00:31.000,2025-04-14 10:37:08.379
false,false,243,228,15,1260,00:00:33.000,2025-04-14 10:37:32.401
false,true,271,252,19,0,00:00:00.000,2025-04-14 10:38:42.458
false,false,292,270,22,668,00:00:31.000,2025-04-14 10:39:34.495
false,false,284,263,21,414,00:00:31.000,2025-04-14 10:39:18.482
false,false,281,260,21,317,00:00:32.000,2025-04-14 10:39:12.476
false,false,282,261,21,350,00:00:33.000,2025-04-14 10:39:14.479
false,false,319,296,23,475,00:00:30.000,2025-04-14 10:40:40.546
false,false,333,310,23,377,00:00:32.000,2025-04-14 10:41:20.573
false,false,322,299,23,30,00:00:30.000,2025-04-14 10:40:58.557
false,false,343,319,24,127,00:00:32.000,2025-04-14 10:41:52.596
false,false,364,340,24,442,00:00:33.000,2025-04-14 10:42:46.634
false,false,385,359,26,407,00:00:31.000,2025-04-14 10:43:40.665
false,false,372,346,26,694,00:00:30.000,2025-04-14 10:43:02.644
false,false,398,371,27,222,00:00:32.000,2025-04-14 10:44:18.696
false,false,432,405,27,601,00:00:31.000,2025-04-14 10:45:50.768
false,false,452,425,27,158,00:00:33.000,2025-04-14 10:46:42.803
false,false,479,450,29,156,00:00:31.000,2025-04-14 10:47:48.850
false,false,475,447,28,30,00:00:30.000,2025-04-14 10:47:40.848
false,false,489,460,29,283,00:00:33.000,2025-04-14 10:48:20.872
false,false,497,468,29,539,00:00:32.000,2025-04-14 10:48:36.884
false,false,522,489,33,443,00:00:30.000,2025-04-14 10:49:38.929
false,false,526,493,33,566,00:00:31.000,2025-04-14 10:49:46.935
false,false,545,512,33,380,00:00:32.000,2025-04-14 10:50:36.972
false,false,546,513,33,411,00:00:31.000,2025-04-14 10:50:38.973
false,false,562,528,34,915,00:00:32.000,2025-04-14 10:51:10.999
false,false,564,530,34,980,00:00:33.000,2025-04-14 10:51:15.004
false,false,569,535,34,1143,00:00:33.000,2025-04-14 10:51:25.014
false,false,571,537,34,1205,00:00:30.000,2025-04-14 10:51:29.016
false,false,578,543,35,1426,00:00:33.000,2025-04-14 10:51:43.031
false,true,663,626,37,0,00:00:00.000,2025-04-14 10:55:29.186
false,false,200,190,10,626,00:00:32.000,2025-04-14 10:35:54.315
false,false,215,202,13,385,00:00:30.000,2025-04-14 10:36:36.353
false,false,220,206,14,539,00:00:32.000,2025-04-14 10:36:46.364
false,false,235,221,14,1011,00:00:30.000,2025-04-14 10:37:16.384
false,false,314,291,23,317,00:00:31.000,2025-04-14 10:40:30.538
false,false,335,312,23,441,00:00:33.000,2025-04-14 10:41:24.575
false,false,338,314,24,539,00:00:33.000,2025-04-14 10:41:30.579
false,false,345,321,24,191,00:00:33.000,2025-04-14 10:41:56.601
false,false,350,326,24,349,00:00:30.000,2025-04-14 10:42:06.609
false,true,350,326,24,0,00:00:00.000,2025-04-14 10:42:08.610
false,false,366,341,25,504,00:00:31.000,2025-04-14 10:42:50.639
false,false,379,353,26,221,00:00:30.000,2025-04-14 10:43:28.657
false,false,388,362,26,499,00:00:30.000,2025-04-14 10:43:46.671
false,false,391,365,26,595,00:00:33.000,2025-04-14 10:43:52.677
false,true,391,365,26,0,00:00:00.000,2025-04-14 10:43:58.683
false,false,411,384,27,350,00:00:31.000,2025-04-14 10:44:56.724
false,true,447,420,27,0,00:00:00.000,2025-04-14 10:46:32.799
false,false,473,445,28,815,00:00:31.000,2025-04-14 10:47:24.834
false,false,478,449,29,125,00:00:32.000,2025-04-14 10:47:46.849
false,false,481,452,29,30,00:00:30.000,2025-04-14 10:48:04.858
false,false,490,461,29,316,00:00:33.000,2025-04-14 10:48:22.874
false,false,500,471,29,636,00:00:33.000,2025-04-14 10:48:42.889
false,false,504,474,30,760,00:00:31.000,2025-04-14 10:48:50.898
false,false,517,485,32,287,00:00:32.000,2025-04-14 10:49:28.921
false,false,539,506,33,191,00:00:31.000,2025-04-14 10:50:24.965
false,false,557,523,34,758,00:00:32.000,2025-04-14 10:51:00.994
false,false,573,539,34,1265,00:00:30.000,2025-04-14 10:51:33.021
true,false,403,376,27,99,00:00:33.000,2025-04-14 10:44:40.712
true,false,435,408,27,692,00:00:31.000,2025-04-14 10:45:56.773
true,true,252,235,17,0,00:00:00.000,2025-04-14 10:37:58.424
true,false,325,302,23,120,00:00:30.000,2025-04-14 10:41:04.559
true,false,415,388,27,64,00:00:33.000,2025-04-14 10:45:16.740
true,false,555,521,34,695,00:00:31.000,2025-04-14 10:50:56.991
true,false,559,525,34,823,00:00:33.000,2025-04-14 10:51:04.996
true,false,274,255,19,95,00:00:30.000,2025-04-14 10:38:58.468
true,false,449,422,27,63,00:00:30.000,2025-04-14 10:46:36.800
true,false,563,529,34,947,00:00:32.000,2025-04-14 10:51:13.002
true,false,373,347,26,33,00:00:33.000,2025-04-14 10:43:16.651
true,false,267,248,19,469,00:00:32.000,2025-04-14 10:38:32.448
true,true,321,298,23,0,00:00:00.000,2025-04-14 10:40:48.553
true,false,538,505,33,160,00:00:33.000,2025-04-14 10:50:22.964
true,false,422,395,27,285,00:00:32.000,2025-04-14 10:45:30.754
true,false,681,643,38,568,00:00:30.000,2025-04-14 10:56:09.207
true,false,265,246,19,407,00:00:30.000,2025-04-14 10:38:28.445
true,true,413,386,27,0,00:00:00.000,2025-04-14 10:45:08.736
true,false,331,308,23,312,00:00:33.000,2025-04-14 10:41:16.569
true,false,279,259,20,253,00:00:33.000,2025-04-14 10:39:08.473
true,false,518,486,32,319,00:00:32.000,2025-04-14 10:49:30.923
true,false,204,193,11,33,00:00:33.000,2025-04-14 10:36:14.331
true,true,339,315,24,0,00:00:00.000,2025-04-14 10:41:38.584
true,false,516,484,32,255,00:00:33.000,2025-04-14 10:49:26.919
true,false,227,213,14,762,00:00:33.000,2025-04-14 10:37:00.375
true,false,316,293,23,380,00:00:31.000,2025-04-14 10:40:34.541
true,false,669,631,38,192,00:00:33.000,2025-04-14 10:55:45.193
false,false,674,636,38,349,00:00:32.000,2025-04-14 10:55:55.198
false,false,675,637,38,379,00:00:30.000,2025-04-14 10:55:57.200
false,false,688,650,38,790,00:00:33.000,2025-04-14 10:56:23.217
false,false,710,672,38,94,00:00:33.000,2025-04-14 10:57:19.266
false,false,714,676,38,222,00:00:31.000,2025-04-14 10:57:27.270
false,false,718,680,38,348,00:00:30.000,2025-04-14 10:57:35.275
false,true,726,686,40,0,00:00:00.000,2025-04-14 10:58:15.300
false,false,727,687,40,32,00:00:32.000,2025-04-14 10:58:17.302
false,true,618,582,36,0,00:00:00.000,2025-04-14 10:53:17.099
false,false,626,590,36,226,00:00:31.000,2025-04-14 10:53:55.128
false,false,634,598,36,250,00:00:30.000,2025-04-14 10:54:23.149
false,true,824,780,44,0,00:00:00.000,2025-04-14 11:02:37.492
false,false,833,788,45,280,00:00:33.000,2025-04-14 11:03:01.517
false,false,843,798,45,599,00:00:31.000,2025-04-14 11:03:21.533
false,true,856,809,47,0,00:00:00.000,2025-04-14 11:03:59.562
false,true,860,813,47,0,00:00:00.000,2025-04-14 11:04:09.572
false,false,876,827,49,313,00:00:32.000,2025-04-14 11:05:03.620
false,false,880,830,50,439,00:00:32.000,2025-04-14 11:05:11.627
false,false,754,713,41,30,00:00:30.000,2025-04-14 10:59:23.351
false,false,755,714,41,60,00:00:30.000,2025-04-14 10:59:25.352
false,true,759,718,41,0,00:00:00.000,2025-04-14 10:59:37.361
false,false,762,721,41,98,00:00:33.000,2025-04-14 10:59:51.367
false,false,767,726,41,253,00:00:30.000,2025-04-14 11:00:01.375
false,false,770,729,41,349,00:00:33.000,2025-04-14 11:00:07.380
false,false,794,753,41,697,00:00:33.000,2025-04-14 11:01:07.424
false,true,797,756,41,0,00:00:00.000,2025-04-14 11:01:31.443
false,true,797,756,41,0,00:00:00.000,2025-04-14 11:01:33.443
false,false,799,758,41,64,00:00:33.000,2025-04-14 11:01:41.448
false,false,883,833,50,534,00:00:32.000,2025-04-14 11:05:17.628
false,false,884,834,50,565,00:00:31.000,2025-04-14 11:05:19.630
false,true,917,866,51,0,00:00:00.000,2025-04-14 11:06:47.700
false,true,926,875,51,0,00:00:00.000,2025-04-14 11:07:23.730
false,true,927,876,51,0,00:00:00.000,2025-04-14 11:07:43.742
false,false,935,884,51,252,00:00:33.000,2025-04-14 11:08:01.753
false,false,936,885,51,284,00:00:32.000,2025-04-14 11:08:03.755
false,true,939,888,51,0,00:00:00.000,2025-04-14 11:08:13.762
false,true,1156,1085,71,0,00:00:00.000,2025-04-14 11:19:00.198
false,false,1176,1105,71,64,00:00:33.000,2025-04-14 11:19:52.235
false,false,1183,1111,72,282,00:00:30.000,2025-04-14 11:20:06.246
false,true,1190,1118,72,0,00:00:00.000,2025-04-14 11:20:44.275
false,false,1206,1134,72,316,00:00:30.000,2025-04-14 11:21:40.318
false,false,1210,1138,72,440,00:00:32.000,2025-04-14 11:21:48.325
false,true,951,897,54,0,00:00:00.000,2025-04-14 11:08:47.787
false,true,951,897,54,0,00:00:00.000,2025-04-14 11:08:51.790
false,true,968,914,54,0,00:00:00.000,2025-04-14 11:09:37.814
false,false,975,920,55,225,00:00:33.000,2025-04-14 11:09:57.827
false,false,999,944,55,31,00:00:31.000,2025-04-14 11:11:09.872
false,true,1087,1019,68,0,00:00:00.000,2025-04-14 11:15:40.067
false,true,1110,1042,68,0,00:00:00.000,2025-04-14 11:16:30.100
false,true,1113,1045,68,0,00:00:00.000,2025-04-14 11:16:58.115
false,false,1116,1048,68,95,00:00:31.000,2025-04-14 11:17:04.119
false,false,1119,1051,68,189,00:00:31.000,2025-04-14 11:17:10.123
false,false,1132,1062,70,604,00:00:33.000,2025-04-14 11:17:36.139
false,true,1014,956,58,0,00:00:00.000,2025-04-14 11:12:01.915
false,false,1036,976,60,448,00:00:32.000,2025-04-14 11:12:59.959
false,true,1050,988,62,0,00:00:00.000,2025-04-14 11:13:45.991
false,false,1062,999,63,226,00:00:33.000,2025-04-14 11:14:28.018
false,false,1231,1159,72,1101,00:00:32.000,2025-04-14 11:22:30.364
false,false,1244,1171,73,94,00:00:30.000,2025-04-14 11:23:20.401
false,false,1250,1177,73,286,00:00:31.000,2025-04-14 11:23:32.412
false,false,1262,1189,73,663,00:00:30.000,2025-04-14 11:23:56.428
false,true,1262,1189,73,0,00:00:00.000,2025-04-14 11:23:58.428
false,false,1272,1199,73,127,00:00:33.000,2025-04-14 11:24:40.468
false,false,1519,1430,89,350,00:00:31.000,2025-04-14 11:35:54.959
false,false,1524,1435,89,509,00:00:33.000,2025-04-14 11:36:04.964
false,false,1532,1443,89,758,00:00:32.000,2025-04-14 11:36:20.977
false,false,1554,1462,92,1459,00:00:30.000,2025-04-14 11:37:05.015
false,false,693,655,38,945,00:00:30.000,2025-04-14 10:56:33.227
false,false,699,661,38,1133,00:00:30.000,2025-04-14 10:56:45.236
false,false,706,668,38,1355,00:00:33.000,2025-04-14 10:56:59.251
false,true,720,681,39,0,00:00:00.000,2025-04-14 10:57:43.282
false,false,724,684,40,127,00:00:33.000,2025-04-14 10:57:59.291
false,false,734,693,41,252,00:00:31.000,2025-04-14 10:58:31.314
false,false,736,695,41,316,00:00:32.000,2025-04-14 10:58:35.318
false,false,587,552,35,1711,00:00:30.000,2025-04-14 10:52:01.040
false,false,599,564,35,2083,00:00:31.000,2025-04-14 10:52:25.056
false,false,623,587,36,129,00:00:33.000,2025-04-14 10:53:49.122
false,false,807,764,43,320,00:00:33.000,2025-04-14 11:01:57.463
false,false,820,776,44,727,00:00:33.000,2025-04-14 11:02:23.482
false,false,857,810,47,33,00:00:33.000,2025-04-14 11:04:01.565
false,false,871,823,48,155,00:00:31.000,2025-04-14 11:04:53.611
false,false,873,825,48,218,00:00:31.000,2025-04-14 11:04:57.615
false,false,877,828,49,343,00:00:30.000,2025-04-14 11:05:05.622
false,false,750,709,41,761,00:00:31.000,2025-04-14 10:59:03.340
false,false,888,838,50,692,00:00:33.000,2025-04-14 11:05:27.636
false,false,891,840,51,790,00:00:33.000,2025-04-14 11:05:33.642
false,false,892,841,51,822,00:00:32.000,2025-04-14 11:05:35.643
false,false,914,863,51,1520,00:00:31.000,2025-04-14 11:06:19.682
false,true,915,864,51,0,00:00:00.000,2025-04-14 11:06:25.687
false,false,916,865,51,33,00:00:33.000,2025-04-14 11:06:35.693
false,true,918,867,51,0,00:00:00.000,2025-04-14 11:07:01.710
false,true,926,875,51,0,00:00:00.000,2025-04-14 11:07:25.729
false,false,940,889,51,32,00:00:32.000,2025-04-14 11:08:23.770
false,true,1155,1084,71,0,00:00:00.000,2025-04-14 11:18:40.183
false,false,1179,1108,71,157,00:00:30.000,2025-04-14 11:19:58.241
false,false,1182,1111,71,252,00:00:32.000,2025-04-14 11:20:04.244
false,false,947,894,53,251,00:00:30.000,2025-04-14 11:08:37.782
false,false,950,897,53,345,00:00:32.000,2025-04-14 11:08:43.787
false,true,951,897,54,0,00:00:00.000,2025-04-14 11:08:49.788
false,false,957,903,54,189,00:00:32.000,2025-04-14 11:09:09.799
false,false,966,912,54,470,00:00:32.000,2025-04-14 11:09:27.811
false,false,973,918,55,159,00:00:33.000,2025-04-14 11:09:53.821
false,false,980,925,55,386,00:00:31.000,2025-04-14 11:10:07.833
false,true,998,943,55,0,00:00:00.000,2025-04-14 11:10:59.869
false,false,1008,950,58,312,00:00:30.000,2025-04-14 11:11:27.892
false,true,1087,1019,68,0,00:00:00.000,2025-04-14 11:15:38.067
false,false,1090,1022,68,94,00:00:30.000,2025-04-14 11:15:48.076
false,false,1114,1046,68,32,00:00:32.000,2025-04-14 11:17:00.117
false,true,1014,956,58,0,00:00:00.000,2025-04-14 11:11:57.914
false,false,1020,962,58,191,00:00:33.000,2025-04-14 11:12:15.924
false,true,1022,964,58,0,00:00:00.000,2025-04-14 11:12:27.933
false,false,1034,974,60,385,00:00:33.000,2025-04-14 11:12:55.956
false,false,1053,991,62,95,00:00:31.000,2025-04-14 11:13:57.997
false,false,1072,1008,64,542,00:00:32.000,2025-04-14 11:14:48.031
false,false,1234,1162,72,1198,00:00:31.000,2025-04-14 11:22:36.366
false,true,1241,1169,72,0,00:00:00.000,2025-04-14 11:22:54.380
false,true,1273,1200,73,0,00:00:00.000,2025-04-14 11:24:48.478
false,true,1508,1419,89,0,00:00:00.000,2025-04-14 11:35:22.935
false,false,1545,1454,91,1175,00:00:31.000,2025-04-14 11:36:47.001
false,false,1555,1462,93,1489,00:00:30.000,2025-04-14 11:37:07.016
false,false,689,651,38,821,00:00:31.000,2025-04-14 10:56:25.219
false,false,692,654,38,915,00:00:32.000,2025-04-14 10:56:31.225
false,false,715,677,38,254,00:00:32.000,2025-04-14 10:57:29.271
false,true,720,681,39,0,00:00:00.000,2025-04-14 10:57:45.283
false,true,720,681,39,0,00:00:00.000,2025-04-14 10:57:51.285
false,false,605,570,35,2270,00:00:32.000,2025-04-14 10:52:37.067
false,false,621,585,36,63,00:00:30.000,2025-04-14 10:53:45.119
false,false,622,586,36,96,00:00:33.000,2025-04-14 10:53:47.122
false,false,625,589,36,195,00:00:33.000,2025-04-14 10:53:53.126
false,false,631,595,36,159,00:00:33.000,2025-04-14 10:54:17.143
false,false,654,617,37,890,00:00:31.000,2025-04-14 10:55:03.173
false,false,659,622,37,1044,00:00:32.000,2025-04-14 10:55:13.176
false,false,828,784,44,124,00:00:30.000,2025-04-14 11:02:51.504
false,false,856,809,47,1012,00:00:33.000,2025-04-14 11:03:47.554
false,false,860,813,47,130,00:00:31.000,2025-04-14 11:04:07.568
false,true,866,819,47,0,00:00:00.000,2025-04-14 11:04:37.593
false,true,753,712,41,0,00:00:00.000,2025-04-14 10:59:19.347
false,false,776,735,41,130,00:00:31.000,2025-04-14 11:00:31.395
false,false,901,850,51,1109,00:00:33.000,2025-04-14 11:05:53.660
false,true,915,864,51,0,00:00:00.000,2025-04-14 11:06:23.685
false,true,917,866,51,0,00:00:00.000,2025-04-14 11:06:39.696
false,true,918,867,51,0,00:00:00.000,2025-04-14 11:06:55.705
false,true,927,876,51,0,00:00:00.000,2025-04-14 11:07:35.735
false,true,927,876,51,0,00:00:00.000,2025-04-14 11:07:41.740
false,false,941,890,51,65,00:00:33.000,2025-04-14 11:08:25.772
false,true,1156,1085,71,0,00:00:00.000,2025-04-14 11:18:52.191
false,false,1173,1102,71,538,00:00:32.000,2025-04-14 11:19:34.219
false,false,1174,1103,71,569,00:00:31.000,2025-04-14 11:19:36.220
false,true,1174,1103,71,0,00:00:00.000,2025-04-14 11:19:44.227
false,true,1189,1117,72,0,00:00:00.000,2025-04-14 11:20:24.262
false,false,1191,1119,72,31,00:00:31.000,2025-04-14 11:20:46.278
false,false,1197,1125,72,33,00:00:33.000,2025-04-14 11:21:22.308
false,false,1214,1142,72,567,00:00:32.000,2025-04-14 11:21:56.333
false,false,951,897,54,375,00:00:30.000,2025-04-14 11:08:45.787
false,false,958,904,54,220,00:00:31.000,2025-04-14 11:09:11.799
false,false,960,906,54,283,00:00:32.000,2025-04-14 11:09:15.804
false,false,964,910,54,406,00:00:30.000,2025-04-14 11:09:23.808
false,false,967,913,54,502,00:00:32.000,2025-04-14 11:09:29.812
false,true,968,914,54,0,00:00:00.000,2025-04-14 11:09:41.816
false,false,986,931,55,573,00:00:31.000,2025-04-14 11:10:19.843
false,true,996,941,55,0,00:00:00.000,2025-04-14 11:10:47.862
false,false,1011,953,58,411,00:00:33.000,2025-04-14 11:11:33.898
false,true,1085,1018,67,0,00:00:00.000,2025-04-14 11:15:26.055
false,false,1092,1024,68,154,00:00:30.000,2025-04-14 11:15:52.079
false,false,1094,1026,68,216,00:00:32.000,2025-04-14 11:15:56.081
false,true,1110,1042,68,0,00:00:00.000,2025-04-14 11:16:36.103
false,true,1113,1045,68,0,00:00:00.000,2025-04-14 11:16:50.109
false,false,1129,1061,68,506,00:00:30.000,2025-04-14 11:17:30.136
false,false,1145,1075,70,219,00:00:31.000,2025-04-14 11:18:14.167
false,false,1016,958,58,63,00:00:30.000,2025-04-14 11:12:07.920
false,false,1039,979,60,65,00:00:33.000,2025-04-14 11:13:17.970
false,false,1046,985,61,286,00:00:30.000,2025-04-14 11:13:31.981
false,true,1055,992,63,0,00:00:00.000,2025-04-14 11:14:12.005
false,false,1059,996,63,129,00:00:32.000,2025-04-14 11:14:22.013
false,false,1071,1007,64,510,00:00:31.000,2025-04-14 11:14:46.031
false,false,1075,1010,65,638,00:00:31.000,2025-04-14 11:14:54.033
false,false,1240,1168,72,1387,00:00:31.000,2025-04-14 11:22:48.376
false,false,1241,1169,72,1420,00:00:33.000,2025-04-14 11:22:50.378
false,false,1253,1180,73,379,00:00:32.000,2025-04-14 11:23:38.414
false,false,1277,1204,73,125,00:00:30.000,2025-04-14 11:25:02.490
false,false,1513,1424,89,161,00:00:32.000,2025-04-14 11:35:42.948
false,false,1539,1449,90,985,00:00:31.000,2025-04-14 11:36:34.991
false,false,1551,1460,91,1365,00:00:30.000,2025-04-14 11:36:59.012
false,false,1553,1461,92,1429,00:00:32.000,2025-04-14 11:37:03.014
false,false,709,671,38,61,00:00:31.000,2025-04-14 10:57:17.266
false,false,711,673,38,126,00:00:32.000,2025-04-14 10:57:21.267
false,true,726,686,40,0,00:00:00.000,2025-04-14 10:58:05.293
false,false,606,571,35,2301,00:00:31.000,2025-04-14 10:52:39.069
false,false,615,580,35,63,00:00:30.000,2025-04-14 10:53:09.092
false,true,619,583,36,0,00:00:00.000,2025-04-14 10:53:33.113
false,true,626,590,36,0,00:00:00.000,2025-04-14 10:53:59.132
false,false,635,599,36,281,00:00:31.000,2025-04-14 10:54:25.151
false,false,646,609,37,634,00:00:32.000,2025-04-14 10:54:47.166
false,false,656,619,37,950,00:00:30.000,2025-04-14 10:55:07.174
false,true,824,780,44,0,00:00:00.000,2025-04-14 11:02:33.490
false,false,844,799,45,632,00:00:33.000,2025-04-14 11:03:23.535
false,false,848,802,46,758,00:00:33.000,2025-04-14 11:03:31.543
false,false,851,805,46,853,00:00:30.000,2025-04-14 11:03:37.547
false,true,856,809,47,0,00:00:00.000,2025-04-14 11:03:53.558
false,false,862,815,47,62,00:00:32.000,2025-04-14 11:04:23.582
false,false,881,831,50,470,00:00:31.000,2025-04-14 11:05:13.627
false,true,753,712,41,0,00:00:00.000,2025-04-14 10:59:21.350
false,false,761,720,41,65,00:00:32.000,2025-04-14 10:59:49.366
false,false,778,737,41,193,00:00:32.000,2025-04-14 11:00:35.397
false,false,779,738,41,225,00:00:32.000,2025-04-14 11:00:37.399
false,false,786,745,41,445,00:00:30.000,2025-04-14 11:00:51.410
false,false,904,853,51,1201,00:00:31.000,2025-04-14 11:05:59.663
false,false,908,857,51,1330,00:00:32.000,2025-04-14 11:06:07.672
false,true,915,864,51,0,00:00:00.000,2025-04-14 11:06:31.689
false,false,924,873,51,191,00:00:33.000,2025-04-14 11:07:15.725
false,true,1155,1084,71,0,00:00:00.000,2025-04-14 11:18:42.184
false,false,1170,1099,71,442,00:00:31.000,2025-04-14 11:19:28.215
false,false,1192,1120,72,61,00:00:30.000,2025-04-14 11:20:48.280
false,false,1208,1136,72,377,00:00:30.000,2025-04-14 11:21:44.322
false,false,948,895,53,281,00:00:30.000,2025-04-14 11:08:39.785
false,false,963,909,54,376,00:00:30.000,2025-04-14 11:09:21.807
false,false,972,917,55,126,00:00:32.000,2025-04-14 11:09:51.821
false,false,977,922,55,290,00:00:33.000,2025-04-14 11:10:01.830
false,false,990,935,55,701,00:00:32.000,2025-04-14 11:10:27.849
false,false,1004,947,57,188,00:00:33.000,2025-04-14 11:11:19.883
false,false,1013,955,58,471,00:00:30.000,2025-04-14 11:11:37.899
false,true,1085,1018,67,0,00:00:00.000,2025-04-14 11:15:18.046
false,false,1105,1037,68,559,00:00:33.000,2025-04-14 11:16:18.093
false,false,1126,1058,68,414,00:00:33.000,2025-04-14 11:17:24.130
false,false,1131,1061,70,571,00:00:32.000,2025-04-14 11:17:34.138
false,true,1022,964,58,0,00:00:00.000,2025-04-14 11:12:23.929
false,false,1025,966,59,94,00:00:31.000,2025-04-14 11:12:37.941
false,false,1027,968,59,160,00:00:33.000,2025-04-14 11:12:41.943
false,false,1033,974,59,352,00:00:31.000,2025-04-14 11:12:53.954
false,true,1037,977,60,0,00:00:00.000,2025-04-14 11:13:13.969
false,true,1050,988,62,0,00:00:00.000,2025-04-14 11:13:49.994
false,true,1055,992,63,0,00:00:00.000,2025-04-14 11:14:04.002
false,false,1064,1000,64,290,00:00:33.000,2025-04-14 11:14:32.021
false,false,1066,1002,64,355,00:00:33.000,2025-04-14 11:14:36.024
false,false,1069,1005,64,448,00:00:30.000,2025-04-14 11:14:42.029
false,false,1223,1151,72,845,00:00:32.000,2025-04-14 11:22:14.350
false,false,1230,1158,72,1069,00:00:30.000,2025-04-14 11:22:28.361
false,false,1239,1167,72,1356,00:00:32.000,2025-04-14 11:22:46.376
false,true,1241,1169,72,0,00:00:00.000,2025-04-14 11:22:52.379
false,false,1248,1175,73,222,00:00:32.000,2025-04-14 11:23:28.409
false,false,1270,1197,73,62,00:00:32.000,2025-04-14 11:24:36.466
false,true,1273,1200,73,0,00:00:00.000,2025-04-14 11:24:52.481
false,false,1508,1419,89,689,00:00:30.000,2025-04-14 11:35:20.932
false,false,1512,1423,89,129,00:00:33.000,2025-04-14 11:35:40.946
false,false,1525,1436,89,541,00:00:32.000,2025-04-14 11:36:06.967
false,false,697,659,38,1071,00:00:31.000,2025-04-14 10:56:41.230
false,false,735,694,41,284,00:00:32.000,2025-04-14 10:58:33.317
false,false,589,554,35,1773,00:00:32.000,2025-04-14 10:52:05.043
false,false,618,582,36,156,00:00:30.000,2025-04-14 10:53:15.097
false,true,626,590,36,0,00:00:00.000,2025-04-14 10:54:05.139
false,false,650,613,37,762,00:00:33.000,2025-04-14 10:54:55.170
false,false,653,616,37,859,00:00:31.000,2025-04-14 10:55:01.172
false,false,815,771,44,571,00:00:32.000,2025-04-14 11:02:13.475
false,false,819,775,44,694,00:00:31.000,2025-04-14 11:02:21.480
false,true,824,780,44,0,00:00:00.000,2025-04-14 11:02:35.491
false,true,824,780,44,0,00:00:00.000,2025-04-14 11:02:43.498
false,false,826,782,44,63,00:00:33.000,2025-04-14 11:02:47.502
false,false,855,808,47,979,00:00:33.000,2025-04-14 11:03:45.552
false,true,866,819,47,0,00:00:00.000,2025-04-14 11:04:35.590
false,false,875,826,49,281,00:00:30.000,2025-04-14 11:05:01.618
false,false,739,698,41,410,00:00:32.000,2025-04-14 10:58:41.324
false,false,759,718,41,185,00:00:30.000,2025-04-14 10:59:33.358
false,false,771,730,41,382,00:00:33.000,2025-04-14 11:00:09.382
false,false,800,759,41,97,00:00:33.000,2025-04-14 11:01:43.448
false,false,803,762,41,192,00:00:32.000,2025-04-14 11:01:49.452
false,false,895,844,51,918,00:00:33.000,2025-04-14 11:05:41.649
false,false,903,852,51,1170,00:00:30.000,2025-04-14 11:05:57.663
false,false,909,858,51,1363,00:00:33.000,2025-04-14 11:06:09.674
false,true,918,867,51,0,00:00:00.000,2025-04-14 11:06:59.710
false,true,927,876,51,0,00:00:00.000,2025-04-14 11:07:45.743
false,false,933,882,51,189,00:00:31.000,2025-04-14 11:07:57.751
false,true,939,888,51,0,00:00:00.000,2025-04-14 11:08:11.761
false,true,1156,1085,71,0,00:00:00.000,2025-04-14 11:18:54.194
false,false,1158,1087,71,61,00:00:30.000,2025-04-14 11:19:04.200
false,false,1167,1096,71,347,00:00:32.000,2025-04-14 11:19:22.212
false,false,1169,1098,71,411,00:00:32.000,2025-04-14 11:19:26.215
false,true,1190,1118,72,0,00:00:00.000,2025-04-14 11:20:36.269
false,true,1196,1124,72,0,00:00:00.000,2025-04-14 11:21:08.294
false,false,978,923,55,323,00:00:33.000,2025-04-14 11:10:03.831
false,false,998,943,55,62,00:00:30.000,2025-04-14 11:10:55.867
false,false,1108,1040,68,657,00:00:33.000,2025-04-14 11:16:24.096
false,false,1113,1045,68,95,00:00:31.000,2025-04-14 11:16:46.108
false,false,1117,1049,68,126,00:00:31.000,2025-04-14 11:17:06.121
false,false,1143,1073,70,157,00:00:33.000,2025-04-14 11:18:10.161
false,true,1022,964,58,0,00:00:00.000,2025-04-14 11:12:31.937
false,false,1023,965,58,33,00:00:33.000,2025-04-14 11:12:33.938
false,false,1052,990,62,64,00:00:32.000,2025-04-14 11:13:55.996
false,false,1074,1009,65,607,00:00:33.000,2025-04-14 11:14:52.033
false,false,1076,1011,65,668,00:00:30.000,2025-04-14 11:14:56.034
false,false,1082,1016,66,858,00:00:32.000,2025-04-14 11:15:08.041
false,false,1085,1018,67,953,00:00:30.000,2025-04-14 11:15:14.044
false,false,1232,1160,72,1134,00:00:33.000,2025-04-14 11:22:32.366
false,false,1233,1161,72,1167,00:00:33.000,2025-04-14 11:22:34.366
false,false,1243,1170,73,64,00:00:32.000,2025-04-14 11:23:18.400
false,false,1246,1173,73,159,00:00:33.000,2025-04-14 11:23:24.404
false,true,1262,1189,73,0,00:00:00.000,2025-04-14 11:24:00.433
false,true,1268,1195,73,0,00:00:00.000,2025-04-14 11:24:30.461
false,false,1279,1206,73,187,00:00:31.000,2025-04-14 11:25:06.490
false,false,1530,1441,89,694,00:00:30.000,2025-04-14 11:36:16.975
false,false,1537,1447,90,921,00:00:33.000,2025-04-14 11:36:30.988
false,false,1546,1455,91,1207,00:00:32.000,2025-04-14 11:36:49.002
false,false,695,657,38,1008,00:00:31.000,2025-04-14 10:56:37.227
false,false,698,660,38,1103,00:00:32.000,2025-04-14 10:56:43.232
false,true,707,669,38,0,00:00:00.000,2025-04-14 10:57:05.256
false,true,707,669,38,0,00:00:00.000,2025-04-14 10:57:09.261
false,false,731,691,40,158,00:00:32.000,2025-04-14 10:58:25.310
false,false,595,560,35,1959,00:00:30.000,2025-04-14 10:52:17.051
false,false,612,577,35,2486,00:00:30.000,2025-04-14 10:52:51.078
false,false,624,588,36,162,00:00:33.000,2025-04-14 10:53:51.124
false,false,835,790,45,345,00:00:32.000,2025-04-14 11:03:05.519
false,false,846,800,46,693,00:00:31.000,2025-04-14 11:03:27.541
false,true,856,809,47,0,00:00:00.000,2025-04-14 11:03:49.555
false,false,858,811,47,66,00:00:33.000,2025-04-14 11:04:03.566
false,false,863,816,47,92,00:00:30.000,2025-04-14 11:04:25.583
false,true,866,819,47,0,00:00:00.000,2025-04-14 11:04:43.601
false,false,748,707,41,698,00:00:32.000,2025-04-14 10:58:59.336
false,false,753,712,41,858,00:00:33.000,2025-04-14 10:59:09.343
false,false,885,835,50,597,00:00:32.000,2025-04-14 11:05:21.633
false,false,925,874,51,222,00:00:31.000,2025-04-14 11:07:17.726
false,false,932,881,51,158,00:00:32.000,2025-04-14 11:07:55.750
false,false,937,886,51,317,00:00:33.000,2025-04-14 11:08:05.757
false,true,939,888,51,0,00:00:00.000,2025-04-14 11:08:21.766
false,false,943,892,51,126,00:00:30.000,2025-04-14 11:08:29.776
false,true,1155,1084,71,0,00:00:00.000,2025-04-14 11:18:38.183
false,true,1189,1117,72,0,00:00:00.000,2025-04-14 11:20:22.260
false,false,1193,1121,72,93,00:00:32.000,2025-04-14 11:20:50.280
false,false,971,916,55,94,00:00:30.000,2025-04-14 11:09:49.818
false,false,974,919,55,192,00:00:33.000,2025-04-14 11:09:55.824
false,false,988,933,55,636,00:00:31.000,2025-04-14 11:10:23.847
false,false,996,941,55,891,00:00:33.000,2025-04-14 11:10:39.856
false,false,1002,947,55,122,00:00:30.000,2025-04-14 11:11:15.879
false,true,1014,956,58,0,00:00:00.000,2025-04-14 11:11:43.904
false,true,1085,1018,67,0,00:00:00.000,2025-04-14 11:15:22.050
false,true,1087,1019,68,0,00:00:00.000,2025-04-14 11:15:32.062
false,true,1087,1019,68,0,00:00:00.000,2025-04-14 11:15:36.065
false,true,1110,1042,68,0,00:00:00.000,2025-04-14 11:16:32.101
false,false,1151,1081,70,412,00:00:33.000,2025-04-14 11:18:26.174
false,true,1022,964,58,0,00:00:00.000,2025-04-14 11:12:25.931
false,false,1024,966,58,63,00:00:30.000,2025-04-14 11:12:35.940
false,false,1030,971,59,259,00:00:33.000,2025-04-14 11:12:47.948
false,true,1037,977,60,0,00:00:00.000,2025-04-14 11:13:05.965
false,true,1037,977,60,0,00:00:00.000,2025-04-14 11:13:11.968
false,false,1041,981,60,128,00:00:31.000,2025-04-14 11:13:21.972
false,false,1054,991,63,125,00:00:30.000,2025-04-14 11:13:59.999
false,false,1058,995,63,97,00:00:33.000,2025-04-14 11:14:20.010
false,false,1216,1144,72,629,00:00:32.000,2025-04-14 11:22:00.338
false,true,1241,1169,72,0,00:00:00.000,2025-04-14 11:23:02.387
false,false,1252,1179,73,347,00:00:31.000,2025-04-14 11:23:36.414
false,true,1268,1195,73,0,00:00:00.000,2025-04-14 11:24:26.457
false,true,1273,1200,73,0,00:00:00.000,2025-04-14 11:24:44.474
false,false,1547,1456,91,1240,00:00:33.000,2025-04-14 11:36:51.002
false,false,590,555,35,1806,00:00:33.000,2025-04-14 10:52:07.044
false,false,593,558,35,1897,00:00:30.000,2025-04-14 10:52:13.047
false,false,617,582,35,126,00:00:31.000,2025-04-14 10:53:13.096
false,false,619,583,36,33,00:00:33.000,2025-04-14 10:53:29.111
false,false,627,591,36,30,00:00:30.000,2025-04-14 10:54:09.141
false,false,628,592,36,62,00:00:32.000,2025-04-14 10:54:11.142
false,false,642,606,36,506,00:00:30.000,2025-04-14 10:54:39.159
false,false,643,607,36,538,00:00:32.000,2025-04-14 10:54:41.161
false,false,645,608,37,602,00:00:31.000,2025-04-14 10:54:45.165
false,false,822,778,44,789,00:00:32.000,2025-04-14 11:02:27.486
false,false,845,799,46,662,00:00:30.000,2025-04-14 11:03:25.538
false,false,850,804,46,823,00:00:33.000,2025-04-14 11:03:35.546
false,false,861,814,47,30,00:00:30.000,2025-04-14 11:04:21.581
false,true,866,819,47,0,00:00:00.000,2025-04-14 11:04:39.596
false,false,867,819,48,32,00:00:32.000,2025-04-14 11:04:45.603
false,false,879,829,50,407,00:00:33.000,2025-04-14 11:05:09.625
false,false,746,705,41,633,00:00:33.000,2025-04-14 10:58:55.333
false,false,773,732,41,33,00:00:33.000,2025-04-14 11:00:25.392
false,false,775,734,41,99,00:00:33.000,2025-04-14 11:00:29.395
false,false,793,752,41,664,00:00:31.000,2025-04-14 11:01:05.422
false,false,796,755,41,761,00:00:31.000,2025-04-14 11:01:11.425
false,false,896,845,51,951,00:00:33.000,2025-04-14 11:05:43.652
false,false,902,851,51,1140,00:00:31.000,2025-04-14 11:05:55.662
false,false,918,867,51,31,00:00:31.000,2025-04-14 11:06:51.701
false,true,918,867,51,0,00:00:00.000,2025-04-14 11:06:53.702
false,true,927,876,51,0,00:00:00.000,2025-04-14 11:07:37.736
false,true,939,888,51,0,00:00:00.000,2025-04-14 11:08:15.762
false,false,945,893,52,188,00:00:30.000,2025-04-14 11:08:33.779
false,false,1190,1118,72,30,00:00:30.000,2025-04-14 11:20:32.266
false,true,1190,1118,72,0,00:00:00.000,2025-04-14 11:20:42.274
false,false,1195,1123,72,156,00:00:31.000,2025-04-14 11:20:54.283
false,true,1196,1124,72,0,00:00:00.000,2025-04-14 11:21:02.288
false,true,1196,1124,72,0,00:00:00.000,2025-04-14 11:21:04.289
false,false,1211,1139,72,471,00:00:31.000,2025-04-14 11:21:50.326
false,false,1212,1140,72,503,00:00:32.000,2025-04-14 11:21:52.329
false,false,1213,1141,72,535,00:00:32.000,2025-04-14 11:21:54.331
false,true,951,897,54,0,00:00:00.000,2025-04-14 11:08:55.793
false,false,959,905,54,251,00:00:31.000,2025-04-14 11:09:13.803
false,false,991,936,55,733,00:00:32.000,2025-04-14 11:10:29.850
false,false,992,937,55,766,00:00:33.000,2025-04-14 11:10:31.852
false,true,996,941,55,0,00:00:00.000,2025-04-14 11:10:49.863
false,true,998,943,55,0,00:00:00.000,2025-04-14 11:11:01.869
false,true,1014,956,58,0,00:00:00.000,2025-04-14 11:11:51.909
false,false,1112,1044,68,64,00:00:32.000,2025-04-14 11:16:44.106
false,true,1113,1045,68,0,00:00:00.000,2025-04-14 11:16:52.110
false,false,1149,1079,70,348,00:00:30.000,2025-04-14 11:18:22.171
false,false,1155,1084,71,532,00:00:30.000,2025-04-14 11:18:34.179
false,false,1042,982,60,159,00:00:31.000,2025-04-14 11:13:23.973
false,true,1050,988,62,0,00:00:00.000,2025-04-14 11:13:41.985
false,false,1051,989,62,32,00:00:32.000,2025-04-14 11:13:53.995
false,false,1081,1015,66,826,00:00:33.000,2025-04-14 11:15:06.039
false,false,1083,1016,67,890,00:00:32.000,2025-04-14 11:15:10.041
false,false,1237,1165,72,1291,00:00:31.000,2025-04-14 11:22:42.372
false,true,1241,1169,72,0,00:00:00.000,2025-04-14 11:23:08.392
false,false,1242,1170,72,32,00:00:32.000,2025-04-14 11:23:16.399
false,false,1255,1182,73,443,00:00:31.000,2025-04-14 11:23:42.415
false,true,1268,1195,73,0,00:00:00.000,2025-04-14 11:24:22.451
false,false,1269,1196,73,30,00:00:30.000,2025-04-14 11:24:34.463
false,false,1273,1200,73,157,00:00:30.000,2025-04-14 11:24:42.471
false,true,1273,1200,73,0,00:00:00.000,2025-04-14 11:24:50.479
false,false,1282,1209,73,279,00:00:31.000,2025-04-14 11:25:12.492
false,false,1541,1451,90,1047,00:00:30.000,2025-04-14 11:36:38.995
false,false,690,652,38,852,00:00:31.000,2025-04-14 10:56:27.222
false,false,703,665,38,1261,00:00:33.000,2025-04-14 10:56:53.242
false,true,707,669,38,0,00:00:00.000,2025-04-14 10:57:07.259
false,false,585,550,35,1648,00:00:33.000,2025-04-14 10:51:57.038
false,false,594,559,35,1929,00:00:32.000,2025-04-14 10:52:15.049
false,false,597,562,35,2022,00:00:33.000,2025-04-14 10:52:21.053
false,false,610,575,35,2425,00:00:30.000,2025-04-14 10:52:47.076
false,true,613,578,35,0,00:00:00.000,2025-04-14 10:53:05.088
false,false,614,579,35,33,00:00:33.000,2025-04-14 10:53:07.090
false,false,641,605,36,476,00:00:32.000,2025-04-14 10:54:37.157
false,false,648,611,37,697,00:00:30.000,2025-04-14 10:54:51.168
false,false,657,620,37,980,00:00:30.000,2025-04-14 10:55:09.176
false,false,809,765,44,382,00:00:32.000,2025-04-14 11:02:01.464
false,false,825,781,44,30,00:00:30.000,2025-04-14 11:02:45.499
false,true,860,813,47,0,00:00:00.000,2025-04-14 11:04:15.578
false,true,866,819,47,0,00:00:00.000,2025-04-14 11:04:33.590
false,false,874,825,49,251,00:00:33.000,2025-04-14 11:04:59.616
false,false,878,828,50,374,00:00:31.000,2025-04-14 11:05:07.623
false,true,797,756,41,0,00:00:00.000,2025-04-14 11:01:25.437
false,false,802,761,41,160,00:00:30.000,2025-04-14 11:01:47.450
false,false,917,866,51,65,00:00:32.000,2025-04-14 11:06:37.695
false,false,930,879,51,96,00:00:32.000,2025-04-14 11:07:51.746
false,false,946,894,52,221,00:00:33.000,2025-04-14 11:08:35.780
false,false,1156,1085,71,33,00:00:33.000,2025-04-14 11:18:48.188
false,true,1174,1103,71,0,00:00:00.000,2025-04-14 11:19:38.222
false,true,1190,1118,72,0,00:00:00.000,2025-04-14 11:20:38.271
false,false,1196,1124,72,186,00:00:30.000,2025-04-14 11:20:56.283
false,true,1196,1124,72,0,00:00:00.000,2025-04-14 11:21:12.298
false,false,1198,1126,72,66,00:00:33.000,2025-04-14 11:21:24.309
false,false,954,900,54,94,00:00:33.000,2025-04-14 11:09:03.796
false,false,955,901,54,126,00:00:32.000,2025-04-14 11:09:05.797
false,false,956,902,54,157,00:00:31.000,2025-04-14 11:09:07.798
false,false,1001,946,55,92,00:00:31.000,2025-04-14 11:11:13.878
false,false,1003,947,56,155,00:00:33.000,2025-04-14 11:11:17.881
false,false,1009,951,58,345,00:00:33.000,2025-04-14 11:11:29.893
false,true,1087,1019,68,0,00:00:00.000,2025-04-14 11:15:42.070
false,false,1093,1025,68,184,00:00:30.000,2025-04-14 11:15:54.080
false,true,1138,1068,70,0,00:00:00.000,2025-04-14 11:17:56.155
false,true,1138,1068,70,0,00:00:00.000,2025-04-14 11:17:58.156
false,false,1147,1077,70,285,00:00:33.000,2025-04-14 11:18:18.169
false,false,1153,1083,70,472,00:00:30.000,2025-04-14 11:18:30.178
false,false,1018,960,58,128,00:00:33.000,2025-04-14 11:12:11.922
false,true,1022,964,58,0,00:00:00.000,2025-04-14 11:12:29.934
false,false,1038,978,60,32,00:00:32.000,2025-04-14 11:13:15.970
false,false,1040,980,60,97,00:00:32.000,2025-04-14 11:13:19.971
false,false,1045,984,61,256,00:00:31.000,2025-04-14 11:13:29.978
false,false,1080,1015,65,793,00:00:31.000,2025-04-14 11:15:04.037
false,false,1245,1172,73,126,00:00:32.000,2025-04-14 11:23:22.402
false,false,1256,1183,73,476,00:00:33.000,2025-04-14 11:23:44.417
false,true,1268,1195,73,0,00:00:00.000,2025-04-14 11:24:32.463
false,false,1278,1205,73,156,00:00:31.000,2025-04-14 11:25:04.490
false,false,1284,1211,73,340,00:00:30.000,2025-04-14 11:25:16.495
false,false,1531,1442,89,726,00:00:32.000,2025-04-14 11:36:18.976
false,true,720,681,39,0,00:00:00.000,2025-04-14 10:57:47.283
false,false,608,573,35,2363,00:00:32.000,2025-04-14 10:52:43.072
false,true,613,578,35,0,00:00:00.000,2025-04-14 10:53:03.087
false,true,618,582,36,0,00:00:00.000,2025-04-14 10:53:19.100
false,true,626,590,36,0,00:00:00.000,2025-04-14 10:53:57.131
false,false,629,593,36,94,00:00:32.000,2025-04-14 10:54:13.142
false,false,640,604,36,444,00:00:32.000,2025-04-14 10:54:35.155
false,false,655,618,37,920,00:00:30.000,2025-04-14 10:55:05.174
false,false,658,621,37,1012,00:00:32.000,2025-04-14 10:55:11.176
false,false,814,770,44,539,00:00:33.000,2025-04-14 11:02:11.472
false,false,816,772,44,601,00:00:30.000,2025-04-14 11:02:15.477
false,false,830,785,45,184,00:00:30.000,2025-04-14 11:02:55.511
false,false,841,796,45,537,00:00:33.000,2025-04-14 11:03:17.530
false,false,864,817,47,125,00:00:33.000,2025-04-14 11:04:27.584
false,false,742,701,41,507,00:00:33.000,2025-04-14 10:58:47.328
false,false,757,716,41,125,00:00:32.000,2025-04-14 10:59:29.356
false,true,759,718,41,0,00:00:00.000,2025-04-14 10:59:45.365
false,false,763,722,41,130,00:00:32.000,2025-04-14 10:59:53.368
false,false,764,723,41,160,00:00:30.000,2025-04-14 10:59:55.370
false,false,765,724,41,192,00:00:32.000,2025-04-14 10:59:57.372
false,true,772,731,41,0,00:00:00.000,2025-04-14 11:00:15.385
false,false,797,756,41,791,00:00:30.000,2025-04-14 11:01:13.426
false,false,889,839,50,724,00:00:32.000,2025-04-14 11:05:29.637
false,false,894,843,51,885,00:00:33.000,2025-04-14 11:05:39.648
false,true,915,864,51,0,00:00:00.000,2025-04-14 11:06:27.687
false,true,917,866,51,0,00:00:00.000,2025-04-14 11:06:45.699
false,false,921,870,51,96,00:00:31.000,2025-04-14 11:07:09.717
false,false,926,875,51,254,00:00:32.000,2025-04-14 11:07:19.727
false,true,926,875,51,0,00:00:00.000,2025-04-14 11:07:27.730
false,false,1161,1090,71,155,00:00:33.000,2025-04-14 11:19:10.203
false,false,1168,1097,71,379,00:00:32.000,2025-04-14 11:19:24.214
false,false,1178,1107,71,127,00:00:30.000,2025-04-14 11:19:56.237
false,false,1185,1113,72,348,00:00:33.000,2025-04-14 11:20:10.249
false,true,1189,1117,72,0,00:00:00.000,2025-04-14 11:20:30.265
false,true,951,897,54,0,00:00:00.000,2025-04-14 11:08:57.793
false,false,953,899,54,61,00:00:30.000,2025-04-14 11:09:01.796
false,false,970,915,55,64,00:00:32.000,2025-04-14 11:09:47.818
false,false,979,924,55,355,00:00:32.000,2025-04-14 11:10:05.831
false,false,982,927,55,449,00:00:31.000,2025-04-14 11:10:11.837
false,true,996,941,55,0,00:00:00.000,2025-04-14 11:10:41.858
false,true,996,941,55,0,00:00:00.000,2025-04-14 11:10:43.858
false,false,997,942,55,32,00:00:32.000,2025-04-14 11:10:53.865
false,false,1005,947,58,218,00:00:30.000,2025-04-14 11:11:21.885
false,true,1014,956,58,0,00:00:00.000,2025-04-14 11:11:45.907
false,true,1085,1018,67,0,00:00:00.000,2025-04-14 11:15:24.052
false,false,1097,1029,68,308,00:00:32.000,2025-04-14 11:16:02.083
false,false,1099,1031,68,368,00:00:30.000,2025-04-14 11:16:06.084
false,false,1101,1033,68,429,00:00:30.000,2025-04-14 11:16:10.087
false,false,1110,1042,68,722,00:00:32.000,2025-04-14 11:16:28.098
false,true,1110,1042,68,0,00:00:00.000,2025-04-14 11:16:34.102
false,true,1110,1042,68,0,00:00:00.000,2025-04-14 11:16:40.106
false,false,1115,1047,68,64,00:00:32.000,2025-04-14 11:17:02.119
false,false,1135,1065,70,698,00:00:32.000,2025-04-14 11:17:42.145
false,false,1137,1067,70,758,00:00:30.000,2025-04-14 11:17:46.150
false,false,1021,963,58,223,00:00:32.000,2025-04-14 11:12:17.925
false,true,1037,977,60,0,00:00:00.000,2025-04-14 11:13:03.962
false,false,1047,986,61,317,00:00:31.000,2025-04-14 11:13:33.982
false,false,1048,987,61,347,00:00:30.000,2025-04-14 11:13:35.983
false,true,1050,988,62,0,00:00:00.000,2025-04-14 11:13:43.988
false,true,1050,988,62,0,00:00:00.000,2025-04-14 11:13:51.995
false,false,1067,1003,64,387,00:00:32.000,2025-04-14 11:14:38.026
false,false,1073,1009,64,574,00:00:32.000,2025-04-14 11:14:50.032
false,false,1219,1147,72,720,00:00:30.000,2025-04-14 11:22:06.343
false,true,1241,1169,72,0,00:00:00.000,2025-04-14 11:23:06.390
false,true,1241,1169,72,0,00:00:00.000,2025-04-14 11:23:14.397
false,true,1262,1189,73,0,00:00:00.000,2025-04-14 11:24:04.435
false,true,1262,1189,73,0,00:00:00.000,2025-04-14 11:24:08.439
false,false,1511,1422,89,96,00:00:32.000,2025-04-14 11:35:38.945
false,false,1517,1428,89,289,00:00:33.000,2025-04-14 11:35:50.955
false,false,1518,1429,89,319,00:00:30.000,2025-04-14 11:35:52.958
false,false,1521,1432,89,414,00:00:33.000,2025-04-14 11:35:58.961
false,false,1522,1433,89,444,00:00:30.000,2025-04-14 11:36:00.962
false,false,1523,1434,89,476,00:00:32.000,2025-04-14 11:36:02.964
false,false,1535,1446,89,856,00:00:32.000,2025-04-14 11:36:26.983
false,false,1540,1450,90,1017,00:00:32.000,2025-04-14 11:36:36.993
false,false,705,667,38,1322,00:00:31.000,2025-04-14 10:56:57.248
false,true,707,669,38,0,00:00:00.000,2025-04-14 10:57:13.263
false,true,720,681,39,0,00:00:00.000,2025-04-14 10:57:49.284
false,false,586,551,35,1681,00:00:33.000,2025-04-14 10:51:59.038
false,false,601,566,35,2146,00:00:33.000,2025-04-14 10:52:29.060
false,false,602,567,35,2176,00:00:30.000,2025-04-14 10:52:31.062
false,true,618,582,36,0,00:00:00.000,2025-04-14 10:53:21.101
false,true,618,582,36,0,00:00:00.000,2025-04-14 10:53:23.104
false,true,626,590,36,0,00:00:00.000,2025-04-14 10:54:07.139
false,false,639,603,36,412,00:00:33.000,2025-04-14 10:54:33.154
false,false,832,787,45,247,00:00:33.000,2025-04-14 11:02:59.514
false,false,837,792,45,408,00:00:31.000,2025-04-14 11:03:09.523
false,false,840,795,45,504,00:00:33.000,2025-04-14 11:03:15.528
false,false,847,801,46,725,00:00:32.000,2025-04-14 11:03:29.542
false,false,865,818,47,156,00:00:31.000,2025-04-14 11:04:29.586
false,false,870,822,48,124,00:00:30.000,2025-04-14 11:04:51.610
false,false,737,696,41,346,00:00:30.000,2025-04-14 10:58:37.320
false,false,738,697,41,378,00:00:32.000,2025-04-14 10:58:39.322
false,false,744,703,41,570,00:00:33.000,2025-04-14 10:58:51.329
false,false,751,710,41,792,00:00:31.000,2025-04-14 10:59:05.341
false,true,759,718,41,0,00:00:00.000,2025-04-14 10:59:39.363
false,false,790,749,41,571,00:00:32.000,2025-04-14 11:00:59.417
false,true,797,756,41,0,00:00:00.000,2025-04-14 11:01:29.441
false,false,913,862,51,1489,00:00:32.000,2025-04-14 11:06:17.681
false,true,926,875,51,0,00:00:00.000,2025-04-14 11:07:21.727
false,false,934,883,51,219,00:00:30.000,2025-04-14 11:07:59.752
false,false,1162,1091,71,187,00:00:32.000,2025-04-14 11:19:12.204
false,false,1194,1122,72,125,00:00:32.000,2025-04-14 11:20:52.281
false,true,1196,1124,72,0,00:00:00.000,2025-04-14 11:21:14.300
false,false,976,921,55,257,00:00:32.000,2025-04-14 11:09:59.829
false,true,998,943,55,0,00:00:00.000,2025-04-14 11:11:03.870
false,false,1087,1019,68,63,00:00:33.000,2025-04-14 11:15:30.060
false,true,1087,1019,68,0,00:00:00.000,2025-04-14 11:15:34.062
false,false,1104,1036,68,526,00:00:33.000,2025-04-14 11:16:16.092
false,false,1107,1039,68,624,00:00:32.000,2025-04-14 11:16:22.095
false,true,1113,1045,68,0,00:00:00.000,2025-04-14 11:16:48.108
false,false,1123,1055,68,317,00:00:33.000,2025-04-14 11:17:18.127
false,false,1127,1059,68,444,00:00:30.000,2025-04-14 11:17:26.133
false,true,1138,1068,70,0,00:00:00.000,2025-04-14 11:17:50.154
false,false,1144,1074,70,188,00:00:31.000,2025-04-14 11:18:12.163
false,false,1150,1080,70,379,00:00:31.000,2025-04-14 11:18:24.172
false,true,1014,956,58,0,00:00:00.000,2025-04-14 11:11:59.915
false,false,1032,973,59,321,00:00:32.000,2025-04-14 11:12:51.951
false,false,1049,988,61,380,00:00:33.000,2025-04-14 11:13:37.984
false,false,1050,988,62,410,00:00:30.000,2025-04-14 11:13:39.985
false,true,1050,988,62,0,00:00:00.000,2025-04-14 11:13:47.993
false,false,1055,992,63,158,00:00:33.000,2025-04-14 11:14:02.001
false,false,1070,1006,64,479,00:00:31.000,2025-04-14 11:14:44.030
false,false,1235,1163,72,1229,00:00:31.000,2025-04-14 11:22:38.368
false,true,1241,1169,72,0,00:00:00.000,2025-04-14 11:22:58.384
false,false,1283,1210,73,310,00:00:31.000,2025-04-14 11:25:14.493
false,false,1515,1426,89,225,00:00:33.000,2025-04-14 11:35:46.952
false,false,1550,1459,91,1335,00:00:32.000,2025-04-14 11:36:57.010
false,false,1557,1464,93,1553,00:00:33.000,2025-04-14 11:37:11.020
false,false,700,662,38,1164,00:00:31.000,2025-04-14 10:56:47.237
false,false,701,663,38,1197,00:00:33.000,2025-04-14 10:56:49.239
false,false,704,666,38,1291,00:00:30.000,2025-04-14 10:56:55.245
false,false,717,679,38,318,00:00:33.000,2025-04-14 10:57:33.274
false,false,721,682,39,31,00:00:31.000,2025-04-14 10:57:53.287
false,false,616,581,35,95,00:00:32.000,2025-04-14 10:53:11.094
false,true,618,582,36,0,00:00:00.000,2025-04-14 10:53:25.107
false,false,620,584,36,33,00:00:33.000,2025-04-14 10:53:43.117
false,true,626,590,36,0,00:00:00.000,2025-04-14 10:54:03.138
false,false,817,773,44,633,00:00:32.000,2025-04-14 11:02:17.479
false,false,824,780,44,850,00:00:31.000,2025-04-14 11:02:31.490
false,false,839,794,45,471,00:00:32.000,2025-04-14 11:03:13.525
false,true,856,809,47,0,00:00:00.000,2025-04-14 11:03:51.557
false,true,856,809,47,0,00:00:00.000,2025-04-14 11:03:57.562
false,false,740,699,41,441,00:00:31.000,2025-04-14 10:58:43.326
false,false,743,702,41,537,00:00:30.000,2025-04-14 10:58:49.328
false,true,753,712,41,0,00:00:00.000,2025-04-14 10:59:13.344
false,false,756,715,41,93,00:00:33.000,2025-04-14 10:59:27.353
false,true,759,718,41,0,00:00:00.000,2025-04-14 10:59:35.359
false,true,772,731,41,0,00:00:00.000,2025-04-14 11:00:19.389
false,false,787,746,41,478,00:00:33.000,2025-04-14 11:00:53.412
false,false,792,751,41,633,00:00:31.000,2025-04-14 11:01:03.420
false,false,795,754,41,730,00:00:33.000,2025-04-14 11:01:09.425
false,true,797,756,41,0,00:00:00.000,2025-04-14 11:01:27.439
false,false,897,846,51,983,00:00:32.000,2025-04-14 11:05:45.653
false,false,900,849,51,1076,00:00:31.000,2025-04-14 11:05:51.658
false,false,910,859,51,1395,00:00:32.000,2025-04-14 11:06:11.675
false,true,917,866,51,0,00:00:00.000,2025-04-14 11:06:49.700
false,true,918,867,51,0,00:00:00.000,2025-04-14 11:07:03.711
false,false,919,868,51,33,00:00:33.000,2025-04-14 11:07:05.712
false,true,926,875,51,0,00:00:00.000,2025-04-14 11:07:29.731
false,true,926,875,51,0,00:00:00.000,2025-04-14 11:07:31.732
false,true,1155,1084,71,0,00:00:00.000,2025-04-14 11:18:44.186
false,true,1156,1085,71,0,00:00:00.000,2025-04-14 11:18:58.197
false,true,1174,1103,71,0,00:00:00.000,2025-04-14 11:19:42.223
false,false,1180,1109,71,188,00:00:31.000,2025-04-14 11:20:00.242
false,true,1196,1124,72,0,00:00:00.000,2025-04-14 11:20:58.284
false,false,1202,1130,72,190,00:00:30.000,2025-04-14 11:21:32.314
false,false,1207,1135,72,347,00:00:31.000,2025-04-14 11:21:42.320
false,true,951,897,54,0,00:00:00.000,2025-04-14 11:08:53.791
false,false,983,928,55,479,00:00:30.000,2025-04-14 11:10:13.838
false,false,989,934,55,669,00:00:33.000,2025-04-14 11:10:25.848
false,true,1085,1018,67,0,00:00:00.000,2025-04-14 11:15:20.047
false,false,1089,1021,68,64,00:00:33.000,2025-04-14 11:15:46.073
false,false,1109,1041,68,690,00:00:33.000,2025-04-14 11:16:26.096
false,false,1146,1076,70,252,00:00:33.000,2025-04-14 11:18:16.168
false,false,1148,1078,70,318,00:00:33.000,2025-04-14 11:18:20.171
false,true,1155,1084,71,0,00:00:00.000,2025-04-14 11:18:36.182
false,false,1015,957,58,33,00:00:33.000,2025-04-14 11:12:05.919
false,false,1017,959,58,95,00:00:32.000,2025-04-14 11:12:09.921
false,false,1026,967,59,127,00:00:33.000,2025-04-14 11:12:39.941
false,false,1043,982,61,192,00:00:33.000,2025-04-14 11:13:25.974
false,false,1044,983,61,225,00:00:33.000,2025-04-14 11:13:27.976
false,false,1236,1164,72,1260,00:00:31.000,2025-04-14 11:22:40.369
false,false,1238,1166,72,1324,00:00:33.000,2025-04-14 11:22:44.374
false,true,1241,1169,72,0,00:00:00.000,2025-04-14 11:23:00.385
false,true,1241,1169,72,0,00:00:00.000,2025-04-14 11:23:04.388
false,false,1251,1178,73,316,00:00:30.000,2025-04-14 11:23:34.412
false,false,1268,1195,73,198,00:00:33.000,2025-04-14 11:24:20.449
false,false,1271,1198,73,94,00:00:32.000,2025-04-14 11:24:38.468
false,false,1533,1444,89,791,00:00:33.000,2025-04-14 11:36:22.979
false,false,1538,1448,90,954,00:00:33.000,2025-04-14 11:36:32.990
false,false,702,664,38,1228,00:00:31.000,2025-04-14 10:56:51.241
false,true,707,669,38,0,00:00:00.000,2025-04-14 10:57:11.262
false,true,720,681,39,0,00:00:00.000,2025-04-14 10:57:41.281
false,false,733,693,40,221,00:00:30.000,2025-04-14 10:58:29.314
false,false,592,557,35,1867,00:00:30.000,2025-04-14 10:52:11.047
false,false,596,561,35,1989,00:00:30.000,2025-04-14 10:52:19.052
false,false,600,565,35,2113,00:00:30.000,2025-04-14 10:52:27.058
false,true,613,578,35,0,00:00:00.000,2025-04-14 10:52:59.084
false,true,613,578,35,0,00:00:00.000,2025-04-14 10:53:01.086
false,false,633,597,36,220,00:00:30.000,2025-04-14 10:54:21.147
false,false,636,600,36,313,00:00:32.000,2025-04-14 10:54:27.151
false,false,637,601,36,346,00:00:33.000,2025-04-14 10:54:29.152
false,false,810,766,44,414,00:00:32.000,2025-04-14 11:02:03.465
false,false,812,768,44,476,00:00:31.000,2025-04-14 11:02:07.466
false,false,813,769,44,506,00:00:30.000,2025-04-14 11:02:09.470
false,false,823,779,44,819,00:00:30.000,2025-04-14 11:02:29.488
false,false,829,784,45,154,00:00:30.000,2025-04-14 11:02:53.507
false,false,849,803,46,790,00:00:32.000,2025-04-14 11:03:33.545
false,false,854,807,47,946,00:00:30.000,2025-04-14 11:03:43.550
false,true,753,712,41,0,00:00:00.000,2025-04-14 10:59:17.346
false,true,759,718,41,0,00:00:00.000,2025-04-14 10:59:43.363
false,true,772,731,41,0,00:00:00.000,2025-04-14 11:00:23.391
false,false,791,750,41,602,00:00:31.000,2025-04-14 11:01:01.418
false,true,797,756,41,0,00:00:00.000,2025-04-14 11:01:17.430
false,false,798,757,41,31,00:00:31.000,2025-04-14 11:01:39.448
false,false,801,760,41,130,00:00:33.000,2025-04-14 11:01:45.448
false,false,804,762,42,224,00:00:32.000,2025-04-14 11:01:51.454
false,false,886,836,50,627,00:00:30.000,2025-04-14 11:05:23.634
false,false,887,837,50,659,00:00:32.000,2025-04-14 11:05:25.635
false,false,893,842,51,852,00:00:30.000,2025-04-14 11:05:37.645
false,false,912,861,51,1457,00:00:32.000,2025-04-14 11:06:15.680
false,true,917,866,51,0,00:00:00.000,2025-04-14 11:06:41.697
false,true,918,867,51,0,00:00:00.000,2025-04-14 11:06:57.708
false,false,923,872,51,158,00:00:31.000,2025-04-14 11:07:13.721
false,true,939,888,51,0,00:00:00.000,2025-04-14 11:08:17.763
false,true,939,888,51,0,00:00:00.000,2025-04-14 11:08:19.764
false,true,1155,1084,71,0,00:00:00.000,2025-04-14 11:18:46.187
false,false,1171,1100,71,473,00:00:31.000,2025-04-14 11:19:30.217
false,true,1174,1103,71,0,00:00:00.000,2025-04-14 11:19:40.223
false,false,1186,1114,72,381,00:00:33.000,2025-04-14 11:20:12.251
false,true,1189,1117,72,0,00:00:00.000,2025-04-14 11:20:26.262
false,true,1196,1124,72,0,00:00:00.000,2025-04-14 11:21:06.291
false,false,1199,1127,72,96,00:00:30.000,2025-04-14 11:21:26.311
false,false,1203,1131,72,222,00:00:32.000,2025-04-14 11:21:34.315
false,false,981,926,55,418,00:00:32.000,2025-04-14 11:10:09.834
false,false,985,930,55,542,00:00:32.000,2025-04-14 11:10:17.842
false,false,993,938,55,797,00:00:31.000,2025-04-14 11:10:33.854
false,true,996,941,55,0,00:00:00.000,2025-04-14 11:10:45.860
false,false,1007,949,58,282,00:00:31.000,2025-04-14 11:11:25.889
false,true,1014,956,58,0,00:00:00.000,2025-04-14 11:11:55.912
false,false,1086,1018,68,30,00:00:30.000,2025-04-14 11:15:28.057
false,false,1098,1030,68,338,00:00:30.000,2025-04-14 11:16:04.083
false,false,1103,1035,68,493,00:00:31.000,2025-04-14 11:16:14.090
false,false,1133,1063,70,634,00:00:30.000,2025-04-14 11:17:38.142
false,false,1139,1069,70,31,00:00:31.000,2025-04-14 11:18:02.157
false,false,1152,1082,70,442,00:00:30.000,2025-04-14 11:18:28.176
false,false,1037,977,60,481,00:00:33.000,2025-04-14 11:13:01.962
false,true,1241,1169,72,0,00:00:00.000,2025-04-14 11:22:56.382
false,true,1241,1169,72,0,00:00:00.000,2025-04-14 11:23:12.395
false,false,1266,1193,73,132,00:00:33.000,2025-04-14 11:24:16.447
false,false,1267,1194,73,165,00:00:33.000,2025-04-14 11:24:18.449
false,false,1516,1427,89,256,00:00:31.000,2025-04-14 11:35:48.954
false,false,696,658,38,1040,00:00:32.000,2025-04-14 10:56:39.229
false,false,726,686,40,190,00:00:31.000,2025-04-14 10:58:03.293
false,false,609,574,35,2395,00:00:32.000,2025-04-14 10:52:45.075
false,false,611,576,35,2456,00:00:31.000,2025-04-14 10:52:49.076
false,true,619,583,36,0,00:00:00.000,2025-04-14 10:53:35.114
false,false,632,596,36,190,00:00:31.000,2025-04-14 10:54:19.145
false,false,638,602,36,379,00:00:33.000,2025-04-14 10:54:31.154
false,false,818,774,44,663,00:00:30.000,2025-04-14 11:02:19.480
false,false,834,789,45,313,00:00:33.000,2025-04-14 11:03:03.517
false,false,853,806,47,916,00:00:32.000,2025-04-14 11:03:41.549
false,true,856,809,47,0,00:00:00.000,2025-04-14 11:03:55.561
false,true,866,819,47,0,00:00:00.000,2025-04-14 11:04:41.598
false,false,868,820,48,62,00:00:30.000,2025-04-14 11:04:47.606
false,false,869,821,48,94,00:00:32.000,2025-04-14 11:04:49.606
false,false,745,704,41,600,00:00:30.000,2025-04-14 10:58:53.330
false,true,753,712,41,0,00:00:00.000,2025-04-14 10:59:11.343
false,true,753,712,41,0,00:00:00.000,2025-04-14 10:59:15.346
false,true,759,718,41,0,00:00:00.000,2025-04-14 10:59:41.363
false,false,768,727,41,285,00:00:32.000,2025-04-14 11:00:03.376
false,false,772,731,41,412,00:00:30.000,2025-04-14 11:00:11.382
false,true,797,756,41,0,00:00:00.000,2025-04-14 11:01:19.432
false,true,797,756,41,0,00:00:00.000,2025-04-14 11:01:37.445
false,false,898,847,51,1013,00:00:30.000,2025-04-14 11:05:47.655
false,false,928,877,51,31,00:00:31.000,2025-04-14 11:07:47.744
false,false,931,880,51,126,00:00:30.000,2025-04-14 11:07:53.748
false,true,1156,1085,71,0,00:00:00.000,2025-04-14 11:18:56.195
false,false,1160,1089,71,122,00:00:31.000,2025-04-14 11:19:08.202
false,false,1181,1110,71,220,00:00:32.000,2025-04-14 11:20:02.244
false,false,1184,1112,72,315,00:00:33.000,2025-04-14 11:20:08.247
false,true,1190,1118,72,0,00:00:00.000,2025-04-14 11:20:34.267
false,false,949,896,53,313,00:00:32.000,2025-04-14 11:08:41.787
false,false,961,907,54,315,00:00:32.000,2025-04-14 11:09:17.805
false,false,969,915,54,32,00:00:32.000,2025-04-14 11:09:45.817
false,false,994,939,55,828,00:00:31.000,2025-04-14 11:10:35.855
false,false,1006,948,58,251,00:00:33.000,2025-04-14 11:11:23.887
false,true,1014,956,58,0,00:00:00.000,2025-04-14 11:11:41.902
false,true,1014,956,58,0,00:00:00.000,2025-04-14 11:11:47.909
false,true,1014,956,58,0,00:00:00.000,2025-04-14 11:11:49.909
false,true,1110,1042,68,0,00:00:00.000,2025-04-14 11:16:38.105
false,false,1111,1043,68,32,00:00:32.000,2025-04-14 11:16:42.106
false,false,1120,1052,68,221,00:00:32.000,2025-04-14 11:17:12.125
false,false,1125,1057,68,381,00:00:31.000,2025-04-14 11:17:22.128
false,false,1130,1061,69,539,00:00:33.000,2025-04-14 11:17:32.138
false,false,1136,1066,70,728,00:00:30.000,2025-04-14 11:17:44.147
false,false,1140,1070,70,63,00:00:32.000,2025-04-14 11:18:04.157
false,false,1019,961,58,158,00:00:30.000,2025-04-14 11:12:13.923
false,false,1035,975,60,416,00:00:31.000,2025-04-14 11:12:57.957
false,false,1068,1004,64,418,00:00:31.000,2025-04-14 11:14:40.027
false,true,1085,1018,67,0,00:00:00.000,2025-04-14 11:15:16.046
false,false,1224,1152,72,878,00:00:33.000,2025-04-14 11:22:16.352
false,false,1226,1154,72,943,00:00:32.000,2025-04-14 11:22:20.357
false,false,1249,1176,73,255,00:00:33.000,2025-04-14 11:23:30.411
false,true,1262,1189,73,0,00:00:00.000,2025-04-14 11:24:02.433
false,true,1273,1200,73,0,00:00:00.000,2025-04-14 11:24:46.476
false,false,1276,1203,73,95,00:00:33.000,2025-04-14 11:25:00.487
false,false,1281,1208,73,248,00:00:30.000,2025-04-14 11:25:10.491
false,true,1508,1419,89,0,00:00:00.000,2025-04-14 11:35:28.940
false,false,1514,1425,89,192,00:00:31.000,2025-04-14 11:35:44.951
false,false,1520,1431,89,381,00:00:31.000,2025-04-14 11:35:56.959
false,false,1552,1460,92,1397,00:00:32.000,2025-04-14 11:37:01.013
false,false,713,675,38,191,00:00:33.000,2025-04-14 10:57:25.268
false,false,720,681,39,412,00:00:33.000,2025-04-14 10:57:39.279
false,true,726,686,40,0,00:00:00.000,2025-04-14 10:58:07.295
false,true,726,686,40,0,00:00:00.000,2025-04-14 10:58:11.296
false,false,729,689,40,96,00:00:31.000,2025-04-14 10:58:21.304
false,false,588,553,35,1741,00:00:30.000,2025-04-14 10:52:03.042
false,false,607,572,35,2331,00:00:30.000,2025-04-14 10:52:41.071
false,false,613,578,35,2516,00:00:30.000,2025-04-14 10:52:53.080
false,true,613,578,35,0,00:00:00.000,2025-04-14 10:52:55.080
false,true,613,578,35,0,00:00:00.000,2025-04-14 10:52:57.082
false,true,626,590,36,0,00:00:00.000,2025-04-14 10:54:01.136
false,false,644,607,37,571,00:00:33.000,2025-04-14 10:54:43.163
false,false,827,783,44,94,00:00:31.000,2025-04-14 11:02:49.502
false,false,842,797,45,568,00:00:31.000,2025-04-14 11:03:19.530
false,false,859,812,47,99,00:00:33.000,2025-04-14 11:04:05.567
false,true,860,813,47,0,00:00:00.000,2025-04-14 11:04:11.574
false,false,752,711,41,825,00:00:33.000,2025-04-14 10:59:07.342
false,false,769,728,41,316,00:00:31.000,2025-04-14 11:00:05.377
false,false,774,733,41,66,00:00:33.000,2025-04-14 11:00:27.393
false,false,777,736,41,161,00:00:31.000,2025-04-14 11:00:33.396
false,false,784,743,41,383,00:00:31.000,2025-04-14 11:00:47.407
false,false,785,744,41,415,00:00:32.000,2025-04-14 11:00:49.408
false,false,789,748,41,539,00:00:30.000,2025-04-14 11:00:57.414
false,true,797,756,41,0,00:00:00.000,2025-04-14 11:01:35.444
false,false,899,848,51,1045,00:00:32.000,2025-04-14 11:05:49.655
false,false,905,854,51,1234,00:00:33.000,2025-04-14 11:06:01.666
false,true,915,864,51,0,00:00:00.000,2025-04-14 11:06:33.691
false,true,917,866,51,0,00:00:00.000,2025-04-14 11:06:43.698
false,true,927,876,51,0,00:00:00.000,2025-04-14 11:07:39.739
false,true,1156,1085,71,0,00:00:00.000,2025-04-14 11:18:50.189
false,false,1163,1092,71,220,00:00:33.000,2025-04-14 11:19:14.205
false,false,1164,1093,71,251,00:00:31.000,2025-04-14 11:19:16.207
false,false,1165,1094,71,283,00:00:32.000,2025-04-14 11:19:18.209
false,true,1174,1103,71,0,00:00:00.000,2025-04-14 11:19:48.231
false,false,1175,1104,71,31,00:00:31.000,2025-04-14 11:19:50.232
false,false,1188,1116,72,446,00:00:33.000,2025-04-14 11:20:16.255
false,true,1189,1117,72,0,00:00:00.000,2025-04-14 11:20:20.259
false,true,1189,1117,72,0,00:00:00.000,2025-04-14 11:20:28.263
false,true,1196,1124,72,0,00:00:00.000,2025-04-14 11:21:16.302
false,false,968,914,54,534,00:00:32.000,2025-04-14 11:09:31.813
false,false,995,940,55,858,00:00:30.000,2025-04-14 11:10:37.856
false,true,996,941,55,0,00:00:00.000,2025-04-14 11:10:51.864
false,false,1000,945,55,61,00:00:30.000,2025-04-14 11:11:11.876
false,false,1010,952,58,378,00:00:33.000,2025-04-14 11:11:31.895
false,false,1014,956,58,503,00:00:32.000,2025-04-14 11:11:39.900
false,false,1095,1027,68,246,00:00:30.000,2025-04-14 11:15:58.082
false,false,1096,1028,68,276,00:00:30.000,2025-04-14 11:16:00.082
false,false,1106,1038,68,592,00:00:33.000,2025-04-14 11:16:20.094
false,false,1118,1050,68,158,00:00:32.000,2025-04-14 11:17:08.122
false,false,1124,1056,68,350,00:00:33.000,2025-04-14 11:17:20.127
false,false,1128,1060,68,476,00:00:32.000,2025-04-14 11:17:28.133
false,false,1138,1068,70,789,00:00:31.000,2025-04-14 11:17:48.153
false,false,1142,1072,70,124,00:00:30.000,2025-04-14 11:18:08.161
false,false,1154,1083,71,502,00:00:30.000,2025-04-14 11:18:32.179
false,false,1029,970,59,226,00:00:33.000,2025-04-14 11:12:45.947
false,true,1037,977,60,0,00:00:00.000,2025-04-14 11:13:07.966
false,true,1055,992,63,0,00:00:00.000,2025-04-14 11:14:10.005
false,false,1060,997,63,160,00:00:31.000,2025-04-14 11:14:24.015
false,false,1065,1001,64,322,00:00:32.000,2025-04-14 11:14:34.023
false,false,1215,1143,72,597,00:00:30.000,2025-04-14 11:21:58.336
false,false,1217,1145,72,660,00:00:31.000,2025-04-14 11:22:02.339
false,false,1220,1148,72,751,00:00:31.000,2025-04-14 11:22:08.345
false,false,1225,1153,72,911,00:00:33.000,2025-04-14 11:22:18.354
false,false,1229,1157,72,1039,00:00:31.000,2025-04-14 11:22:26.361
false,false,1254,1181,73,412,00:00:33.000,2025-04-14 11:23:40.414
false,true,1262,1189,73,0,00:00:00.000,2025-04-14 11:24:06.438
false,true,1268,1195,73,0,00:00:00.000,2025-04-14 11:24:28.459
false,false,1280,1207,73,218,00:00:31.000,2025-04-14 11:25:08.491
false,true,1508,1419,89,0,00:00:00.000,2025-04-14 11:35:24.938
false,true,1508,1419,89,0,00:00:00.000,2025-04-14 11:35:26.939
false,false,1536,1446,90,888,00:00:32.000,2025-04-14 11:36:28.985
false,false,1543,1452,91,1113,00:00:33.000,2025-04-14 11:36:42.998
false,false,1544,1453,91,1144,00:00:31.000,2025-04-14 11:36:45.000
false,false,708,670,38,30,00:00:30.000,2025-04-14 10:57:15.265
false,false,712,674,38,158,00:00:32.000,2025-04-14 10:57:23.268
false,false,725,685,40,159,00:00:32.000,2025-04-14 10:58:01.292
false,false,732,692,40,191,00:00:33.000,2025-04-14 10:58:27.312
false,false,603,568,35,2208,00:00:32.000,2025-04-14 10:52:33.064
false,true,618,582,36,0,00:00:00.000,2025-04-14 10:53:27.109
false,true,619,583,36,0,00:00:00.000,2025-04-14 10:53:37.114
false,true,619,583,36,0,00:00:00.000,2025-04-14 10:53:39.115
false,false,647,610,37,667,00:00:33.000,2025-04-14 10:54:49.166
false,false,808,764,44,350,00:00:30.000,2025-04-14 11:01:59.463
false,false,836,791,45,377,00:00:32.000,2025-04-14 11:03:07.521
false,true,860,813,47,0,00:00:00.000,2025-04-14 11:04:17.579
false,false,882,832,50,502,00:00:32.000,2025-04-14 11:05:15.628
false,false,741,700,41,474,00:00:33.000,2025-04-14 10:58:45.327
false,false,747,706,41,666,00:00:33.000,2025-04-14 10:58:57.334
false,false,760,719,41,33,00:00:33.000,2025-04-14 10:59:47.365
false,false,766,725,41,223,00:00:31.000,2025-04-14 10:59:59.373
false,true,772,731,41,0,00:00:00.000,2025-04-14 11:00:17.388
false,false,782,741,41,321,00:00:31.000,2025-04-14 11:00:43.404
false,false,915,864,51,1550,00:00:30.000,2025-04-14 11:06:21.683
false,false,920,869,51,65,00:00:32.000,2025-04-14 11:07:07.714
false,false,922,871,51,127,00:00:31.000,2025-04-14 11:07:11.721
false,false,927,876,51,33,00:00:33.000,2025-04-14 11:07:33.733
false,false,929,878,51,64,00:00:33.000,2025-04-14 11:07:49.745
false,false,938,887,51,350,00:00:33.000,2025-04-14 11:08:07.760
false,false,944,892,52,158,00:00:32.000,2025-04-14 11:08:31.778
false,true,1174,1103,71,0,00:00:00.000,2025-04-14 11:19:46.229
false,true,1196,1124,72,0,00:00:00.000,2025-04-14 11:21:00.288
false,true,1196,1124,72,0,00:00:00.000,2025-04-14 11:21:18.305
false,false,1204,1132,72,255,00:00:33.000,2025-04-14 11:21:36.316
false,false,952,898,54,31,00:00:31.000,2025-04-14 11:08:59.794
false,true,968,914,54,0,00:00:00.000,2025-04-14 11:09:33.813
false,true,968,914,54,0,00:00:00.000,2025-04-14 11:09:35.814
false,true,968,914,54,0,00:00:00.000,2025-04-14 11:09:43.817
false,true,998,943,55,0,00:00:00.000,2025-04-14 11:10:57.868
false,true,1014,956,58,0,00:00:00.000,2025-04-14 11:11:53.910
false,false,1088,1020,68,31,00:00:31.000,2025-04-14 11:15:44.072
false,true,1113,1045,68,0,00:00:00.000,2025-04-14 11:16:54.112
false,false,1122,1054,68,284,00:00:30.000,2025-04-14 11:17:16.126
false,false,1141,1071,70,94,00:00:31.000,2025-04-14 11:18:06.159
false,true,1022,964,58,0,00:00:00.000,2025-04-14 11:12:21.928
false,false,1028,969,59,193,00:00:33.000,2025-04-14 11:12:43.945
false,false,1031,972,59,289,00:00:30.000,2025-04-14 11:12:49.949
false,true,1055,992,63,0,00:00:00.000,2025-04-14 11:14:14.006
false,false,1063,999,64,257,00:00:31.000,2025-04-14 11:14:30.019
false,false,1077,1012,65,698,00:00:30.000,2025-04-14 11:14:58.036
false,false,1079,1014,65,762,00:00:33.000,2025-04-14 11:15:02.038
false,false,1218,1146,72,690,00:00:30.000,2025-04-14 11:22:04.340
false,false,1221,1149,72,783,00:00:32.000,2025-04-14 11:22:10.346
false,false,1247,1174,73,190,00:00:31.000,2025-04-14 11:23:26.406
false,false,1258,1185,73,537,00:00:31.000,2025-04-14 11:23:48.418
false,false,1259,1186,73,569,00:00:32.000,2025-04-14 11:23:50.419
false,false,1261,1188,73,633,00:00:31.000,2025-04-14 11:23:54.425
false,false,1263,1190,73,33,00:00:33.000,2025-04-14 11:24:10.441
false,false,1265,1192,73,99,00:00:33.000,2025-04-14 11:24:14.445
false,true,1273,1200,73,0,00:00:00.000,2025-04-14 11:24:54.482
false,false,1275,1202,73,62,00:00:32.000,2025-04-14 11:24:58.485
false,false,1510,1421,89,64,00:00:33.000,2025-04-14 11:35:36.945
false,false,1528,1439,89,633,00:00:30.000,2025-04-14 11:36:12.972
false,false,1534,1445,89,824,00:00:33.000,2025-04-14 11:36:24.980
false,false,1542,1451,91,1080,00:00:33.000,2025-04-14 11:36:40.996
false,false,1556,1463,93,1520,00:00:31.000,2025-04-14 11:37:09.019
false,false,707,669,38,1385,00:00:30.000,2025-04-14 10:57:01.253
false,false,716,678,38,285,00:00:31.000,2025-04-14 10:57:31.274
false,false,719,680,39,379,00:00:31.000,2025-04-14 10:57:37.277
false,false,722,683,39,63,00:00:32.000,2025-04-14 10:57:55.290
false,false,723,684,39,94,00:00:31.000,2025-04-14 10:57:57.291
false,false,598,563,35,2052,00:00:30.000,2025-04-14 10:52:23.056
false,false,604,569,35,2238,00:00:30.000,2025-04-14 10:52:35.065
false,true,619,583,36,0,00:00:00.000,2025-04-14 10:53:31.112
false,true,619,583,36,0,00:00:00.000,2025-04-14 10:53:41.116
false,false,630,594,36,126,00:00:32.000,2025-04-14 10:54:15.143
false,false,649,612,37,729,00:00:32.000,2025-04-14 10:54:53.169
false,false,651,614,37,795,00:00:33.000,2025-04-14 10:54:57.171
false,false,652,615,37,828,00:00:33.000,2025-04-14 10:54:59.171
false,false,660,623,37,1077,00:00:33.000,2025-04-14 10:55:15.177
false,false,811,767,44,445,00:00:31.000,2025-04-14 11:02:05.466
false,true,824,780,44,0,00:00:00.000,2025-04-14 11:02:39.493
false,true,824,780,44,0,00:00:00.000,2025-04-14 11:02:41.496
false,false,866,819,47,186,00:00:30.000,2025-04-14 11:04:31.588
false,false,872,824,48,187,00:00:32.000,2025-04-14 11:04:55.613
false,false,749,708,41,730,00:00:32.000,2025-04-14 10:59:01.338
false,true,772,731,41,0,00:00:00.000,2025-04-14 11:00:13.383
false,false,780,739,41,258,00:00:33.000,2025-04-14 11:00:39.402
false,false,781,740,41,290,00:00:32.000,2025-04-14 11:00:41.402
false,true,797,756,41,0,00:00:00.000,2025-04-14 11:01:21.433
false,true,797,756,41,0,00:00:00.000,2025-04-14 11:01:23.435
false,false,805,763,42,257,00:00:33.000,2025-04-14 11:01:53.457
false,false,806,764,42,287,00:00:30.000,2025-04-14 11:01:55.461
false,false,890,839,51,757,00:00:33.000,2025-04-14 11:05:31.640
false,false,906,855,51,1265,00:00:31.000,2025-04-14 11:06:03.668
false,false,1159,1088,71,91,00:00:30.000,2025-04-14 11:19:06.201
false,false,1172,1101,71,506,00:00:33.000,2025-04-14 11:19:32.218
false,false,1177,1106,71,97,00:00:33.000,2025-04-14 11:19:54.236
false,true,1196,1124,72,0,00:00:00.000,2025-04-14 11:21:10.296
false,true,1196,1124,72,0,00:00:00.000,2025-04-14 11:21:20.306
false,false,1201,1129,72,160,00:00:32.000,2025-04-14 11:21:30.313
false,false,962,908,54,346,00:00:31.000,2025-04-14 11:09:19.806
false,true,968,914,54,0,00:00:00.000,2025-04-14 11:09:39.816
false,false,984,929,55,510,00:00:31.000,2025-04-14 11:10:15.840
false,true,998,943,55,0,00:00:00.000,2025-04-14 11:11:07.872
false,false,1012,954,58,441,00:00:30.000,2025-04-14 11:11:35.899
false,false,1102,1034,68,462,00:00:33.000,2025-04-14 11:16:12.089
false,false,1134,1064,70,666,00:00:32.000,2025-04-14 11:17:40.143
false,true,1138,1068,70,0,00:00:00.000,2025-04-14 11:17:54.155
false,true,1014,956,58,0,00:00:00.000,2025-04-14 11:12:03.917
false,false,1022,964,58,255,00:00:32.000,2025-04-14 11:12:19.926
false,true,1037,977,60,0,00:00:00.000,2025-04-14 11:13:09.967
false,false,1056,993,63,31,00:00:31.000,2025-04-14 11:14:16.008
false,false,1078,1013,65,729,00:00:31.000,2025-04-14 11:15:00.036
false,false,1222,1150,72,813,00:00:30.000,2025-04-14 11:22:12.348
false,false,1227,1155,72,975,00:00:32.000,2025-04-14 11:22:22.359
false,false,1228,1156,72,1008,00:00:33.000,2025-04-14 11:22:24.359
false,true,1241,1169,72,0,00:00:00.000,2025-04-14 11:23:10.393
false,false,1260,1187,73,602,00:00:33.000,2025-04-14 11:23:52.422
false,true,1268,1195,73,0,00:00:00.000,2025-04-14 11:24:24.454
false,false,1507,1418,89,659,00:00:33.000,2025-04-14 11:35:18.931
false,true,1508,1419,89,0,00:00:00.000,2025-04-14 11:35:30.941
true,true,1138,1068,70,0,00:00:00.000,2025-04-14 11:18:00.157
true,false,1061,998,63,193,00:00:33.000,2025-04-14 11:14:26.016
true,false,1549,1458,91,1303,00:00:33.000,2025-04-14 11:36:55.009
true,false,730,690,40,126,00:00:30.000,2025-04-14 10:58:23.307
true,false,965,911,54,438,00:00:32.000,2025-04-14 11:09:25.811
true,true,772,731,41,0,00:00:00.000,2025-04-14 11:00:21.390
true,true,797,756,41,0,00:00:00.000,2025-04-14 11:01:15.427
true,false,1200,1128,72,128,00:00:32.000,2025-04-14 11:21:28.312
true,false,1257,1184,73,506,00:00:30.000,2025-04-14 11:23:46.418
true,true,1508,1419,89,0,00:00:00.000,2025-04-14 11:35:32.943
true,true,998,943,55,0,00:00:00.000,2025-04-14 11:11:05.871
true,true,1055,992,63,0,00:00:00.000,2025-04-14 11:14:06.003
true,false,1187,1115,72,413,00:00:32.000,2025-04-14 11:20:14.253
true,true,707,669,38,0,00:00:00.000,2025-04-14 10:57:03.256
true,false,942,891,51,96,00:00:31.000,2025-04-14 11:08:27.774
true,false,1264,1191,73,66,00:00:33.000,2025-04-14 11:24:12.442
true,false,1274,1201,73,30,00:00:30.000,2025-04-14 11:24:56.483
true,false,1529,1440,89,664,00:00:31.000,2025-04-14 11:36:14.974
true,false,1189,1117,72,476,00:00:30.000,2025-04-14 11:20:18.257
true,false,838,793,45,439,00:00:31.000,2025-04-14 11:03:11.524
true,false,1100,1032,68,399,00:00:31.000,2025-04-14 11:16:08.086
true,false,1121,1053,68,254,00:00:33.000,2025-04-14 11:17:14.126
true,true,1055,992,63,0,00:00:00.000,2025-04-14 11:14:08.003
true,false,831,786,45,214,00:00:30.000,2025-04-14 11:02:57.511
true,false,788,747,41,509,00:00:31.000,2025-04-14 11:00:55.412
true,true,915,864,51,0,00:00:00.000,2025-04-14 11:06:29.688
true,false,1057,994,63,64,00:00:33.000,2025-04-14 11:14:18.009
true,false,691,653,38,883,00:00:31.000,2025-04-14 10:56:29.225
true,false,852,806,46,884,00:00:31.000,2025-04-14 11:03:39.547
true,false,758,717,41,155,00:00:30.000,2025-04-14 10:59:31.357
true,false,987,932,55,605,00:00:32.000,2025-04-14 11:10:21.845
true,false,591,556,35,1837,00:00:31.000,2025-04-14 10:52:09.045
true,false,1205,1133,72,286,00:00:31.000,2025-04-14 11:21:38.317
true,false,694,656,38,977,00:00:32.000,2025-04-14 10:56:35.228
true,true,860,813,47,0,00:00:00.000,2025-04-14 11:04:13.576
true,false,783,742,41,352,00:00:31.000,2025-04-14 11:00:45.405
true,false,907,856,51,1298,00:00:33.000,2025-04-14 11:06:05.670
true,false,911,860,51,1425,00:00:30.000,2025-04-14 11:06:13.677
true,false,1157,1086,71,31,00:00:31.000,2025-04-14 11:19:02.201
true,false,1209,1137,72,408,00:00:31.000,2025-04-14 11:21:46.323
true,false,1091,1023,68,124,00:00:30.000,2025-04-14 11:15:50.077
true,true,1113,1045,68,0,00:00:00.000,2025-04-14 11:16:56.113
true,true,726,686,40,0,00:00:00.000,2025-04-14 10:58:09.295
true,false,728,688,40,65,00:00:33.000,2025-04-14 10:58:19.302
true,false,939,888,51,380,00:00:30.000,2025-04-14 11:08:09.761
true,false,1166,1095,71,315,00:00:32.000,2025-04-14 11:19:20.210
true,true,1138,1068,70,0,00:00:00.000,2025-04-14 11:17:52.154
true,false,821,777,44,757,00:00:30.000,2025-04-14 11:02:25.484
true,true,726,686,40,0,00:00:00.000,2025-04-14 10:58:13.298
true,true,860,813,47,0,00:00:00.000,2025-04-14 11:04:19.581
true,true,1190,1118,72,0,00:00:00.000,2025-04-14 11:20:40.272
true,false,1084,1017,67,923,00:00:33.000,2025-04-14 11:15:12.042
true,false,1509,1420,89,31,00:00:31.000,2025-04-14 11:35:34.943
false,false,1526,1437,89,572,00:00:31.000,2025-04-14 11:36:08.969
false,false,1527,1438,89,603,00:00:31.000,2025-04-14 11:36:10.969
false,false,1548,1457,91,1270,00:00:30.000,2025-04-14 11:36:53.005
false,false,1558,1465,93,1584,00:00:31.000,2025-04-14 11:37:13.022
false,false,1577,1482,95,2186,00:00:32.000,2025-04-14 11:37:51.051
false,false,1579,1484,95,2252,00:00:33.000,2025-04-14 11:37:55.055
false,false,1580,1485,95,2285,00:00:33.000,2025-04-14 11:37:57.055
false,false,1584,1489,95,2408,00:00:32.000,2025-04-14 11:38:05.060
false,false,1593,1498,95,192,00:00:33.000,2025-04-14 11:38:35.077
false,false,1314,1239,75,726,00:00:33.000,2025-04-14 11:26:28.542
false,false,1316,1241,75,792,00:00:33.000,2025-04-14 11:26:32.544
false,false,1318,1243,75,857,00:00:33.000,2025-04-14 11:26:36.547
false,false,1350,1272,78,1860,00:00:30.000,2025-04-14 11:27:40.597
false,false,1359,1280,79,2139,00:00:30.000,2025-04-14 11:27:58.613
false,true,1364,1285,79,0,00:00:00.000,2025-04-14 11:28:16.629
false,false,1467,1381,86,820,00:00:30.000,2025-04-14 11:33:22.845
false,false,1474,1388,86,30,00:00:30.000,2025-04-14 11:33:48.862
false,false,1480,1393,87,195,00:00:33.000,2025-04-14 11:34:12.881
false,true,1486,1399,87,0,00:00:00.000,2025-04-14 11:34:32.899
false,false,1499,1412,87,405,00:00:30.000,2025-04-14 11:35:02.919
false,true,1370,1290,80,0,00:00:00.000,2025-04-14 11:28:42.642
false,true,1375,1295,80,0,00:00:00.000,2025-04-14 11:29:00.655
false,false,1382,1300,82,224,00:00:31.000,2025-04-14 11:29:20.668
false,false,1411,1328,83,349,00:00:31.000,2025-04-14 11:30:42.736
false,false,1412,1329,83,382,00:00:33.000,2025-04-14 11:30:44.738
false,false,1425,1340,85,789,00:00:31.000,2025-04-14 11:31:10.754
false,false,1426,1341,85,822,00:00:33.000,2025-04-14 11:31:12.754
false,false,1428,1343,85,883,00:00:30.000,2025-04-14 11:31:16.758
false,true,1428,1343,85,0,00:00:00.000,2025-04-14 11:31:20.761
false,true,1428,1343,85,0,00:00:00.000,2025-04-14 11:31:22.763
false,false,424,394,30,1755,00:00:30.000,2025-04-16 10:22:53.921
false,false,436,405,31,2137,00:00:31.000,2025-04-16 10:22:59.931
false,false,283,265,18,32,00:00:32.000,2025-04-16 10:21:31.296
false,false,322,300,22,373,00:00:32.000,2025-04-16 10:21:59.839
false,true,235,218,17,0,00:00:00.000,2025-04-16 10:20:52.749
false,false,250,233,17,64,00:00:32.000,2025-04-16 10:21:08.771
false,false,251,234,17,95,00:00:31.000,2025-04-16 10:21:09.271
false,false,356,330,26,1448,00:00:30.000,2025-04-16 10:22:16.867
false,false,363,337,26,1669,00:00:32.000,2025-04-16 10:22:20.372
false,true,482,450,32,0,00:00:00.000,2025-04-16 10:23:37.488
false,false,489,457,32,217,00:00:32.000,2025-04-16 10:23:44.495
false,false,494,462,32,374,00:00:31.000,2025-04-16 10:23:46.999
false,true,516,483,33,0,00:00:00.000,2025-04-16 10:24:01.522
false,true,516,483,33,0,00:00:00.000,2025-04-16 10:24:04.025
false,false,523,490,33,33,00:00:33.000,2025-04-16 10:24:10.537
false,false,1139,1072,67,761,00:00:32.000,2025-04-15 09:20:51.216
false,false,1142,1075,67,97,00:00:33.000,2025-04-15 09:21:00.222
false,false,1151,1084,67,388,00:00:33.000,2025-04-15 09:21:09.230
false,false,1175,1105,70,1143,00:00:31.000,2025-04-15 09:21:33.253
false,false,1177,1107,70,1205,00:00:30.000,2025-04-15 09:21:35.254
false,false,1183,1113,70,1391,00:00:31.000,2025-04-15 09:21:41.261
false,false,1184,1114,70,1421,00:00:30.000,2025-04-15 09:21:42.262
false,true,1186,1115,71,0,00:00:00.000,2025-04-15 09:21:45.263
false,true,1186,1115,71,0,00:00:00.000,2025-04-15 09:21:50.268
false,false,1194,1120,74,247,00:00:30.000,2025-04-15 09:21:58.277
false,false,1197,1123,74,98,00:00:32.000,2025-04-15 09:22:07.286
false,false,1213,1139,74,605,00:00:31.000,2025-04-15 09:22:23.296
false,false,1233,1158,75,1244,00:00:30.000,2025-04-15 09:22:43.316
false,true,1247,1171,76,0,00:00:00.000,2025-04-15 09:22:58.332
false,false,1251,1174,77,125,00:00:30.000,2025-04-15 09:23:07.340
false,false,1256,1179,77,285,00:00:31.000,2025-04-15 09:23:12.347
false,true,1263,1186,77,0,00:00:00.000,2025-04-15 09:23:22.358
false,false,1278,1199,79,474,00:00:31.000,2025-04-15 09:23:40.376
false,false,1292,1211,81,915,00:00:30.000,2025-04-15 09:23:54.394
false,true,1307,1225,82,0,00:00:00.000,2025-04-15 09:24:13.413
false,false,1317,1235,82,317,00:00:32.000,2025-04-15 09:24:25.426
false,false,1320,1238,82,412,00:00:33.000,2025-04-15 09:24:28.427
false,false,1338,1254,84,976,00:00:32.000,2025-04-15 09:24:46.453
false,false,1342,1258,84,1097,00:00:31.000,2025-04-15 09:24:50.457
false,false,1352,1268,84,1410,00:00:31.000,2025-04-15 09:25:00.470
false,true,1352,1268,84,0,00:00:00.000,2025-04-15 09:25:03.473
false,false,1380,1296,84,817,00:00:30.000,2025-04-15 09:25:40.510
false,false,1120,1054,66,159,00:00:32.000,2025-04-15 09:20:32.198
false,false,1122,1056,66,221,00:00:31.000,2025-04-15 09:20:34.201
false,true,1381,1297,84,0,00:00:00.000,2025-04-15 09:25:47.520
false,false,1393,1306,87,369,00:00:33.000,2025-04-15 09:25:59.533
false,false,1402,1315,87,654,00:00:33.000,2025-04-15 09:26:08.544
false,false,1416,1329,87,1097,00:00:30.000,2025-04-15 09:26:22.562
false,false,1419,1332,87,1191,00:00:31.000,2025-04-15 09:26:25.565
false,false,1424,1337,87,1348,00:00:32.000,2025-04-15 09:26:30.571
false,false,1428,1341,87,61,00:00:30.000,2025-04-15 09:26:40.580
false,false,1429,1342,87,91,00:00:30.000,2025-04-15 09:26:41.581
false,false,1432,1345,87,183,00:00:30.000,2025-04-15 09:26:44.584
false,false,1435,1348,87,278,00:00:31.000,2025-04-15 09:26:47.587
false,false,1440,1353,87,440,00:00:33.000,2025-04-15 09:26:52.593
false,true,1463,1374,89,0,00:00:00.000,2025-04-15 09:27:26.626
false,false,1470,1380,90,218,00:00:30.000,2025-04-15 09:27:34.633
false,false,1472,1382,90,280,00:00:30.000,2025-04-15 09:27:36.636
false,true,1508,1414,94,0,00:00:00.000,2025-04-15 09:28:29.684
false,false,1516,1422,94,251,00:00:31.000,2025-04-15 09:28:38.694
false,false,1581,1480,101,667,00:00:32.000,2025-04-15 09:29:55.776
false,false,1584,1482,102,763,00:00:32.000,2025-04-15 09:29:58.777
false,true,1585,1483,102,0,00:00:00.000,2025-04-15 09:30:04.784
false,false,1596,1494,102,96,00:00:32.000,2025-04-15 09:30:22.804
false,false,1599,1497,102,191,00:00:32.000,2025-04-15 09:30:25.808
false,false,1600,1498,102,222,00:00:31.000,2025-04-15 09:30:26.810
false,false,1727,1618,109,3681,00:00:30.000,2025-04-15 09:32:45.937
false,false,1740,1631,109,4081,00:00:30.000,2025-04-15 09:32:58.949
false,true,1744,1635,109,0,00:00:00.000,2025-04-15 09:33:06.957
false,false,1752,1642,110,253,00:00:31.000,2025-04-15 09:33:16.969
false,false,1758,1648,110,161,00:00:31.000,2025-04-15 09:33:28.985
false,true,1762,1652,110,0,00:00:00.000,2025-04-15 09:33:36.995
false,false,1618,1516,102,247,00:00:30.000,2025-04-15 09:30:56.833
false,false,1652,1549,103,1319,00:00:33.000,2025-04-15 09:31:30.866
false,false,1678,1573,105,2139,00:00:33.000,2025-04-15 09:31:56.890
false,false,1695,1587,108,2674,00:00:31.000,2025-04-15 09:32:13.908
false,false,1698,1590,108,2766,00:00:32.000,2025-04-15 09:32:16.912
false,false,1700,1592,108,2828,00:00:31.000,2025-04-15 09:32:18.914
false,false,1790,1678,112,126,00:00:32.000,2025-04-15 09:34:25.047
false,true,1793,1681,112,0,00:00:00.000,2025-04-15 09:34:29.051
false,false,1804,1691,113,342,00:00:33.000,2025-04-15 09:34:45.066
false,false,1806,1693,113,405,00:00:31.000,2025-04-15 09:34:47.069
false,false,1807,1694,113,437,00:00:32.000,2025-04-15 09:34:48.071
false,false,1808,1695,113,469,00:00:32.000,2025-04-15 09:34:49.072
false,true,1811,1698,113,0,00:00:00.000,2025-04-15 09:34:53.077
false,false,1813,1700,113,63,00:00:30.000,2025-04-15 09:35:00.085
false,true,1830,1717,113,0,00:00:00.000,2025-04-15 09:35:34.119
false,false,1840,1726,114,305,00:00:32.000,2025-04-15 09:35:45.132
false,false,1853,1739,114,345,00:00:33.000,2025-04-15 09:36:04.152
false,false,1879,1764,115,1154,00:00:31.000,2025-04-15 09:36:30.182
false,true,1881,1766,115,0,00:00:00.000,2025-04-15 09:36:35.187
false,true,1891,1775,116,0,00:00:00.000,2025-04-15 09:36:59.216
false,false,1903,1787,116,367,00:00:30.000,2025-04-15 09:37:12.230
false,false,1907,1791,116,491,00:00:30.000,2025-04-15 09:37:16.232
false,true,1914,1797,117,0,00:00:00.000,2025-04-15 09:37:26.244
false,true,1914,1797,117,0,00:00:00.000,2025-04-15 09:37:29.248
false,false,1927,1810,117,346,00:00:31.000,2025-04-15 09:37:48.267
false,false,1944,1826,118,412,00:00:30.000,2025-04-15 09:38:17.299
false,true,1951,1833,118,0,00:00:00.000,2025-04-15 09:38:29.311
false,false,1957,1839,118,188,00:00:32.000,2025-04-15 09:38:36.322
false,false,1968,1850,118,539,00:00:31.000,2025-04-15 09:38:47.334
false,true,1971,1852,119,0,00:00:00.000,2025-04-15 09:38:56.344
false,true,1975,1856,119,0,00:00:00.000,2025-04-15 09:39:01.349
false,false,2051,1925,126,503,00:00:33.000,2025-04-15 09:40:52.454
false,true,2068,1942,126,0,00:00:00.000,2025-04-15 09:41:10.474
false,false,2077,1950,127,286,00:00:31.000,2025-04-15 09:41:24.486
false,false,2082,1955,127,447,00:00:32.000,2025-04-15 09:41:29.493
false,false,2091,1964,127,726,00:00:32.000,2025-04-15 09:41:38.503
false,false,2095,1968,127,123,00:00:32.000,2025-04-15 09:41:48.513
false,false,2141,2011,130,1568,00:00:31.000,2025-04-15 09:42:34.563
false,false,2174,2041,133,2611,00:00:33.000,2025-04-15 09:43:07.593
false,false,2176,2043,133,2676,00:00:32.000,2025-04-15 09:43:09.595
false,false,1568,1475,93,1905,00:00:32.000,2025-04-14 11:37:33.037
false,false,1575,1480,95,2122,00:00:30.000,2025-04-14 11:37:47.049
false,false,1295,1222,73,129,00:00:32.000,2025-04-14 11:25:50.514
false,false,1296,1223,73,162,00:00:33.000,2025-04-14 11:25:52.514
false,false,1311,1236,75,631,00:00:30.000,2025-04-14 11:26:22.535
false,false,1336,1259,77,1420,00:00:32.000,2025-04-14 11:27:12.572
false,false,1341,1264,77,1580,00:00:32.000,2025-04-14 11:27:22.578
false,false,1347,1269,78,1767,00:00:30.000,2025-04-14 11:27:34.589
false,false,1356,1277,79,2047,00:00:31.000,2025-04-14 11:27:52.607
false,false,1361,1282,79,2201,00:00:31.000,2025-04-14 11:28:02.617
false,false,1451,1366,85,315,00:00:33.000,2025-04-14 11:32:50.821
false,false,1468,1382,86,852,00:00:32.000,2025-04-14 11:33:24.846
false,false,1491,1404,87,158,00:00:31.000,2025-04-14 11:34:46.908
false,false,1493,1406,87,219,00:00:31.000,2025-04-14 11:34:50.910
false,false,1496,1409,87,312,00:00:33.000,2025-04-14 11:34:56.913
false,false,1500,1413,87,438,00:00:33.000,2025-04-14 11:35:04.919
false,true,1370,1290,80,0,00:00:00.000,2025-04-14 11:28:44.643
false,false,1377,1297,80,63,00:00:33.000,2025-04-14 11:29:10.661
false,true,1390,1308,82,0,00:00:00.000,2025-04-14 11:29:46.690
false,false,1393,1311,82,93,00:00:30.000,2025-04-14 11:29:54.695
false,false,1400,1318,82,315,00:00:31.000,2025-04-14 11:30:08.710
false,true,1400,1318,82,0,00:00:00.000,2025-04-14 11:30:12.713
false,false,1427,1342,85,853,00:00:31.000,2025-04-14 11:31:14.755
false,true,1428,1343,85,0,00:00:00.000,2025-04-14 11:31:28.767
false,false,1433,1348,85,154,00:00:30.000,2025-04-14 11:31:38.772
false,true,1436,1351,85,0,00:00:00.000,2025-04-14 11:31:48.779
false,true,455,424,31,0,00:00:00.000,2025-04-16 10:23:14.952
false,false,263,245,18,479,00:00:32.000,2025-04-16 10:21:15.279
false,true,273,255,18,0,00:00:00.000,2025-04-16 10:21:20.787
false,true,282,264,18,0,00:00:00.000,2025-04-16 10:21:28.292
false,false,291,272,19,283,00:00:31.000,2025-04-16 10:21:35.301
false,true,310,289,21,0,00:00:00.000,2025-04-16 10:21:49.322
false,true,310,289,21,0,00:00:00.000,2025-04-16 10:21:50.323
false,true,310,289,21,0,00:00:00.000,2025-04-16 10:21:51.325
false,false,315,293,22,154,00:00:31.000,2025-04-16 10:21:56.334
false,false,317,295,22,216,00:00:31.000,2025-04-16 10:21:57.336
false,true,235,218,17,0,00:00:00.000,2025-04-16 10:20:55.252
false,false,238,221,17,92,00:00:30.000,2025-04-16 10:20:56.754
false,true,244,227,17,0,00:00:00.000,2025-04-16 10:21:02.262
false,false,343,319,24,1040,00:00:32.000,2025-04-16 10:22:10.356
false,false,384,358,26,498,00:00:30.000,2025-04-16 10:22:33.893
false,false,474,443,31,532,00:00:31.000,2025-04-16 10:23:30.979
false,false,481,449,32,755,00:00:32.000,2025-04-16 10:23:34.482
false,false,483,451,32,31,00:00:31.000,2025-04-16 10:23:41.493
false,false,507,474,33,186,00:00:33.000,2025-04-16 10:23:56.514
false,true,516,483,33,0,00:00:00.000,2025-04-16 10:24:03.024
false,false,525,492,33,96,00:00:31.000,2025-04-16 10:24:11.538
false,false,534,498,36,378,00:00:32.000,2025-04-16 10:24:16.044
false,false,1150,1083,67,355,00:00:31.000,2025-04-15 09:21:08.230
false,false,1153,1086,67,451,00:00:32.000,2025-04-15 09:21:11.232
false,false,1158,1091,67,606,00:00:30.000,2025-04-15 09:21:16.237
false,false,1161,1093,68,703,00:00:31.000,2025-04-15 09:21:19.243
false,false,1162,1094,68,734,00:00:31.000,2025-04-15 09:21:20.244
false,false,1178,1108,70,1235,00:00:30.000,2025-04-15 09:21:36.254
false,false,1203,1129,74,292,00:00:32.000,2025-04-15 09:22:13.290
false,false,1206,1132,74,386,00:00:31.000,2025-04-15 09:22:16.291
false,false,1210,1136,74,512,00:00:31.000,2025-04-15 09:22:20.296
false,false,1215,1141,74,670,00:00:32.000,2025-04-15 09:22:25.298
false,false,1226,1152,74,1022,00:00:33.000,2025-04-15 09:22:36.308
false,false,1232,1158,74,1214,00:00:33.000,2025-04-15 09:22:42.314
false,true,1247,1171,76,0,00:00:00.000,2025-04-15 09:22:59.331
false,true,1247,1171,76,0,00:00:00.000,2025-04-15 09:23:01.334
false,false,1282,1202,80,600,00:00:33.000,2025-04-15 09:23:44.381
false,false,1284,1204,80,662,00:00:32.000,2025-04-15 09:23:46.383
false,false,1285,1205,80,693,00:00:31.000,2025-04-15 09:23:47.384
false,false,1293,1211,82,947,00:00:32.000,2025-04-15 09:23:55.394
false,false,1314,1232,82,221,00:00:33.000,2025-04-15 09:24:22.421
false,false,1315,1233,82,254,00:00:33.000,2025-04-15 09:24:23.423
false,false,1318,1236,82,348,00:00:31.000,2025-04-15 09:24:26.427
false,false,1328,1246,82,668,00:00:33.000,2025-04-15 09:24:36.442
false,false,1378,1294,84,755,00:00:32.000,2025-04-15 09:25:38.511
false,false,1116,1050,66,33,00:00:33.000,2025-04-15 09:20:28.194
false,false,1388,1303,85,214,00:00:30.000,2025-04-15 09:25:54.529
false,false,1389,1304,85,244,00:00:30.000,2025-04-15 09:25:55.529
false,false,1414,1327,87,1034,00:00:32.000,2025-04-15 09:26:20.558
false,false,1426,1339,87,1408,00:00:30.000,2025-04-15 09:26:32.571
false,false,1452,1364,88,815,00:00:32.000,2025-04-15 09:27:04.601
false,false,1497,1404,93,96,00:00:33.000,2025-04-15 09:28:13.666
false,false,1508,1414,94,443,00:00:33.000,2025-04-15 09:28:24.679
false,false,1511,1417,94,93,00:00:31.000,2025-04-15 09:28:33.690
false,false,1513,1419,94,156,00:00:30.000,2025-04-15 09:28:35.692
false,false,1515,1421,94,220,00:00:31.000,2025-04-15 09:28:37.694
false,false,1519,1425,94,345,00:00:31.000,2025-04-15 09:28:41.698
false,false,1532,1436,96,757,00:00:33.000,2025-04-15 09:28:54.710
false,false,1537,1440,97,910,00:00:31.000,2025-04-15 09:28:59.714
false,true,1546,1449,97,0,00:00:00.000,2025-04-15 09:29:09.726
false,false,1550,1453,97,124,00:00:32.000,2025-04-15 09:29:18.738
false,false,1553,1456,97,216,00:00:31.000,2025-04-15 09:29:21.743
false,false,1563,1465,98,95,00:00:32.000,2025-04-15 09:29:37.759
false,false,1585,1483,102,794,00:00:31.000,2025-04-15 09:29:59.779
false,true,1585,1483,102,0,00:00:00.000,2025-04-15 09:30:00.781
false,false,1602,1500,102,287,00:00:32.000,2025-04-15 09:30:28.811
false,false,1609,1507,102,30,00:00:30.000,2025-04-15 09:30:41.822
false,false,1728,1619,109,3711,00:00:30.000,2025-04-15 09:32:46.937
false,false,1738,1629,109,4019,00:00:32.000,2025-04-15 09:32:56.948
false,true,1744,1635,109,0,00:00:00.000,2025-04-15 09:33:05.955
false,true,1753,1643,110,0,00:00:00.000,2025-04-15 09:33:20.976
false,false,1759,1649,110,193,00:00:32.000,2025-04-15 09:33:29.986
false,true,1762,1652,110,0,00:00:00.000,2025-04-15 09:33:34.993
false,false,1769,1658,111,218,00:00:31.000,2025-04-15 09:33:46.006
false,true,1610,1508,102,0,00:00:00.000,2025-04-15 09:30:44.824
false,false,1625,1523,102,471,00:00:32.000,2025-04-15 09:31:03.840
false,false,1627,1525,102,533,00:00:32.000,2025-04-15 09:31:05.843
false,false,1655,1552,103,1413,00:00:33.000,2025-04-15 09:31:33.869
false,false,1687,1579,108,2425,00:00:32.000,2025-04-15 09:32:05.899
false,false,1783,1671,112,191,00:00:32.000,2025-04-15 09:34:12.033
false,false,1809,1696,113,502,00:00:33.000,2025-04-15 09:34:50.073
false,true,1811,1698,113,0,00:00:00.000,2025-04-15 09:34:58.083
false,false,1818,1705,113,221,00:00:30.000,2025-04-15 09:35:05.092
false,true,1823,1710,113,0,00:00:00.000,2025-04-15 09:35:13.100
false,true,1842,1728,114,0,00:00:00.000,2025-04-15 09:35:48.135
false,false,1861,1747,114,594,00:00:33.000,2025-04-15 09:36:12.164
false,false,1871,1756,115,909,00:00:30.000,2025-04-15 09:36:22.174
false,false,1880,1765,115,1186,00:00:32.000,2025-04-15 09:36:31.183
false,true,1881,1766,115,0,00:00:00.000,2025-04-15 09:36:38.190
false,true,1881,1766,115,0,00:00:00.000,2025-04-15 09:36:44.198
false,false,1899,1783,116,244,00:00:31.000,2025-04-15 09:37:08.225
false,false,1914,1797,117,718,00:00:33.000,2025-04-15 09:37:23.241
false,true,1914,1797,117,0,00:00:00.000,2025-04-15 09:37:28.247
false,true,1916,1799,117,0,00:00:00.000,2025-04-15 09:37:34.252
false,true,1931,1814,117,0,00:00:00.000,2025-04-15 09:38:04.285
false,true,1951,1833,118,0,00:00:00.000,2025-04-15 09:38:26.310
false,false,1953,1835,118,61,00:00:31.000,2025-04-15 09:38:32.315
false,true,2068,1942,126,0,00:00:00.000,2025-04-15 09:41:11.475
false,false,2076,1949,127,255,00:00:32.000,2025-04-15 09:41:23.485
false,false,2083,1956,127,477,00:00:30.000,2025-04-15 09:41:30.494
false,false,2089,1962,127,664,00:00:31.000,2025-04-15 09:41:36.501
false,false,2103,1976,127,369,00:00:30.000,2025-04-15 09:41:56.522
false,false,2107,1980,127,495,00:00:30.000,2025-04-15 09:42:00.526
false,false,2110,1983,127,589,00:00:30.000,2025-04-15 09:42:03.529
false,false,2140,2010,130,1537,00:00:31.000,2025-04-15 09:42:33.562
false,false,2148,2017,131,1787,00:00:31.000,2025-04-15 09:42:41.570
false,false,2157,2025,132,2076,00:00:30.000,2025-04-15 09:42:50.581
false,false,2188,2055,133,3058,00:00:31.000,2025-04-15 09:43:21.608
false,false,2208,2073,135,3692,00:00:31.000,2025-04-15 09:43:41.632
false,false,1563,1470,93,1746,00:00:33.000,2025-04-14 11:37:23.029
false,false,1585,1490,95,2438,00:00:30.000,2025-04-14 11:38:07.060
false,false,1287,1214,73,435,00:00:31.000,2025-04-14 11:25:22.496
false,true,1291,1218,73,0,00:00:00.000,2025-04-14 11:25:38.506
false,false,1297,1224,73,195,00:00:33.000,2025-04-14 11:25:54.515
false,false,1333,1257,76,1322,00:00:31.000,2025-04-14 11:27:06.567
false,false,1346,1268,78,1737,00:00:31.000,2025-04-14 11:27:32.589
false,false,1352,1274,78,1922,00:00:32.000,2025-04-14 11:27:44.601
false,false,1457,1372,85,503,00:00:30.000,2025-04-14 11:33:02.832
false,true,1474,1388,86,0,00:00:00.000,2025-04-14 11:33:52.865
false,false,1479,1392,87,162,00:00:33.000,2025-04-14 11:34:10.880
false,false,1485,1398,87,350,00:00:31.000,2025-04-14 11:34:22.890
false,true,1486,1399,87,0,00:00:00.000,2025-04-14 11:34:28.894
false,true,1375,1295,80,0,00:00:00.000,2025-04-14 11:28:58.652
false,true,1400,1318,82,0,00:00:00.000,2025-04-14 11:30:10.711
false,true,1400,1318,82,0,00:00:00.000,2025-04-14 11:30:14.715
false,false,1417,1334,83,538,00:00:30.000,2025-04-14 11:30:54.745
false,true,457,426,31,0,00:00:00.000,2025-04-16 10:23:18.458
false,false,423,394,29,1725,00:00:32.000,2025-04-16 10:22:53.421
false,false,428,397,31,1883,00:00:32.000,2025-04-16 10:22:55.924
false,false,261,243,18,415,00:00:31.000,2025-04-16 10:21:14.278
false,false,268,250,18,637,00:00:31.000,2025-04-16 10:21:17.783
false,false,272,254,18,762,00:00:32.000,2025-04-16 10:21:19.787
false,true,297,278,19,0,00:00:00.000,2025-04-16 10:21:38.806
false,false,319,297,22,279,00:00:32.000,2025-04-16 10:21:58.337
false,false,241,224,17,187,00:00:32.000,2025-04-16 10:20:58.256
false,true,248,231,17,0,00:00:00.000,2025-04-16 10:21:07.270
false,false,357,331,26,1478,00:00:30.000,2025-04-16 10:22:17.368
false,false,370,344,26,65,00:00:33.000,2025-04-16 10:22:26.882
false,false,375,349,26,220,00:00:30.000,2025-04-16 10:22:29.387
false,false,392,365,27,750,00:00:31.000,2025-04-16 10:22:37.901
false,false,408,381,27,1251,00:00:30.000,2025-04-16 10:22:45.912
false,false,476,444,32,594,00:00:32.000,2025-04-16 10:23:31.980
false,true,482,450,32,0,00:00:00.000,2025-04-16 10:23:38.489
false,true,482,450,32,0,00:00:00.000,2025-04-16 10:23:40.992
false,false,492,460,32,311,00:00:30.000,2025-04-16 10:23:45.997
false,true,522,489,33,0,00:00:00.000,2025-04-16 10:24:07.533
false,true,1139,1072,67,0,00:00:00.000,2025-04-15 09:20:53.219
false,false,1156,1089,67,544,00:00:33.000,2025-04-15 09:21:14.235
false,false,1159,1092,67,639,00:00:33.000,2025-04-15 09:21:17.239
false,false,1160,1093,67,672,00:00:33.000,2025-04-15 09:21:18.241
false,false,1169,1101,68,948,00:00:30.000,2025-04-15 09:21:27.249
false,false,1171,1103,68,1014,00:00:33.000,2025-04-15 09:21:29.251
false,true,1186,1115,71,0,00:00:00.000,2025-04-15 09:21:48.265
false,false,1195,1121,74,33,00:00:33.000,2025-04-15 09:22:05.282
false,false,1225,1151,74,989,00:00:30.000,2025-04-15 09:22:35.308
false,false,1236,1161,75,1337,00:00:32.000,2025-04-15 09:22:46.318
false,false,1249,1173,76,63,00:00:32.000,2025-04-15 09:23:05.339
false,false,1266,1189,77,94,00:00:31.000,2025-04-15 09:23:28.364
false,false,1289,1208,81,824,00:00:32.000,2025-04-15 09:23:51.389
false,true,1307,1225,82,0,00:00:00.000,2025-04-15 09:24:15.414
false,false,1322,1240,82,477,00:00:32.000,2025-04-15 09:24:30.431
false,false,1340,1256,84,1036,00:00:30.000,2025-04-15 09:24:48.455
false,false,1349,1265,84,1316,00:00:32.000,2025-04-15 09:24:57.465
false,false,1363,1279,84,284,00:00:33.000,2025-04-15 09:25:23.492
false,false,1364,1280,84,316,00:00:32.000,2025-04-15 09:25:24.493
false,false,1370,1286,84,507,00:00:31.000,2025-04-15 09:25:30.501
false,false,1379,1295,84,787,00:00:32.000,2025-04-15 09:25:39.511
false,false,1394,1307,87,399,00:00:30.000,2025-04-15 09:26:00.534
false,false,1408,1321,87,843,00:00:30.000,2025-04-15 09:26:14.551
false,true,1426,1339,87,0,00:00:00.000,2025-04-15 09:26:35.575
false,false,1430,1343,87,122,00:00:31.000,2025-04-15 09:26:42.582
false,false,1438,1351,87,374,00:00:31.000,2025-04-15 09:26:50.590
false,false,1458,1369,89,192,00:00:30.000,2025-04-15 09:27:16.612
false,false,1484,1393,91,285,00:00:32.000,2025-04-15 09:27:54.651
false,false,1500,1406,94,192,00:00:33.000,2025-04-15 09:28:16.671
false,false,1501,1407,94,224,00:00:32.000,2025-04-15 09:28:17.671
false,false,1509,1415,94,31,00:00:31.000,2025-04-15 09:28:31.686
false,false,1514,1420,94,189,00:00:33.000,2025-04-15 09:28:36.693
false,false,1522,1427,95,438,00:00:31.000,2025-04-15 09:28:44.700
false,false,1540,1443,97,1005,00:00:30.000,2025-04-15 09:29:02.718
false,true,1546,1449,97,0,00:00:00.000,2025-04-15 09:29:13.730
false,false,1547,1450,97,31,00:00:31.000,2025-04-15 09:29:15.733
false,false,1560,1462,98,437,00:00:33.000,2025-04-15 09:29:28.752
false,false,1588,1486,102,94,00:00:31.000,2025-04-15 09:30:08.789
false,false,1591,1489,102,185,00:00:31.000,2025-04-15 09:30:11.793
false,true,1593,1491,102,0,00:00:00.000,2025-04-15 09:30:18.799
false,false,1598,1496,102,159,00:00:33.000,2025-04-15 09:30:24.807
false,false,1604,1502,102,349,00:00:31.000,2025-04-15 09:30:30.813
false,false,1608,1506,102,474,00:00:33.000,2025-04-15 09:30:34.815
false,false,1708,1600,108,3081,00:00:31.000,2025-04-15 09:32:26.919
false,false,1730,1621,109,3772,00:00:30.000,2025-04-15 09:32:48.941
false,false,1736,1627,109,3956,00:00:30.000,2025-04-15 09:32:54.945
false,false,1748,1639,109,129,00:00:33.000,2025-04-15 09:33:12.965
false,true,1769,1658,111,0,00:00:00.000,2025-04-15 09:33:49.009
false,true,1769,1658,111,0,00:00:00.000,2025-04-15 09:33:51.012
false,false,1614,1512,102,124,00:00:30.000,2025-04-15 09:30:52.831
false,false,1626,1524,102,501,00:00:30.000,2025-04-15 09:31:04.841
false,false,1635,1532,103,784,00:00:30.000,2025-04-15 09:31:13.851
false,false,1640,1537,103,937,00:00:31.000,2025-04-15 09:31:18.857
false,false,1642,1539,103,1002,00:00:32.000,2025-04-15 09:31:20.859
false,false,1663,1559,104,1665,00:00:33.000,2025-04-15 09:31:41.878
false,false,1684,1578,106,2329,00:00:30.000,2025-04-15 09:32:02.895
false,false,1778,1667,111,32,00:00:32.000,2025-04-15 09:34:07.025
false,true,1786,1674,112,0,00:00:00.000,2025-04-15 09:34:20.041
false,true,1793,1681,112,0,00:00:00.000,2025-04-15 09:34:30.053
false,false,1795,1683,112,62,00:00:30.000,2025-04-15 09:34:36.059
false,false,1798,1686,112,153,00:00:30.000,2025-04-15 09:34:39.060
false,false,1814,1701,113,96,00:00:33.000,2025-04-15 09:35:01.087
false,false,1819,1706,113,254,00:00:33.000,2025-04-15 09:35:06.093
false,true,1826,1713,113,0,00:00:00.000,2025-04-15 09:35:21.107
false,true,1826,1713,113,0,00:00:00.000,2025-04-15 09:35:23.109
false,true,1826,1713,113,0,00:00:00.000,2025-04-15 09:35:24.111
false,true,1826,1713,113,0,00:00:00.000,2025-04-15 09:35:25.111
false,true,1830,1717,113,0,00:00:00.000,2025-04-15 09:35:33.119
false,false,1838,1724,114,243,00:00:31.000,2025-04-15 09:35:43.130
false,false,1845,1731,114,96,00:00:32.000,2025-04-15 09:35:56.144
false,false,1909,1793,116,556,00:00:33.000,2025-04-15 09:37:18.235
false,true,1914,1797,117,0,00:00:00.000,2025-04-15 09:37:24.241
false,false,1926,1809,117,315,00:00:32.000,2025-04-15 09:37:47.265
false,true,1929,1812,117,0,00:00:00.000,2025-04-15 09:37:52.271
false,false,1950,1832,118,598,00:00:30.000,2025-04-15 09:38:23.306
false,false,1955,1837,118,125,00:00:31.000,2025-04-15 09:38:34.319
false,false,1966,1848,118,475,00:00:32.000,2025-04-15 09:38:45.332
false,true,2091,1964,127,0,00:00:00.000,2025-04-15 09:41:42.506
false,false,2121,1992,129,935,00:00:32.000,2025-04-15 09:42:14.544
false,false,2122,1993,129,968,00:00:33.000,2025-04-15 09:42:15.545
false,false,2175,2042,133,2644,00:00:33.000,2025-04-15 09:43:08.594
false,false,2202,2067,135,3504,00:00:30.000,2025-04-15 09:43:35.625
false,false,2224,2085,139,4202,00:00:33.000,2025-04-15 09:43:57.651
false,false,1587,1492,95,2502,00:00:32.000,2025-04-14 11:38:11.061
false,true,1291,1218,73,0,00:00:00.000,2025-04-14 11:25:36.504
false,false,1298,1225,73,226,00:00:31.000,2025-04-14 11:25:56.515
false,false,1328,1252,76,1167,00:00:33.000,2025-04-14 11:26:56.561
false,false,1331,1255,76,1258,00:00:30.000,2025-04-14 11:27:02.564
false,true,1364,1285,79,0,00:00:00.000,2025-04-14 11:28:10.623
false,false,1438,1353,85,60,00:00:30.000,2025-04-14 11:32:00.786
false,true,1438,1353,85,0,00:00:00.000,2025-04-14 11:32:10.789
false,false,1439,1354,85,32,00:00:32.000,2025-04-14 11:32:14.794
false,true,1441,1356,85,0,00:00:00.000,2025-04-14 11:32:28.807
false,false,1448,1363,85,221,00:00:30.000,2025-04-14 11:32:44.819
false,false,1449,1364,85,252,00:00:31.000,2025-04-14 11:32:46.820
false,false,1469,1383,86,882,00:00:30.000,2025-04-14 11:33:26.847
false,false,1481,1394,87,226,00:00:31.000,2025-04-14 11:34:14.882
false,false,1488,1401,87,64,00:00:31.000,2025-04-14 11:34:40.901
false,false,1372,1292,80,63,00:00:33.000,2025-04-14 11:28:48.645
false,false,1389,1307,82,443,00:00:30.000,2025-04-14 11:29:34.680
false,false,1394,1312,82,123,00:00:30.000,2025-04-14 11:29:56.697
false,false,1405,1323,82,160,00:00:32.000,2025-04-14 11:30:30.726
false,false,1430,1345,85,63,00:00:32.000,2025-04-14 11:31:32.770
false,true,457,426,31,0,00:00:00.000,2025-04-16 10:23:21.463
false,false,419,390,29,1598,00:00:33.000,2025-04-16 10:22:51.418
false,true,436,405,31,0,00:00:00.000,2025-04-16 10:23:02.435
false,true,436,405,31,0,00:00:00.000,2025-04-16 10:23:02.936
false,false,258,241,17,318,00:00:32.000,2025-04-16 10:21:12.776
false,true,273,255,18,0,00:00:00.000,2025-04-16 10:21:21.787
false,false,287,269,18,160,00:00:30.000,2025-04-16 10:21:33.298
false,false,297,278,19,469,00:00:30.000,2025-04-16 10:21:38.306
false,true,297,278,19,0,00:00:00.000,2025-04-16 10:21:40.809
false,false,314,292,22,123,00:00:30.000,2025-04-16 10:21:55.833
false,false,237,220,17,62,00:00:31.000,2025-04-16 10:20:56.253
false,true,244,227,17,0,00:00:00.000,2025-04-16 10:21:01.261
false,true,248,231,17,0,00:00:00.000,2025-04-16 10:21:05.268
false,false,345,321,24,1103,00:00:32.000,2025-04-16 10:22:11.358
false,false,354,328,26,1387,00:00:31.000,2025-04-16 10:22:15.866
false,false,355,329,26,1418,00:00:31.000,2025-04-16 10:22:16.366
false,false,365,339,26,1733,00:00:33.000,2025-04-16 10:22:21.374
false,false,367,341,26,1798,00:00:32.000,2025-04-16 10:22:22.375
false,true,368,342,26,0,00:00:00.000,2025-04-16 10:22:24.378
false,false,477,445,32,626,00:00:32.000,2025-04-16 10:23:32.481
false,true,482,450,32,0,00:00:00.000,2025-04-16 10:23:40.491
false,false,486,454,32,122,00:00:31.000,2025-04-16 10:23:42.994
false,false,490,458,32,249,00:00:32.000,2025-04-16 10:23:44.996
false,false,501,468,33,597,00:00:33.000,2025-04-16 10:23:50.505
false,false,508,475,33,218,00:00:32.000,2025-04-16 10:23:57.014
false,true,522,489,33,0,00:00:00.000,2025-04-16 10:24:09.035
false,false,530,496,34,255,00:00:30.000,2025-04-16 10:24:14.040
false,false,1131,1064,67,509,00:00:33.000,2025-04-15 09:20:43.208
false,false,1140,1073,67,32,00:00:32.000,2025-04-15 09:20:58.221
false,false,1192,1119,73,187,00:00:31.000,2025-04-15 09:21:56.274
false,true,1194,1120,74,0,00:00:00.000,2025-04-15 09:21:59.278
false,false,1219,1145,74,797,00:00:33.000,2025-04-15 09:22:29.303
false,false,1224,1150,74,959,00:00:33.000,2025-04-15 09:22:34.308
false,false,1227,1153,74,1054,00:00:32.000,2025-04-15 09:22:37.309
false,false,1247,1171,76,1683,00:00:32.000,2025-04-15 09:22:57.331
false,false,1250,1174,76,95,00:00:32.000,2025-04-15 09:23:06.340
false,false,1252,1175,77,156,00:00:31.000,2025-04-15 09:23:08.342
false,false,1269,1191,78,188,00:00:31.000,2025-04-15 09:23:31.367
false,false,1280,1201,79,534,00:00:30.000,2025-04-15 09:23:42.378
false,false,1287,1207,80,759,00:00:33.000,2025-04-15 09:23:49.387
false,false,1299,1217,82,1137,00:00:31.000,2025-04-15 09:24:01.401
false,false,1333,1251,82,822,00:00:33.000,2025-04-15 09:24:41.446
false,false,1334,1251,83,853,00:00:31.000,2025-04-15 09:24:42.448
false,false,1341,1257,84,1066,00:00:30.000,2025-04-15 09:24:49.456
false,true,1352,1268,84,0,00:00:00.000,2025-04-15 09:25:04.474
false,false,1362,1278,84,251,00:00:31.000,2025-04-15 09:25:22.491
false,false,1377,1293,84,723,00:00:30.000,2025-04-15 09:25:37.509
false,false,1381,1297,84,849,00:00:32.000,2025-04-15 09:25:41.512
false,true,1381,1297,84,0,00:00:00.000,2025-04-15 09:25:46.518
false,false,1390,1304,86,276,00:00:32.000,2025-04-15 09:25:56.531
false,false,1409,1322,87,874,00:00:31.000,2025-04-15 09:26:15.551
false,true,1426,1339,87,0,00:00:00.000,2025-04-15 09:26:38.578
false,true,1452,1364,88,0,00:00:00.000,2025-04-15 09:27:05.602
false,false,1462,1373,89,317,00:00:33.000,2025-04-15 09:27:20.618
false,false,1479,1389,90,130,00:00:33.000,2025-04-15 09:27:49.647
false,true,1494,1402,92,0,00:00:00.000,2025-04-15 09:28:05.659
false,false,1502,1408,94,257,00:00:33.000,2025-04-15 09:28:18.672
false,false,1503,1409,94,288,00:00:31.000,2025-04-15 09:28:19.673
false,false,1523,1427,96,471,00:00:33.000,2025-04-15 09:28:45.701
false,false,1554,1457,97,247,00:00:31.000,2025-04-15 09:29:22.745
false,false,1555,1457,98,280,00:00:33.000,2025-04-15 09:29:23.746
false,true,1560,1462,98,0,00:00:00.000,2025-04-15 09:29:31.757
false,true,1560,1462,98,0,00:00:00.000,2025-04-15 09:29:34.759
false,false,1561,1463,98,30,00:00:30.000,2025-04-15 09:29:35.759
false,false,1578,1478,100,572,00:00:31.000,2025-04-15 09:29:52.775
false,false,1579,1478,101,603,00:00:31.000,2025-04-15 09:29:53.775
false,false,1580,1479,101,635,00:00:32.000,2025-04-15 09:29:54.776
false,false,1592,1490,102,215,00:00:30.000,2025-04-15 09:30:12.793
false,true,1593,1491,102,0,00:00:00.000,2025-04-15 09:30:15.796
false,false,1732,1623,109,3834,00:00:31.000,2025-04-15 09:32:50.941
false,false,1744,1635,109,4208,00:00:31.000,2025-04-15 09:33:02.951
false,true,1777,1666,111,0,00:00:00.000,2025-04-15 09:34:01.021
false,true,1610,1508,102,0,00:00:00.000,2025-04-15 09:30:45.824
false,false,1653,1550,103,1350,00:00:31.000,2025-04-15 09:31:31.866
false,false,1677,1572,105,2106,00:00:31.000,2025-04-15 09:31:55.890
false,true,1786,1674,112,0,00:00:00.000,2025-04-15 09:34:21.042
false,true,1826,1713,113,0,00:00:00.000,2025-04-15 09:35:22.108
false,false,1832,1719,113,61,00:00:31.000,2025-04-15 09:35:37.124
false,false,1851,1737,114,281,00:00:30.000,2025-04-15 09:36:02.151
false,false,1915,1798,117,33,00:00:33.000,2025-04-15 09:37:30.249
false,false,1948,1830,118,535,00:00:30.000,2025-04-15 09:38:21.303
false,true,1971,1852,119,0,00:00:00.000,2025-04-15 09:38:52.339
false,false,1975,1856,119,128,00:00:32.000,2025-04-15 09:39:00.349
false,false,2054,1928,126,597,00:00:32.000,2025-04-15 09:40:55.457
false,false,2070,1944,126,65,00:00:32.000,2025-04-15 09:41:17.479
false,false,2093,1966,127,61,00:00:31.000,2025-04-15 09:41:46.511
false,false,2097,1970,127,183,00:00:30.000,2025-04-15 09:41:50.516
false,false,2126,1997,129,1094,00:00:31.000,2025-04-15 09:42:19.548
false,false,2134,2005,129,1350,00:00:33.000,2025-04-15 09:42:27.554
false,false,2138,2008,130,1475,00:00:31.000,2025-04-15 09:42:31.559
false,false,2159,2027,132,2138,00:00:32.000,2025-04-15 09:42:52.583
false,false,2160,2028,132,2170,00:00:32.000,2025-04-15 09:42:53.584
false,false,2196,2062,134,3314,00:00:32.000,2025-04-15 09:43:29.618
false,false,2197,2062,135,3344,00:00:30.000,2025-04-15 09:43:30.619
false,false,2211,2076,135,3787,00:00:33.000,2025-04-15 09:43:44.636
false,false,2218,2081,137,4011,00:00:33.000,2025-04-15 09:43:51.645
false,false,1561,1468,93,1680,00:00:30.000,2025-04-14 11:37:19.026
false,false,1572,1478,94,2028,00:00:30.000,2025-04-14 11:37:41.043
false,false,1574,1479,95,2092,00:00:32.000,2025-04-14 11:37:45.047
false,false,1578,1483,95,2219,00:00:33.000,2025-04-14 11:37:53.053
false,false,1588,1493,95,31,00:00:31.000,2025-04-14 11:38:25.070
false,false,1590,1495,95,94,00:00:31.000,2025-04-14 11:38:29.073
false,false,1293,1220,73,65,00:00:33.000,2025-04-14 11:25:46.512
false,false,1310,1236,74,601,00:00:31.000,2025-04-14 11:26:20.534
false,false,1322,1246,76,978,00:00:30.000,2025-04-14 11:26:44.552
false,false,1323,1247,76,1010,00:00:32.000,2025-04-14 11:26:46.554
false,false,1335,1258,77,1388,00:00:33.000,2025-04-14 11:27:10.570
false,false,1339,1262,77,1518,00:00:33.000,2025-04-14 11:27:18.576
false,false,1358,1279,79,2109,00:00:32.000,2025-04-14 11:27:56.611
false,true,1364,1285,79,0,00:00:00.000,2025-04-14 11:28:14.627
false,false,1369,1289,80,159,00:00:30.000,2025-04-14 11:28:30.635
false,true,1370,1290,80,0,00:00:00.000,2025-04-14 11:28:36.638
false,false,1450,1365,85,282,00:00:30.000,2025-04-14 11:32:48.821
false,false,1453,1368,85,379,00:00:31.000,2025-04-14 11:32:54.824
false,false,1455,1370,85,440,00:00:31.000,2025-04-14 11:32:58.828
false,true,1473,1387,86,0,00:00:00.000,2025-04-14 11:33:40.855
false,false,1486,1399,87,382,00:00:32.000,2025-04-14 11:34:24.890
false,true,1486,1399,87,0,00:00:00.000,2025-04-14 11:34:34.900
false,false,1384,1302,82,290,00:00:33.000,2025-04-14 11:29:24.674
false,false,1399,1317,82,284,00:00:33.000,2025-04-14 11:30:06.708
false,true,1400,1318,82,0,00:00:00.000,2025-04-14 11:30:18.718
false,false,1401,1319,82,33,00:00:33.000,2025-04-14 11:30:22.720
false,true,1428,1343,85,0,00:00:00.000,2025-04-14 11:31:18.760
false,false,1429,1344,85,31,00:00:31.000,2025-04-14 11:31:30.770
false,false,1436,1351,85,248,00:00:30.000,2025-04-14 11:31:44.777
false,true,1436,1351,85,0,00:00:00.000,2025-04-14 11:31:52.779
false,true,1436,1351,85,0,00:00:00.000,2025-04-14 11:31:56.781
false,false,457,426,31,63,00:00:30.000,2025-04-16 10:23:16.454
false,true,457,426,31,0,00:00:00.000,2025-04-16 10:23:22.465
false,false,467,436,31,310,00:00:32.000,2025-04-16 10:23:27.471
false,false,418,390,28,1565,00:00:32.000,2025-04-16 10:22:50.917
false,false,276,258,18,95,00:00:31.000,2025-04-16 10:21:24.788
false,false,279,261,18,189,00:00:32.000,2025-04-16 10:21:26.289
false,true,297,278,19,0,00:00:00.000,2025-04-16 10:21:41.309
false,true,235,218,17,0,00:00:00.000,2025-04-16 10:20:54.751
false,true,244,227,17,0,00:00:00.000,2025-04-16 10:21:00.761
false,false,344,320,24,1071,00:00:31.000,2025-04-16 10:22:10.856
false,false,359,333,26,1543,00:00:33.000,2025-04-16 10:22:18.369
false,true,368,342,26,0,00:00:00.000,2025-04-16 10:22:25.880
false,false,377,351,26,282,00:00:31.000,2025-04-16 10:22:30.388
false,false,396,369,27,875,00:00:32.000,2025-04-16 10:22:39.903
false,false,412,385,27,1376,00:00:32.000,2025-04-16 10:22:47.914
false,true,482,450,32,0,00:00:00.000,2025-04-16 10:23:36.486
false,false,496,463,33,437,00:00:30.000,2025-04-16 10:23:48.001
false,true,501,468,33,0,00:00:00.000,2025-04-16 10:23:51.507
false,true,501,468,33,0,00:00:00.000,2025-04-16 10:23:53.007
false,false,502,469,33,31,00:00:31.000,2025-04-16 10:23:54.009
false,false,512,479,33,345,00:00:31.000,2025-04-16 10:23:59.017
false,true,516,483,33,0,00:00:00.000,2025-04-16 10:24:02.523
false,false,528,495,33,192,00:00:31.000,2025-04-16 10:24:13.040
false,true,534,498,36,0,00:00:00.000,2025-04-16 10:24:16.544
false,false,1133,1066,67,571,00:00:30.000,2025-04-15 09:20:45.209
false,false,1149,1082,67,324,00:00:31.000,2025-04-15 09:21:07.229
false,false,1208,1134,74,448,00:00:32.000,2025-04-15 09:22:18.294
false,false,1214,1140,74,638,00:00:33.000,2025-04-15 09:22:24.298
false,false,1259,1182,77,381,00:00:31.000,2025-04-15 09:23:15.350
false,true,1263,1186,77,0,00:00:00.000,2025-04-15 09:23:23.358
false,false,1264,1187,77,30,00:00:30.000,2025-04-15 09:23:26.362
false,false,1306,1224,82,1359,00:00:33.000,2025-04-15 09:24:08.407
false,true,1307,1225,82,0,00:00:00.000,2025-04-15 09:24:12.412
false,false,1309,1227,82,62,00:00:32.000,2025-04-15 09:24:17.416
false,false,1335,1252,83,883,00:00:30.000,2025-04-15 09:24:43.448
false,false,1339,1255,84,1006,00:00:30.000,2025-04-15 09:24:47.454
false,false,1366,1282,84,381,00:00:33.000,2025-04-15 09:25:26.494
false,false,1368,1284,84,445,00:00:33.000,2025-04-15 09:25:28.497
false,false,1384,1299,85,93,00:00:30.000,2025-04-15 09:25:50.525
false,false,1398,1311,87,524,00:00:31.000,2025-04-15 09:26:04.537
false,false,1403,1316,87,687,00:00:33.000,2025-04-15 09:26:09.546
false,false,1413,1326,87,1002,00:00:33.000,2025-04-15 09:26:19.557
false,false,1434,1347,87,247,00:00:32.000,2025-04-15 09:26:46.586
false,false,1445,1357,88,592,00:00:31.000,2025-04-15 09:26:57.596
false,false,1446,1358,88,625,00:00:33.000,2025-04-15 09:26:58.596
false,false,1456,1367,89,129,00:00:32.000,2025-04-15 09:27:14.609
false,false,1461,1372,89,284,00:00:30.000,2025-04-15 09:27:19.617
false,false,1480,1389,91,160,00:00:30.000,2025-04-15 09:27:50.648
false,false,1517,1423,94,283,00:00:32.000,2025-04-15 09:28:39.695
false,false,1520,1426,94,375,00:00:30.000,2025-04-15 09:28:42.698
false,false,1525,1429,96,535,00:00:33.000,2025-04-15 09:28:47.703
false,false,1533,1437,96,788,00:00:31.000,2025-04-15 09:28:55.711
false,false,1538,1441,97,943,00:00:33.000,2025-04-15 09:29:00.714
false,true,1546,1449,97,0,00:00:00.000,2025-04-15 09:29:14.731
false,false,1557,1459,98,342,00:00:30.000,2025-04-15 09:29:25.749
false,false,1559,1461,98,404,00:00:30.000,2025-04-15 09:29:27.750
false,false,1707,1599,108,3050,00:00:32.000,2025-04-15 09:32:25.919
false,false,1717,1609,108,3364,00:00:31.000,2025-04-15 09:32:35.928
false,false,1734,1625,109,3896,00:00:32.000,2025-04-15 09:32:52.941
false,false,1739,1630,109,4051,00:00:32.000,2025-04-15 09:32:57.949
false,false,1743,1634,109,4177,00:00:31.000,2025-04-15 09:33:01.951
false,false,1756,1646,110,98,00:00:33.000,2025-04-15 09:33:26.985
false,false,1768,1657,111,187,00:00:30.000,2025-04-15 09:33:45.005
false,false,1611,1509,102,32,00:00:32.000,2025-04-15 09:30:49.828
false,false,1624,1522,102,439,00:00:32.000,2025-04-15 09:31:02.839
false,false,1645,1542,103,1097,00:00:32.000,2025-04-15 09:31:23.860
false,false,1647,1544,103,1159,00:00:30.000,2025-04-15 09:31:25.862
false,false,1693,1585,108,2610,00:00:30.000,2025-04-15 09:32:11.906
false,true,1786,1674,112,0,00:00:00.000,2025-04-15 09:34:16.036
false,false,1812,1699,113,33,00:00:33.000,2025-04-15 09:34:59.084
false,false,1829,1716,113,95,00:00:33.000,2025-04-15 09:35:28.114
false,false,1865,1751,114,720,00:00:30.000,2025-04-15 09:36:16.167
false,false,1867,1752,115,783,00:00:31.000,2025-04-15 09:36:18.168
false,true,1881,1766,115,0,00:00:00.000,2025-04-15 09:36:36.187
false,false,1886,1770,116,156,00:00:31.000,2025-04-15 09:36:49.205
false,true,1891,1775,116,0,00:00:00.000,2025-04-15 09:37:00.216
false,false,1900,1784,116,277,00:00:33.000,2025-04-15 09:37:09.226
false,false,1910,1794,116,589,00:00:33.000,2025-04-15 09:37:19.236
false,false,1911,1795,116,621,00:00:32.000,2025-04-15 09:37:20.238
false,false,1924,1807,117,250,00:00:30.000,2025-04-15 09:37:45.264
false,true,1931,1814,117,0,00:00:00.000,2025-04-15 09:37:59.279
false,false,1970,1851,119,604,00:00:33.000,2025-04-15 09:38:49.336
false,false,1971,1852,119,635,00:00:31.000,2025-04-15 09:38:50.337
false,false,2065,1939,126,940,00:00:30.000,2025-04-15 09:41:06.470
false,true,2068,1942,126,0,00:00:00.000,2025-04-15 09:41:12.475
false,false,2084,1957,127,510,00:00:33.000,2025-04-15 09:41:31.495
false,false,2108,1981,127,528,00:00:33.000,2025-04-15 09:42:01.527
false,false,2117,1989,128,812,00:00:33.000,2025-04-15 09:42:10.537
false,false,2120,1991,129,903,00:00:30.000,2025-04-15 09:42:13.542
false,false,2124,1995,129,1032,00:00:32.000,2025-04-15 09:42:17.546
false,false,2125,1996,129,1063,00:00:31.000,2025-04-15 09:42:18.547
false,false,2144,2014,130,1662,00:00:31.000,2025-04-15 09:42:37.566
false,false,2163,2031,132,2263,00:00:31.000,2025-04-15 09:42:56.585
false,false,2164,2032,132,2296,00:00:33.000,2025-04-15 09:42:57.585
false,false,2165,2033,132,2327,00:00:31.000,2025-04-15 09:42:58.585
false,false,2169,2037,132,2452,00:00:31.000,2025-04-15 09:43:02.590
false,false,2178,2045,133,2739,00:00:33.000,2025-04-15 09:43:11.598
false,false,2190,2056,134,3122,00:00:32.000,2025-04-15 09:43:23.610
false,false,2198,2063,135,3377,00:00:33.000,2025-04-15 09:43:31.620
false,false,2225,2086,139,4234,00:00:32.000,2025-04-15 09:43:58.651
false,false,1566,1473,93,1841,00:00:31.000,2025-04-14 11:37:29.033
false,true,1587,1492,95,0,00:00:00.000,2025-04-14 11:38:17.066
false,true,1587,1492,95,0,00:00:00.000,2025-04-14 11:38:19.068
false,false,1286,1213,73,404,00:00:33.000,2025-04-14 11:25:20.496
false,false,1289,1216,73,497,00:00:31.000,2025-04-14 11:25:26.497
false,false,1292,1219,73,32,00:00:32.000,2025-04-14 11:25:44.511
false,false,1309,1235,74,570,00:00:31.000,2025-04-14 11:26:18.533
false,false,1353,1274,79,1954,00:00:32.000,2025-04-14 11:27:46.602
false,false,1364,1285,79,2297,00:00:33.000,2025-04-14 11:28:08.622
false,false,1487,1400,87,33,00:00:33.000,2025-04-14 11:34:38.900
false,false,1490,1403,87,127,00:00:32.000,2025-04-14 11:34:44.905
false,true,1370,1290,80,0,00:00:00.000,2025-04-14 11:28:40.641
false,false,1386,1304,82,352,00:00:30.000,2025-04-14 11:29:28.677
false,false,1391,1309,82,30,00:00:30.000,2025-04-14 11:29:50.693
false,false,1415,1332,83,476,00:00:32.000,2025-04-14 11:30:50.744
false,false,435,404,31,2106,00:00:32.000,2025-04-16 10:22:59.430
false,false,253,236,17,157,00:00:32.000,2025-04-16 10:21:10.272
false,false,256,239,17,253,00:00:31.000,2025-04-16 10:21:11.775
false,false,274,256,18,32,00:00:32.000,2025-04-16 10:21:23.787
false,true,282,264,18,0,00:00:00.000,2025-04-16 10:21:29.793
false,true,310,289,21,0,00:00:00.000,2025-04-16 10:21:51.826
false,true,310,289,21,0,00:00:00.000,2025-04-16 10:21:52.326
false,false,327,304,23,528,00:00:30.000,2025-04-16 10:22:02.343
false,false,339,315,24,913,00:00:33.000,2025-04-16 10:22:08.353
false,false,381,355,26,406,00:00:32.000,2025-04-16 10:22:32.392
false,false,400,373,27,998,00:00:32.000,2025-04-16 10:22:41.905
false,false,403,376,27,1096,00:00:32.000,2025-04-16 10:22:43.408
false,true,482,450,32,0,00:00:00.000,2025-04-16 10:23:35.483
false,true,482,450,32,0,00:00:00.000,2025-04-16 10:23:39.490
false,false,487,455,32,154,00:00:32.000,2025-04-16 10:23:43.494
false,false,510,477,33,282,00:00:32.000,2025-04-16 10:23:58.015
false,true,522,489,33,0,00:00:00.000,2025-04-16 10:24:08.535
false,false,1130,1063,67,476,00:00:32.000,2025-04-15 09:20:42.208
false,false,1166,1098,68,857,00:00:33.000,2025-04-15 09:21:24.245
false,false,1168,1100,68,918,00:00:31.000,2025-04-15 09:21:26.248
false,true,1186,1115,71,0,00:00:00.000,2025-04-15 09:21:46.263
false,false,1190,1118,72,126,00:00:30.000,2025-04-15 09:21:54.273
false,false,1191,1119,72,156,00:00:30.000,2025-04-15 09:21:55.274
false,false,1198,1124,74,130,00:00:32.000,2025-04-15 09:22:08.287
false,false,1199,1125,74,163,00:00:33.000,2025-04-15 09:22:09.287
false,false,1244,1169,75,1590,00:00:32.000,2025-04-15 09:22:54.327
false,false,1245,1169,76,1620,00:00:30.000,2025-04-15 09:22:55.328
false,false,1255,1178,77,254,00:00:32.000,2025-04-15 09:23:11.346
false,false,1257,1180,77,317,00:00:32.000,2025-04-15 09:23:13.348
false,false,1260,1183,77,411,00:00:30.000,2025-04-15 09:23:16.352
false,true,1263,1186,77,0,00:00:00.000,2025-04-15 09:23:20.356
false,false,1274,1195,79,346,00:00:31.000,2025-04-15 09:23:36.374
false,false,1301,1219,82,1200,00:00:32.000,2025-04-15 09:24:03.403
false,false,1313,1231,82,188,00:00:30.000,2025-04-15 09:24:21.420
false,false,1327,1245,82,635,00:00:30.000,2025-04-15 09:24:35.440
false,false,1332,1250,82,789,00:00:30.000,2025-04-15 09:24:40.444
false,false,1348,1264,84,1284,00:00:32.000,2025-04-15 09:24:56.464
false,false,1354,1270,84,62,00:00:32.000,2025-04-15 09:25:08.477
false,false,1361,1277,84,220,00:00:31.000,2025-04-15 09:25:21.489
false,false,1121,1055,66,190,00:00:31.000,2025-04-15 09:20:33.200
false,false,1382,1297,85,31,00:00:31.000,2025-04-15 09:25:48.521
false,false,1383,1298,85,63,00:00:32.000,2025-04-15 09:25:49.523
false,true,1426,1339,87,0,00:00:00.000,2025-04-15 09:26:36.575
false,false,1441,1354,87,471,00:00:31.000,2025-04-15 09:26:53.595
false,false,1443,1356,87,531,00:00:30.000,2025-04-15 09:26:55.597
false,false,1454,1365,89,64,00:00:31.000,2025-04-15 09:27:12.608
false,false,1464,1374,90,32,00:00:32.000,2025-04-15 09:27:28.626
false,false,1471,1381,90,250,00:00:32.000,2025-04-15 09:27:35.635
false,false,1481,1390,91,191,00:00:31.000,2025-04-15 09:27:51.648
false,false,1483,1392,91,253,00:00:32.000,2025-04-15 09:27:53.649
false,false,1496,1404,92,63,00:00:33.000,2025-04-15 09:28:12.666
false,false,1541,1444,97,1037,00:00:32.000,2025-04-15 09:29:03.719
false,false,1556,1458,98,312,00:00:32.000,2025-04-15 09:29:24.747
false,true,1560,1462,98,0,00:00:00.000,2025-04-15 09:29:30.754
false,false,1569,1470,99,286,00:00:31.000,2025-04-15 09:29:43.766
false,false,1572,1473,99,380,00:00:31.000,2025-04-15 09:29:46.771
false,false,1576,1476,100,508,00:00:32.000,2025-04-15 09:29:50.773
false,false,1583,1481,102,731,00:00:31.000,2025-04-15 09:29:57.777
false,true,1585,1483,102,0,00:00:00.000,2025-04-15 09:30:03.784
false,false,1595,1493,102,64,00:00:32.000,2025-04-15 09:30:21.803
false,false,1712,1604,108,3208,00:00:32.000,2025-04-15 09:32:30.923
false,false,1725,1616,109,3620,00:00:31.000,2025-04-15 09:32:43.934
false,true,1744,1635,109,0,00:00:00.000,2025-04-15 09:33:07.958
false,false,1751,1641,110,222,00:00:30.000,2025-04-15 09:33:15.968
false,true,1753,1643,110,0,00:00:00.000,2025-04-15 09:33:19.974
false,false,1760,1650,110,226,00:00:33.000,2025-04-15 09:33:30.986
false,true,1762,1652,110,0,00:00:00.000,2025-04-15 09:33:38.998
false,true,1769,1658,111,0,00:00:00.000,2025-04-15 09:33:50.010
false,false,1770,1659,111,33,00:00:33.000,2025-04-15 09:33:53.014
false,false,1774,1663,111,156,00:00:31.000,2025-04-15 09:33:57.017
false,false,1628,1525,103,564,00:00:31.000,2025-04-15 09:31:06.843
false,false,1634,1531,103,754,00:00:30.000,2025-04-15 09:31:12.849
false,false,1665,1561,104,1727,00:00:30.000,2025-04-15 09:31:43.880
false,false,1669,1564,105,1853,00:00:33.000,2025-04-15 09:31:47.882
false,false,1673,1568,105,1980,00:00:32.000,2025-04-15 09:31:51.887
false,false,1679,1574,105,2172,00:00:33.000,2025-04-15 09:31:57.891
false,false,1682,1576,106,2268,00:00:32.000,2025-04-15 09:32:00.893
false,false,1689,1581,108,2489,00:00:32.000,2025-04-15 09:32:07.901
false,false,1691,1583,108,2550,00:00:31.000,2025-04-15 09:32:09.904
false,false,1701,1593,108,2858,00:00:30.000,2025-04-15 09:32:19.915
false,false,1703,1595,108,2924,00:00:33.000,2025-04-15 09:32:21.916
false,false,1805,1692,113,374,00:00:32.000,2025-04-15 09:34:46.067
false,false,1822,1709,113,350,00:00:32.000,2025-04-15 09:35:09.096
false,true,1830,1717,113,0,00:00:00.000,2025-04-15 09:35:31.116
false,false,1837,1723,114,212,00:00:30.000,2025-04-15 09:35:42.129
false,false,1844,1730,114,64,00:00:32.000,2025-04-15 09:35:55.143
false,false,1848,1734,114,189,00:00:31.000,2025-04-15 09:35:59.146
false,false,1866,1752,114,752,00:00:32.000,2025-04-15 09:36:17.168
false,false,1870,1755,115,879,00:00:33.000,2025-04-15 09:36:21.172
false,false,1873,1758,115,971,00:00:32.000,2025-04-15 09:36:24.176
false,false,1890,1774,116,282,00:00:31.000,2025-04-15 09:36:53.210
false,true,1914,1797,117,0,00:00:00.000,2025-04-15 09:37:27.245
false,false,1921,1804,117,157,00:00:32.000,2025-04-15 09:37:42.262
false,false,1925,1808,117,283,00:00:33.000,2025-04-15 09:37:46.265
false,true,1929,1812,117,0,00:00:00.000,2025-04-15 09:37:56.275
false,true,1931,1814,117,0,00:00:00.000,2025-04-15 09:38:01.281
false,true,1931,1814,117,0,00:00:00.000,2025-04-15 09:38:03.284
false,false,1933,1816,117,64,00:00:33.000,2025-04-15 09:38:06.286
false,false,1960,1842,118,283,00:00:31.000,2025-04-15 09:38:39.325
false,false,2046,1920,126,341,00:00:33.000,2025-04-15 09:40:47.451
false,true,2068,1942,126,0,00:00:00.000,2025-04-15 09:41:15.477
false,false,2119,1990,129,873,00:00:31.000,2025-04-15 09:42:12.540
false,false,2129,2000,129,1191,00:00:33.000,2025-04-15 09:42:22.551
false,false,2131,2002,129,1254,00:00:32.000,2025-04-15 09:42:24.553
false,false,2143,2013,130,1631,00:00:33.000,2025-04-15 09:42:36.565
false,false,2209,2074,135,3724,00:00:32.000,2025-04-15 09:43:42.633
false,false,2216,2079,137,3945,00:00:32.000,2025-04-15 09:43:49.641
false,false,2219,2082,137,4043,00:00:32.000,2025-04-15 09:43:52.646
false,false,1564,1471,93,1779,00:00:33.000,2025-04-14 11:37:25.031
false,false,1567,1474,93,1873,00:00:32.000,2025-04-14 11:37:31.036
false,false,1305,1232,73,445,00:00:32.000,2025-04-14 11:26:10.526
false,false,1313,1238,75,693,00:00:32.000,2025-04-14 11:26:26.540
false,false,1319,1244,75,888,00:00:31.000,2025-04-14 11:26:38.550
false,false,1325,1249,76,1071,00:00:31.000,2025-04-14 11:26:50.557
false,false,1326,1250,76,1103,00:00:32.000,2025-04-14 11:26:52.557
false,false,1351,1273,78,1890,00:00:30.000,2025-04-14 11:27:42.597
false,true,1364,1285,79,0,00:00:00.000,2025-04-14 11:28:12.625
false,true,1364,1285,79,0,00:00:00.000,2025-04-14 11:28:18.630
false,true,1364,1285,79,0,00:00:00.000,2025-04-14 11:28:20.631
false,true,1438,1353,85,0,00:00:00.000,2025-04-14 11:32:08.789
false,false,1475,1388,87,31,00:00:31.000,2025-04-14 11:34:02.875
false,false,1478,1391,87,129,00:00:32.000,2025-04-14 11:34:08.880
false,false,1489,1402,87,95,00:00:31.000,2025-04-14 11:34:42.903
false,true,457,426,31,0,00:00:00.000,2025-04-16 10:23:21.964
false,false,468,437,31,343,00:00:33.000,2025-04-16 10:23:27.973
false,false,427,396,31,1851,00:00:33.000,2025-04-16 10:22:55.422
false,false,429,398,31,1915,00:00:32.000,2025-04-16 10:22:56.425
false,true,273,255,18,0,00:00:00.000,2025-04-16 10:21:21.287
false,true,282,264,18,0,00:00:00.000,2025-04-16 10:21:28.792
false,true,297,278,19,0,00:00:00.000,2025-04-16 10:21:39.807
false,true,297,278,19,0,00:00:00.000,2025-04-16 10:21:40.308
false,false,306,286,20,284,00:00:32.000,2025-04-16 10:21:45.819
false,false,309,288,21,374,00:00:30.000,2025-04-16 10:21:47.320
false,true,310,289,21,0,00:00:00.000,2025-04-16 10:21:49.822
false,false,347,323,24,1166,00:00:33.000,2025-04-16 10:22:12.360
false,false,372,346,26,128,00:00:31.000,2025-04-16 10:22:27.884
false,false,404,377,27,1129,00:00:33.000,2025-04-16 10:22:43.909
false,false,406,379,27,1191,00:00:30.000,2025-04-16 10:22:44.909
false,false,491,459,32,281,00:00:32.000,2025-04-16 10:23:45.497
false,false,495,463,32,407,00:00:33.000,2025-04-16 10:23:47.500
false,true,522,489,33,0,00:00:00.000,2025-04-16 10:24:08.035
false,false,1185,1115,70,1452,00:00:31.000,2025-04-15 09:21:43.263
false,false,1196,1122,74,66,00:00:33.000,2025-04-15 09:22:06.284
false,false,1200,1126,74,194,00:00:31.000,2025-04-15 09:22:10.288
false,false,1212,1138,74,574,00:00:32.000,2025-04-15 09:22:22.296
false,false,1228,1154,74,1085,00:00:31.000,2025-04-15 09:22:38.310
false,false,1231,1157,74,1181,00:00:30.000,2025-04-15 09:22:41.314
false,false,1238,1163,75,1399,00:00:31.000,2025-04-15 09:22:48.321
false,false,1242,1167,75,1528,00:00:31.000,2025-04-15 09:22:52.326
false,true,1247,1171,76,0,00:00:00.000,2025-04-15 09:23:00.333
false,false,1288,1208,80,792,00:00:33.000,2025-04-15 09:23:50.388
false,false,1297,1215,82,1076,00:00:33.000,2025-04-15 09:23:59.399
false,false,1298,1216,82,1106,00:00:30.000,2025-04-15 09:24:00.400
false,false,1336,1253,83,914,00:00:31.000,2025-04-15 09:24:44.449
false,false,1346,1262,84,1222,00:00:31.000,2025-04-15 09:24:54.462
false,false,1353,1269,84,30,00:00:30.000,2025-04-15 09:25:07.477
false,false,1124,1057,67,286,00:00:32.000,2025-04-15 09:20:36.203
false,false,1129,1062,67,444,00:00:30.000,2025-04-15 09:20:41.209
false,true,1381,1297,84,0,00:00:00.000,2025-04-15 09:25:42.513
false,true,1381,1297,84,0,00:00:00.000,2025-04-15 09:25:44.515
false,false,1410,1323,87,905,00:00:31.000,2025-04-15 09:26:16.552
false,false,1418,1331,87,1160,00:00:33.000,2025-04-15 09:26:24.564
false,false,1422,1335,87,1285,00:00:33.000,2025-04-15 09:26:28.570
false,true,1475,1385,90,0,00:00:00.000,2025-04-15 09:27:41.640
false,true,1475,1385,90,0,00:00:00.000,2025-04-15 09:27:45.644
false,false,1486,1394,92,349,00:00:31.000,2025-04-15 09:27:56.653
false,false,1488,1396,92,409,00:00:30.000,2025-04-15 09:27:58.653
false,false,1498,1405,93,128,00:00:32.000,2025-04-15 09:28:14.667
false,false,1526,1430,96,565,00:00:30.000,2025-04-15 09:28:48.704
false,false,1527,1431,96,597,00:00:32.000,2025-04-15 09:28:49.705
false,false,1530,1434,96,694,00:00:32.000,2025-04-15 09:28:52.708
false,false,1573,1474,99,411,00:00:31.000,2025-04-15 09:29:47.772
false,false,1582,1480,102,700,00:00:33.000,2025-04-15 09:29:56.777
false,true,1753,1643,110,0,00:00:00.000,2025-04-15 09:33:23.981
false,false,1643,1540,103,1032,00:00:30.000,2025-04-15 09:31:21.859
false,true,1777,1666,111,0,00:00:00.000,2025-04-15 09:34:06.025
false,false,1796,1684,112,92,00:00:30.000,2025-04-15 09:34:37.060
false,false,1839,1725,114,273,00:00:30.000,2025-04-15 09:35:44.131
false,true,1842,1728,114,0,00:00:00.000,2025-04-15 09:35:52.138
false,false,1852,1738,114,312,00:00:31.000,2025-04-15 09:36:03.152
false,false,1855,1741,114,406,00:00:31.000,2025-04-15 09:36:06.154
false,true,1881,1766,115,0,00:00:00.000,2025-04-15 09:36:41.195
false,true,1914,1797,117,0,00:00:00.000,2025-04-15 09:37:25.243
false,true,1916,1799,117,0,00:00:00.000,2025-04-15 09:37:32.252
false,false,1929,1812,117,410,00:00:32.000,2025-04-15 09:37:50.269
false,false,1959,1841,118,252,00:00:33.000,2025-04-15 09:38:38.325
false,false,1969,1851,118,571,00:00:32.000,2025-04-15 09:38:48.335
false,false,2069,1943,126,33,00:00:33.000,2025-04-15 09:41:16.478
false,false,2074,1947,127,191,00:00:30.000,2025-04-15 09:41:21.482
false,false,2075,1948,127,223,00:00:32.000,2025-04-15 09:41:22.484
false,false,2100,1973,127,275,00:00:30.000,2025-04-15 09:41:53.519
false,false,2114,1987,127,716,00:00:31.000,2025-04-15 09:42:07.534
false,false,2128,1999,129,1158,00:00:33.000,2025-04-15 09:42:21.549
false,false,2147,2016,131,1756,00:00:31.000,2025-04-15 09:42:40.569
false,false,2151,2020,131,1884,00:00:33.000,2025-04-15 09:42:44.574
false,false,2170,2037,133,2482,00:00:30.000,2025-04-15 09:43:03.590
false,false,2201,2066,135,3474,00:00:33.000,2025-04-15 09:43:34.623
false,false,2203,2068,135,3534,00:00:30.000,2025-04-15 09:43:36.626
false,false,1571,1477,94,1998,00:00:30.000,2025-04-14 11:37:39.042
false,false,1592,1497,95,159,00:00:33.000,2025-04-14 11:38:33.076
false,false,1594,1499,95,224,00:00:32.000,2025-04-14 11:38:37.077
false,true,1291,1218,73,0,00:00:00.000,2025-04-14 11:25:40.507
false,true,1441,1356,85,0,00:00:00.000,2025-04-14 11:32:26.805
false,false,1444,1359,85,97,00:00:31.000,2025-04-14 11:32:36.813
false,false,1461,1376,85,630,00:00:30.000,2025-04-14 11:33:10.836
false,false,1466,1380,86,790,00:00:31.000,2025-04-14 11:33:20.843
false,false,1483,1396,87,288,00:00:30.000,2025-04-14 11:34:18.885
false,false,1502,1414,88,501,00:00:30.000,2025-04-14 11:35:08.923
false,false,1390,1308,82,474,00:00:31.000,2025-04-14 11:29:36.682
false,true,1390,1308,82,0,00:00:00.000,2025-04-14 11:29:44.688
false,false,1406,1324,82,193,00:00:33.000,2025-04-14 11:30:32.727
false,false,1416,1333,83,508,00:00:32.000,2025-04-14 11:30:52.744
false,false,456,425,31,33,00:00:33.000,2025-04-16 10:23:15.953
false,false,458,427,31,33,00:00:33.000,2025-04-16 10:23:22.965
false,false,460,429,31,93,00:00:30.000,2025-04-16 10:23:23.967
false,false,417,389,28,1533,00:00:32.000,2025-04-16 10:22:50.417
false,true,436,405,31,0,00:00:00.000,2025-04-16 10:23:00.432
false,false,259,241,18,351,00:00:33.000,2025-04-16 10:21:13.277
false,false,264,246,18,512,00:00:33.000,2025-04-16 10:21:15.781
false,true,273,255,18,0,00:00:00.000,2025-04-16 10:21:22.787
false,true,273,255,18,0,00:00:00.000,2025-04-16 10:21:23.287
false,false,284,266,18,65,00:00:33.000,2025-04-16 10:21:31.796
false,false,286,268,18,130,00:00:32.000,2025-04-16 10:21:32.798
false,false,295,276,19,408,00:00:31.000,2025-04-16 10:21:37.303
false,false,311,290,21,30,00:00:30.000,2025-04-16 10:21:54.330
false,false,321,299,22,341,00:00:31.000,2025-04-16 10:21:59.339
false,false,244,227,17,278,00:00:31.000,2025-04-16 10:20:59.759
false,false,323,301,22,405,00:00:32.000,2025-04-16 10:22:00.340
false,false,324,302,22,435,00:00:30.000,2025-04-16 10:22:00.841
false,false,332,308,24,690,00:00:32.000,2025-04-16 10:22:04.846
false,false,333,309,24,722,00:00:32.000,2025-04-16 10:22:05.348
false,false,335,311,24,787,00:00:33.000,2025-04-16 10:22:06.350
false,false,348,323,25,1198,00:00:32.000,2025-04-16 10:22:12.861
false,false,366,340,26,1766,00:00:33.000,2025-04-16 10:22:21.874
false,true,368,342,26,0,00:00:00.000,2025-04-16 10:22:23.376
false,false,393,366,27,783,00:00:33.000,2025-04-16 10:22:38.402
false,false,407,380,27,1221,00:00:30.000,2025-04-16 10:22:45.411
false,false,414,387,27,1439,00:00:32.000,2025-04-16 10:22:48.916
false,true,482,450,32,0,00:00:00.000,2025-04-16 10:23:35.985
false,false,515,482,33,439,00:00:30.000,2025-04-16 10:24:00.519
false,true,516,483,33,0,00:00:00.000,2025-04-16 10:24:03.525
false,true,534,498,36,0,00:00:00.000,2025-04-16 10:24:17.545
false,false,1132,1065,67,541,00:00:32.000,2025-04-15 09:20:44.208
false,false,1147,1080,67,260,00:00:33.000,2025-04-15 09:21:05.225
false,false,1152,1085,67,419,00:00:31.000,2025-04-15 09:21:10.231
false,false,1163,1095,68,764,00:00:30.000,2025-04-15 09:21:21.244
false,false,1237,1162,75,1368,00:00:31.000,2025-04-15 09:22:47.320
false,false,1261,1184,77,442,00:00:31.000,2025-04-15 09:23:17.353
false,true,1263,1186,77,0,00:00:00.000,2025-04-15 09:23:24.360
false,true,1263,1186,77,0,00:00:00.000,2025-04-15 09:23:25.361
false,false,1277,1198,79,443,00:00:32.000,2025-04-15 09:23:39.376
false,false,1291,1210,81,885,00:00:30.000,2025-04-15 09:23:53.392
false,false,1295,1213,82,1013,00:00:33.000,2025-04-15 09:23:57.397
false,true,1307,1225,82,0,00:00:00.000,2025-04-15 09:24:11.411
false,true,1354,1270,84,0,00:00:00.000,2025-04-15 09:25:10.480
false,false,1360,1276,84,189,00:00:33.000,2025-04-15 09:25:20.488
false,false,1365,1281,84,348,00:00:32.000,2025-04-15 09:25:25.493
false,false,1128,1061,67,414,00:00:30.000,2025-04-15 09:20:40.205
false,true,1381,1297,84,0,00:00:00.000,2025-04-15 09:25:45.516
false,false,1385,1300,85,123,00:00:30.000,2025-04-15 09:25:51.525
false,false,1457,1368,89,162,00:00:33.000,2025-04-15 09:27:15.611
false,false,1460,1371,89,254,00:00:32.000,2025-04-15 09:27:18.615
false,true,1463,1374,89,0,00:00:00.000,2025-04-15 09:27:24.624
false,false,1489,1397,92,440,00:00:31.000,2025-04-15 09:27:59.654
false,false,1494,1402,92,596,00:00:32.000,2025-04-15 09:28:04.657
false,true,1494,1402,92,0,00:00:00.000,2025-04-15 09:28:07.661
false,true,1508,1414,94,0,00:00:00.000,2025-04-15 09:28:30.685
false,false,1518,1424,94,314,00:00:31.000,2025-04-15 09:28:40.696
false,false,1549,1452,97,92,00:00:31.000,2025-04-15 09:29:17.737
false,false,1575,1476,99,476,00:00:32.000,2025-04-15 09:29:49.773
false,false,1586,1484,102,30,00:00:30.000,2025-04-15 09:30:06.786
false,true,1593,1491,102,0,00:00:00.000,2025-04-15 09:30:14.795
false,true,1608,1506,102,0,00:00:00.000,2025-04-15 09:30:35.817
false,false,1716,1608,108,3333,00:00:32.000,2025-04-15 09:32:34.928
false,false,1762,1652,110,292,00:00:33.000,2025-04-15 09:33:32.990
false,true,1769,1658,111,0,00:00:00.000,2025-04-15 09:33:47.008
false,false,1610,1508,102,60,00:00:30.000,2025-04-15 09:30:42.822
false,false,1615,1513,102,155,00:00:31.000,2025-04-15 09:30:53.832
false,false,1661,1558,103,1602,00:00:31.000,2025-04-15 09:31:39.876
false,false,1681,1575,106,2236,00:00:31.000,2025-04-15 09:31:59.892
false,false,1686,1579,107,2393,00:00:33.000,2025-04-15 09:32:04.898
false,true,1777,1666,111,0,00:00:00.000,2025-04-15 09:34:04.024
false,false,1791,1679,112,156,00:00:30.000,2025-04-15 09:34:26.048
false,true,1793,1681,112,0,00:00:00.000,2025-04-15 09:34:34.057
false,false,1826,1713,113,92,00:00:30.000,2025-04-15 09:35:19.105
false,true,1830,1717,113,0,00:00:00.000,2025-04-15 09:35:32.118
false,false,1872,1757,115,939,00:00:30.000,2025-04-15 09:36:23.175
false,false,1874,1759,115,1002,00:00:31.000,2025-04-15 09:36:25.177
false,false,1881,1766,115,1218,00:00:32.000,2025-04-15 09:36:32.184
false,true,1891,1775,116,0,00:00:00.000,2025-04-15 09:36:56.214
false,true,1916,1799,117,0,00:00:00.000,2025-04-15 09:37:37.255
false,false,1923,1806,117,220,00:00:30.000,2025-04-15 09:37:44.263
false,false,1928,1811,117,378,00:00:32.000,2025-04-15 09:37:49.268
false,true,1929,1812,117,0,00:00:00.000,2025-04-15 09:37:51.271
false,false,1938,1821,117,221,00:00:32.000,2025-04-15 09:38:11.292
false,true,1951,1833,118,0,00:00:00.000,2025-04-15 09:38:28.311
false,false,1952,1834,118,30,00:00:30.000,2025-04-15 09:38:31.314
false,false,1967,1849,118,508,00:00:33.000,2025-04-15 09:38:46.333
false,false,2044,1918,126,278,00:00:33.000,2025-04-15 09:40:45.449
false,false,2055,1929,126,627,00:00:30.000,2025-04-15 09:40:56.458
false,false,2080,1953,127,383,00:00:33.000,2025-04-15 09:41:27.491
false,false,2090,1963,127,694,00:00:30.000,2025-04-15 09:41:37.502
false,false,2109,1982,127,559,00:00:31.000,2025-04-15 09:42:02.528
false,false,2156,2024,132,2046,00:00:31.000,2025-04-15 09:42:49.581
false,false,2167,2035,132,2390,00:00:30.000,2025-04-15 09:43:00.589
false,false,1569,1475,94,1936,00:00:31.000,2025-04-14 11:37:35.038
false,false,1576,1481,95,2154,00:00:32.000,2025-04-14 11:37:49.051
false,false,1290,1217,73,530,00:00:33.000,2025-04-14 11:25:28.498
false,false,1349,1271,78,1830,00:00:33.000,2025-04-14 11:27:38.595
false,true,1441,1356,85,0,00:00:00.000,2025-04-14 11:32:20.798
false,false,1470,1384,86,912,00:00:30.000,2025-04-14 11:33:28.848
false,true,1473,1387,86,0,00:00:00.000,2025-04-14 11:33:46.860
false,true,1375,1295,80,0,00:00:00.000,2025-04-14 11:28:56.649
false,true,1390,1308,82,0,00:00:00.000,2025-04-14 11:29:38.682
false,false,1418,1335,83,568,00:00:30.000,2025-04-14 11:30:56.747
false,false,1424,1339,85,758,00:00:31.000,2025-04-14 11:31:08.754
false,true,1428,1343,85,0,00:00:00.000,2025-04-14 11:31:24.763
false,true,457,426,31,0,00:00:00.000,2025-04-16 10:23:17.456
false,true,457,426,31,0,00:00:00.000,2025-04-16 10:23:18.958
false,false,461,430,31,123,00:00:30.000,2025-04-16 10:23:24.469
false,true,436,405,31,0,00:00:00.000,2025-04-16 10:23:00.932
false,false,273,255,18,794,00:00:32.000,2025-04-16 10:21:20.286
false,false,296,277,19,439,00:00:31.000,2025-04-16 10:21:37.804
false,false,301,282,19,124,00:00:32.000,2025-04-16 10:21:43.314
false,false,304,284,20,222,00:00:32.000,2025-04-16 10:21:44.817
false,false,308,287,21,344,00:00:30.000,2025-04-16 10:21:46.820
false,true,310,289,21,0,00:00:00.000,2025-04-16 10:21:53.829
false,true,235,218,17,0,00:00:00.000,2025-04-16 10:20:53.750
false,false,247,230,17,93,00:00:30.000,2025-04-16 10:21:04.266
false,false,346,322,24,1133,00:00:30.000,2025-04-16 10:22:11.859
false,false,368,342,26,1831,00:00:33.000,2025-04-16 10:22:22.876
false,false,401,374,27,1031,00:00:33.000,2025-04-16 10:22:42.406
false,false,479,447,32,690,00:00:33.000,2025-04-16 10:23:33.482
false,false,504,471,33,92,00:00:30.000,2025-04-16 10:23:55.011
false,false,509,476,33,250,00:00:32.000,2025-04-16 10:23:57.515
false,true,534,498,36,0,00:00:00.000,2025-04-16 10:24:17.044
false,false,1135,1068,67,636,00:00:33.000,2025-04-15 09:20:47.210
false,false,1146,1079,67,227,00:00:32.000,2025-04-15 09:21:04.226
false,true,1186,1115,71,0,00:00:00.000,2025-04-15 09:21:49.267
false,true,1194,1120,74,0,00:00:00.000,2025-04-15 09:22:02.280
false,false,1211,1137,74,542,00:00:30.000,2025-04-15 09:22:21.296
false,false,1222,1148,74,894,00:00:33.000,2025-04-15 09:22:32.305
false,true,1247,1171,76,0,00:00:00.000,2025-04-15 09:23:03.338
false,false,1248,1172,76,31,00:00:31.000,2025-04-15 09:23:04.338
false,false,1258,1181,77,350,00:00:33.000,2025-04-15 09:23:14.349
false,false,1268,1190,78,157,00:00:33.000,2025-04-15 09:23:30.366
false,false,1270,1192,78,221,00:00:33.000,2025-04-15 09:23:32.369
false,false,1283,1203,80,630,00:00:30.000,2025-04-15 09:23:45.382
false,false,1323,1241,82,509,00:00:32.000,2025-04-15 09:24:31.433
false,false,1330,1248,82,728,00:00:30.000,2025-04-15 09:24:38.442
false,true,1354,1270,84,0,00:00:00.000,2025-04-15 09:25:09.478
false,false,1376,1292,84,693,00:00:30.000,2025-04-15 09:25:36.508
false,false,1387,1302,85,184,00:00:30.000,2025-04-15 09:25:53.528
false,false,1399,1312,87,557,00:00:33.000,2025-04-15 09:26:05.540
false,false,1411,1324,87,938,00:00:33.000,2025-04-15 09:26:17.553
false,true,1426,1339,87,0,00:00:00.000,2025-04-15 09:26:33.573
false,true,1426,1339,87,0,00:00:00.000,2025-04-15 09:26:37.577
false,true,1452,1364,88,0,00:00:00.000,2025-04-15 09:27:06.603
false,true,1452,1364,88,0,00:00:00.000,2025-04-15 09:27:10.606
false,true,1463,1374,89,0,00:00:00.000,2025-04-15 09:27:25.625
false,false,1548,1451,97,61,00:00:30.000,2025-04-15 09:29:16.734
false,false,1568,1469,99,255,00:00:32.000,2025-04-15 09:29:42.765
false,false,1571,1472,99,349,00:00:33.000,2025-04-15 09:29:45.769
false,false,1574,1475,99,444,00:00:33.000,2025-04-15 09:29:48.772
false,true,1593,1491,102,0,00:00:00.000,2025-04-15 09:30:19.800
false,true,1608,1506,102,0,00:00:00.000,2025-04-15 09:30:40.822
false,false,1705,1597,108,2987,00:00:31.000,2025-04-15 09:32:23.918
false,false,1724,1615,109,3589,00:00:32.000,2025-04-15 09:32:42.935
false,false,1729,1620,109,3742,00:00:31.000,2025-04-15 09:32:47.940
false,false,1737,1628,109,3987,00:00:31.000,2025-04-15 09:32:55.947
false,false,1746,1637,109,64,00:00:31.000,2025-04-15 09:33:10.962
false,false,1755,1645,110,65,00:00:33.000,2025-04-15 09:33:25.984
false,false,1772,1661,111,94,00:00:31.000,2025-04-15 09:33:55.016
false,false,1776,1665,111,222,00:00:33.000,2025-04-15 09:33:59.018
false,false,1617,1515,102,217,00:00:30.000,2025-04-15 09:30:55.832
false,false,1630,1527,103,626,00:00:32.000,2025-04-15 09:31:08.846
false,false,1633,1530,103,724,00:00:32.000,2025-04-15 09:31:11.848
false,false,1636,1533,103,815,00:00:31.000,2025-04-15 09:31:14.852
false,false,1644,1541,103,1065,00:00:33.000,2025-04-15 09:31:22.859
false,false,1658,1555,103,1509,00:00:32.000,2025-04-15 09:31:36.872
false,false,1659,1556,103,1540,00:00:31.000,2025-04-15 09:31:37.873
false,true,1786,1674,112,0,00:00:00.000,2025-04-15 09:34:18.038
false,false,1823,1710,113,381,00:00:31.000,2025-04-15 09:35:10.097
false,true,1842,1728,114,0,00:00:00.000,2025-04-15 09:35:49.136
false,true,1842,1728,114,0,00:00:00.000,2025-04-15 09:35:53.141
false,false,1859,1745,114,530,00:00:33.000,2025-04-15 09:36:10.162
false,false,1889,1773,116,251,00:00:32.000,2025-04-15 09:36:52.209
false,true,1891,1775,116,0,00:00:00.000,2025-04-15 09:36:57.214
false,false,1905,1789,116,431,00:00:33.000,2025-04-15 09:37:14.230
false,false,1912,1796,116,653,00:00:32.000,2025-04-15 09:37:21.238
false,false,1919,1802,117,95,00:00:31.000,2025-04-15 09:37:40.260
false,false,1936,1819,117,159,00:00:32.000,2025-04-15 09:38:09.290
false,false,1937,1820,117,189,00:00:30.000,2025-04-15 09:38:10.291
false,false,1939,1822,117,253,00:00:32.000,2025-04-15 09:38:12.292
false,false,1949,1831,118,568,00:00:33.000,2025-04-15 09:38:22.305
false,false,1951,1833,118,628,00:00:30.000,2025-04-15 09:38:24.307
false,false,1972,1853,119,31,00:00:31.000,2025-04-15 09:38:57.345
false,false,2045,1919,126,308,00:00:30.000,2025-04-15 09:40:46.449
false,false,2052,1926,126,535,00:00:32.000,2025-04-15 09:40:53.455
false,false,2053,1927,126,565,00:00:30.000,2025-04-15 09:40:54.456
false,false,2062,1936,126,849,00:00:32.000,2025-04-15 09:41:03.467
false,false,2066,1940,126,970,00:00:30.000,2025-04-15 09:41:07.471
false,false,2087,1960,127,603,00:00:32.000,2025-04-15 09:41:34.498
false,true,2091,1964,127,0,00:00:00.000,2025-04-15 09:41:41.505
false,false,2094,1967,127,91,00:00:30.000,2025-04-15 09:41:47.512
false,false,2106,1979,127,465,00:00:30.000,2025-04-15 09:41:59.525
false,false,2113,1986,127,685,00:00:31.000,2025-04-15 09:42:06.532
false,false,2130,2001,129,1222,00:00:31.000,2025-04-15 09:42:23.552
false,false,2171,2038,133,2515,00:00:33.000,2025-04-15 09:43:04.591
false,false,2195,2061,134,3282,00:00:33.000,2025-04-15 09:43:28.617
false,false,2206,2071,135,3629,00:00:31.000,2025-04-15 09:43:39.631
false,false,2212,2076,136,3819,00:00:32.000,2025-04-15 09:43:45.637
false,false,2220,2082,138,4075,00:00:32.000,2025-04-15 09:43:53.646
false,false,2222,2084,138,4138,00:00:31.000,2025-04-15 09:43:55.649
false,true,1291,1218,73,0,00:00:00.000,2025-04-14 11:25:32.501
false,false,1300,1227,73,288,00:00:30.000,2025-04-14 11:26:00.520
false,false,1315,1240,75,759,00:00:33.000,2025-04-14 11:26:30.543
false,false,1340,1263,77,1548,00:00:30.000,2025-04-14 11:27:20.578
false,false,1343,1266,77,1643,00:00:33.000,2025-04-14 11:27:26.583
false,false,1348,1270,78,1797,00:00:30.000,2025-04-14 11:27:36.593
false,false,1355,1276,79,2016,00:00:30.000,2025-04-14 11:27:50.605
false,false,1443,1358,85,66,00:00:33.000,2025-04-14 11:32:34.811
false,false,1465,1380,85,759,00:00:33.000,2025-04-14 11:33:18.841
false,true,1474,1388,86,0,00:00:00.000,2025-04-14 11:33:54.867
false,true,1474,1388,86,0,00:00:00.000,2025-04-14 11:33:58.872
false,true,1474,1388,86,0,00:00:00.000,2025-04-14 11:34:00.874
false,true,1486,1399,87,0,00:00:00.000,2025-04-14 11:34:26.892
false,false,1503,1415,88,531,00:00:30.000,2025-04-14 11:35:10.923
false,false,1371,1291,80,30,00:00:30.000,2025-04-14 11:28:46.643
false,false,1375,1295,80,156,00:00:31.000,2025-04-14 11:28:54.646
false,true,1375,1295,80,0,00:00:00.000,2025-04-14 11:29:04.659
false,false,1381,1300,81,193,00:00:33.000,2025-04-14 11:29:18.667
false,false,1388,1306,82,413,00:00:31.000,2025-04-14 11:29:32.679
false,true,1390,1308,82,0,00:00:00.000,2025-04-14 11:29:42.686
false,false,1435,1350,85,218,00:00:33.000,2025-04-14 11:31:42.775
false,true,455,424,31,0,00:00:00.000,2025-04-16 10:23:15.453
false,true,457,426,31,0,00:00:00.000,2025-04-16 10:23:16.956
false,true,457,426,31,0,00:00:00.000,2025-04-16 10:23:17.957
false,false,421,392,29,1663,00:00:32.000,2025-04-16 10:22:52.419
false,false,422,393,29,1693,00:00:30.000,2025-04-16 10:22:52.920
false,false,426,395,31,1818,00:00:30.000,2025-04-16 10:22:54.921
false,false,430,399,31,1947,00:00:32.000,2025-04-16 10:22:56.926
false,false,255,238,17,222,00:00:32.000,2025-04-16 10:21:11.273
false,false,260,242,18,384,00:00:33.000,2025-04-16 10:21:13.777
false,false,280,262,18,219,00:00:30.000,2025-04-16 10:21:26.791
false,false,307,287,20,314,00:00:30.000,2025-04-16 10:21:46.319
false,false,312,291,21,63,00:00:33.000,2025-04-16 10:21:54.831
false,false,320,298,22,310,00:00:31.000,2025-04-16 10:21:58.838
false,false,240,223,17,155,00:00:31.000,2025-04-16 10:20:57.755
false,true,244,227,17,0,00:00:00.000,2025-04-16 10:21:02.762
false,false,252,235,17,125,00:00:30.000,2025-04-16 10:21:09.772
false,false,338,314,24,880,00:00:32.000,2025-04-16 10:22:07.852
false,false,340,316,24,946,00:00:33.000,2025-04-16 10:22:08.854
false,false,351,326,25,1293,00:00:31.000,2025-04-16 10:22:14.364
false,false,379,353,26,343,00:00:30.000,2025-04-16 10:22:31.389
false,false,380,354,26,374,00:00:31.000,2025-04-16 10:22:31.890
false,false,386,360,26,562,00:00:32.000,2025-04-16 10:22:34.896
false,false,388,361,27,624,00:00:30.000,2025-04-16 10:22:35.898
false,false,416,388,28,1501,00:00:30.000,2025-04-16 10:22:49.917
false,true,482,450,32,0,00:00:00.000,2025-04-16 10:23:39.990
false,false,485,453,32,91,00:00:30.000,2025-04-16 10:23:42.494
false,false,503,470,33,62,00:00:31.000,2025-04-16 10:23:54.510
false,false,513,480,33,378,00:00:33.000,2025-04-16 10:23:59.518
false,false,1134,1067,67,603,00:00:32.000,2025-04-15 09:20:46.208
false,true,1139,1072,67,0,00:00:00.000,2025-04-15 09:20:55.219
false,false,1141,1074,67,64,00:00:32.000,2025-04-15 09:20:59.222
false,false,1144,1077,67,162,00:00:33.000,2025-04-15 09:21:02.224
false,false,1180,1110,70,1298,00:00:32.000,2025-04-15 09:21:38.257
false,true,1194,1120,74,0,00:00:00.000,2025-04-15 09:22:00.279
false,true,1194,1120,74,0,00:00:00.000,2025-04-15 09:22:03.279
false,false,1202,1128,74,260,00:00:33.000,2025-04-15 09:22:12.290
false,false,1239,1164,75,1431,00:00:32.000,2025-04-15 09:22:49.322
false,true,1247,1171,76,0,00:00:00.000,2025-04-15 09:23:02.336
false,false,1265,1188,77,63,00:00:33.000,2025-04-15 09:23:27.363
false,false,1294,1212,82,980,00:00:33.000,2025-04-15 09:23:56.395
false,false,1307,1225,82,1391,00:00:32.000,2025-04-15 09:24:09.409
false,false,1310,1228,82,94,00:00:32.000,2025-04-15 09:24:18.418
false,false,1355,1271,84,30,00:00:30.000,2025-04-15 09:25:15.484
false,false,1369,1285,84,476,00:00:31.000,2025-04-15 09:25:29.499
false,false,1373,1289,84,599,00:00:31.000,2025-04-15 09:25:33.505
false,false,1117,1051,66,65,00:00:32.000,2025-04-15 09:20:29.195
false,false,1125,1058,67,319,00:00:33.000,2025-04-15 09:20:37.204
false,false,1396,1309,87,463,00:00:31.000,2025-04-15 09:26:02.536
false,false,1404,1317,87,720,00:00:33.000,2025-04-15 09:26:10.546
false,false,1412,1325,87,969,00:00:31.000,2025-04-15 09:26:18.555
false,false,1415,1328,87,1067,00:00:33.000,2025-04-15 09:26:21.560
false,false,1421,1334,87,1252,00:00:31.000,2025-04-15 09:26:27.567
false,false,1433,1346,87,215,00:00:32.000,2025-04-15 09:26:45.585
false,false,1439,1352,87,407,00:00:33.000,2025-04-15 09:26:51.591
false,false,1476,1386,90,31,00:00:31.000,2025-04-15 09:27:46.644
false,false,1485,1393,92,318,00:00:33.000,2025-04-15 09:27:55.652
false,false,1491,1399,92,501,00:00:31.000,2025-04-15 09:28:01.656
false,false,1506,1412,94,380,00:00:32.000,2025-04-15 09:28:22.676
false,false,1539,1442,97,975,00:00:32.000,2025-04-15 09:29:01.716
false,false,1544,1447,97,1133,00:00:31.000,2025-04-15 09:29:06.722
false,true,1546,1449,97,0,00:00:00.000,2025-04-15 09:29:10.726
false,true,1546,1449,97,0,00:00:00.000,2025-04-15 09:29:11.727
false,false,1565,1467,98,158,00:00:31.000,2025-04-15 09:29:39.761
false,true,1585,1483,102,0,00:00:00.000,2025-04-15 09:30:01.781
false,true,1585,1483,102,0,00:00:00.000,2025-04-15 09:30:05.785
false,false,1589,1487,102,124,00:00:30.000,2025-04-15 09:30:09.790
false,true,1593,1491,102,0,00:00:00.000,2025-04-15 09:30:17.799
false,true,1608,1506,102,0,00:00:00.000,2025-04-15 09:30:38.820
false,false,1706,1598,108,3018,00:00:31.000,2025-04-15 09:32:24.918
false,false,1714,1606,108,3271,00:00:31.000,2025-04-15 09:32:32.925
false,false,1715,1607,108,3301,00:00:30.000,2025-04-15 09:32:33.927
false,false,1731,1622,109,3803,00:00:31.000,2025-04-15 09:32:49.941
false,false,1733,1624,109,3864,00:00:30.000,2025-04-15 09:32:51.941
false,false,1735,1626,109,3926,00:00:30.000,2025-04-15 09:32:53.943
false,false,1741,1632,109,4114,00:00:33.000,2025-04-15 09:32:59.950
false,true,1744,1635,109,0,00:00:00.000,2025-04-15 09:33:08.959
false,false,1749,1640,109,160,00:00:31.000,2025-04-15 09:33:13.966
false,false,1753,1643,110,283,00:00:30.000,2025-04-15 09:33:17.970
false,true,1762,1652,110,0,00:00:00.000,2025-04-15 09:33:37.997
false,false,1767,1656,111,157,00:00:30.000,2025-04-15 09:33:44.004
false,false,1619,1517,102,280,00:00:33.000,2025-04-15 09:30:57.835
false,false,1620,1518,102,312,00:00:32.000,2025-04-15 09:30:58.836
false,false,1632,1529,103,692,00:00:33.000,2025-04-15 09:31:10.847
false,false,1781,1670,111,127,00:00:31.000,2025-04-15 09:34:10.029
false,true,1793,1681,112,0,00:00:00.000,2025-04-15 09:34:33.056
false,true,1823,1710,113,0,00:00:00.000,2025-04-15 09:35:14.101
false,false,1831,1718,113,30,00:00:30.000,2025-04-15 09:35:36.123
false,false,1833,1720,113,91,00:00:30.000,2025-04-15 09:35:38.124
false,false,1847,1733,114,158,00:00:32.000,2025-04-15 09:35:58.146
false,false,1854,1740,114,375,00:00:30.000,2025-04-15 09:36:05.153
false,false,1882,1767,115,30,00:00:30.000,2025-04-15 09:36:45.201
false,false,1896,1780,116,153,00:00:31.000,2025-04-15 09:37:05.221
false,false,1906,1790,116,461,00:00:30.000,2025-04-15 09:37:15.232
false,true,1931,1814,117,0,00:00:00.000,2025-04-15 09:38:00.280
false,false,1963,1845,118,380,00:00:31.000,2025-04-15 09:38:42.329
false,false,2050,1924,126,470,00:00:33.000,2025-04-15 09:40:51.454
false,false,2071,1945,126,96,00:00:31.000,2025-04-15 09:41:18.480
false,true,2091,1964,127,0,00:00:00.000,2025-04-15 09:41:39.504
false,true,2091,1964,127,0,00:00:00.000,2025-04-15 09:41:44.508
false,false,2132,2003,129,1286,00:00:32.000,2025-04-15 09:42:25.554
false,false,2154,2023,131,1982,00:00:32.000,2025-04-15 09:42:47.578
false,false,2155,2023,132,2015,00:00:33.000,2025-04-15 09:42:48.580
false,false,2172,2039,133,2547,00:00:32.000,2025-04-15 09:43:05.592
false,false,2191,2057,134,3154,00:00:32.000,2025-04-15 09:43:24.613
false,false,2214,2077,137,3882,00:00:30.000,2025-04-15 09:43:47.639
false,false,2227,2088,139,4296,00:00:32.000,2025-04-15 09:44:00.654
false,false,1586,1491,95,2470,00:00:32.000,2025-04-14 11:38:09.060
false,true,1587,1492,95,0,00:00:00.000,2025-04-14 11:38:15.065
false,false,1324,1248,76,1040,00:00:30.000,2025-04-14 11:26:48.556
false,false,1342,1265,77,1610,00:00:30.000,2025-04-14 11:27:24.580
false,false,1362,1283,79,2234,00:00:33.000,2025-04-14 11:28:04.618
false,true,1438,1353,85,0,00:00:00.000,2025-04-14 11:32:12.792
false,false,1445,1360,85,128,00:00:31.000,2025-04-14 11:32:38.814
false,false,1454,1369,85,409,00:00:30.000,2025-04-14 11:32:56.825
false,false,1456,1371,85,473,00:00:33.000,2025-04-14 11:33:00.830
false,false,1462,1377,85,663,00:00:33.000,2025-04-14 11:33:12.836
false,false,1477,1390,87,97,00:00:33.000,2025-04-14 11:34:06.878
false,true,1486,1399,87,0,00:00:00.000,2025-04-14 11:34:36.900
false,true,1375,1295,80,0,00:00:00.000,2025-04-14 11:29:02.657
false,false,1392,1310,82,63,00:00:33.000,2025-04-14 11:29:52.694
false,false,1410,1328,82,318,00:00:31.000,2025-04-14 11:30:40.734
false,true,1436,1351,85,0,00:00:00.000,2025-04-14 11:31:54.780
false,true,457,426,31,0,00:00:00.000,2025-04-16 10:23:19.959
false,false,459,428,31,63,00:00:30.000,2025-04-16 10:23:23.466
false,true,282,264,18,0,00:00:00.000,2025-04-16 10:21:29.293
false,true,282,264,18,0,00:00:00.000,2025-04-16 10:21:30.795
false,false,290,271,19,252,00:00:30.000,2025-04-16 10:21:34.800
false,false,293,274,19,347,00:00:33.000,2025-04-16 10:21:36.303
false,false,294,275,19,377,00:00:30.000,2025-04-16 10:21:36.803
false,false,310,289,21,407,00:00:33.000,2025-04-16 10:21:47.820
false,true,310,289,21,0,00:00:00.000,2025-04-16 10:21:48.822
false,false,313,291,22,93,00:00:30.000,2025-04-16 10:21:55.332
false,false,249,232,17,32,00:00:32.000,2025-04-16 10:21:08.270
false,false,325,303,22,465,00:00:30.000,2025-04-16 10:22:01.341
false,false,342,318,24,1008,00:00:32.000,2025-04-16 10:22:09.856
false,true,368,342,26,0,00:00:00.000,2025-04-16 10:22:25.379
false,false,394,367,27,813,00:00:30.000,2025-04-16 10:22:38.902
false,false,411,384,27,1344,00:00:30.000,2025-04-16 10:22:47.414
false,false,472,441,31,468,00:00:31.000,2025-04-16 10:23:29.976
false,false,499,466,33,531,00:00:31.000,2025-04-16 10:23:49.504
false,false,519,486,33,92,00:00:30.000,2025-04-16 10:24:05.530
false,false,527,494,33,161,00:00:32.000,2025-04-16 10:24:12.539
false,false,529,496,33,225,00:00:33.000,2025-04-16 10:24:13.541
false,false,1137,1070,67,697,00:00:31.000,2025-04-15 09:20:49.213
false,true,1139,1072,67,0,00:00:00.000,2025-04-15 09:20:52.218
false,true,1194,1120,74,0,00:00:00.000,2025-04-15 09:22:01.279
false,false,1234,1159,75,1274,00:00:30.000,2025-04-15 09:22:44.317
false,false,1243,1168,75,1558,00:00:30.000,2025-04-15 09:22:53.327
false,false,1254,1177,77,222,00:00:33.000,2025-04-15 09:23:10.345
false,false,1271,1193,78,252,00:00:31.000,2025-04-15 09:23:33.371
false,false,1302,1220,82,1233,00:00:33.000,2025-04-15 09:24:04.403
false,false,1324,1242,82,541,00:00:32.000,2025-04-15 09:24:32.434
false,true,1352,1268,84,0,00:00:00.000,2025-04-15 09:25:06.476
false,false,1359,1275,84,156,00:00:33.000,2025-04-15 09:25:19.488
false,true,1115,1049,66,0,00:00:00.000,2025-04-15 09:20:26.192
false,false,1118,1052,66,97,00:00:32.000,2025-04-15 09:20:30.196
false,false,1127,1060,67,384,00:00:33.000,2025-04-15 09:20:39.205
false,false,1395,1308,87,432,00:00:33.000,2025-04-15 09:26:01.535
false,false,1417,1330,87,1127,00:00:30.000,2025-04-15 09:26:23.562
false,false,1425,1338,87,1378,00:00:30.000,2025-04-15 09:26:31.571
false,false,1436,1349,87,311,00:00:33.000,2025-04-15 09:26:48.588
false,false,1447,1359,88,657,00:00:32.000,2025-04-15 09:26:59.598
false,true,1452,1364,88,0,00:00:00.000,2025-04-15 09:27:07.603
false,false,1459,1370,89,222,00:00:30.000,2025-04-15 09:27:17.614
false,false,1473,1383,90,313,00:00:33.000,2025-04-15 09:27:37.637
false,true,1475,1385,90,0,00:00:00.000,2025-04-15 09:27:43.642
false,true,1475,1385,90,0,00:00:00.000,2025-04-15 09:27:44.643
false,false,1478,1388,90,97,00:00:33.000,2025-04-15 09:27:48.646
false,true,1494,1402,92,0,00:00:00.000,2025-04-15 09:28:06.660
false,true,1494,1402,92,0,00:00:00.000,2025-04-15 09:28:10.665
false,false,1495,1403,92,30,00:00:30.000,2025-04-15 09:28:11.666
false,false,1512,1418,94,126,00:00:33.000,2025-04-15 09:28:34.691
false,false,1562,1464,98,63,00:00:33.000,2025-04-15 09:29:36.759
false,true,1593,1491,102,0,00:00:00.000,2025-04-15 09:30:16.797
false,false,1594,1492,102,32,00:00:32.000,2025-04-15 09:30:20.801
false,false,1709,1601,108,3113,00:00:32.000,2025-04-15 09:32:27.919
false,false,1718,1610,108,3397,00:00:33.000,2025-04-15 09:32:36.929
false,false,1721,1612,109,3491,00:00:33.000,2025-04-15 09:32:39.932
false,false,1726,1617,109,3651,00:00:31.000,2025-04-15 09:32:44.936
false,true,1769,1658,111,0,00:00:00.000,2025-04-15 09:33:48.008
false,true,1777,1666,111,0,00:00:00.000,2025-04-15 09:34:02.022
false,false,1612,1510,102,62,00:00:30.000,2025-04-15 09:30:50.829
false,false,1623,1521,102,407,00:00:32.000,2025-04-15 09:31:01.838
false,false,1639,1536,103,906,00:00:30.000,2025-04-15 09:31:17.855
false,false,1676,1571,105,2075,00:00:33.000,2025-04-15 09:31:54.890
false,false,1692,1584,108,2580,00:00:30.000,2025-04-15 09:32:10.905
false,false,1696,1588,108,2704,00:00:30.000,2025-04-15 09:32:14.909
false,false,1702,1594,108,2891,00:00:33.000,2025-04-15 09:32:20.915
false,false,1779,1668,111,63,00:00:31.000,2025-04-15 09:34:08.026
false,false,1782,1671,111,159,00:00:32.000,2025-04-15 09:34:11.031
false,false,1786,1674,112,285,00:00:31.000,2025-04-15 09:34:15.035
false,true,1811,1698,113,0,00:00:00.000,2025-04-15 09:34:56.081
false,true,1823,1710,113,0,00:00:00.000,2025-04-15 09:35:12.100
false,false,1825,1712,113,62,00:00:32.000,2025-04-15 09:35:18.103
false,false,1830,1717,113,126,00:00:31.000,2025-04-15 09:35:29.115
false,false,1841,1727,114,338,00:00:33.000,2025-04-15 09:35:46.133
false,false,1857,1743,114,466,00:00:30.000,2025-04-15 09:36:08.159
false,false,1860,1746,114,561,00:00:31.000,2025-04-15 09:36:11.163
false,false,1868,1753,115,815,00:00:32.000,2025-04-15 09:36:19.170
false,false,1875,1760,115,1033,00:00:31.000,2025-04-15 09:36:26.178
false,true,1881,1766,115,0,00:00:00.000,2025-04-15 09:36:34.186
false,true,1881,1766,115,0,00:00:00.000,2025-04-15 09:36:42.197
false,false,1885,1769,116,125,00:00:33.000,2025-04-15 09:36:48.204
false,false,1887,1771,116,188,00:00:32.000,2025-04-15 09:36:50.207
false,false,1908,1792,116,523,00:00:32.000,2025-04-15 09:37:17.233
false,true,1916,1799,117,0,00:00:00.000,2025-04-15 09:37:33.252
false,true,1929,1812,117,0,00:00:00.000,2025-04-15 09:37:54.274
false,false,1931,1814,117,61,00:00:30.000,2025-04-15 09:37:58.279
false,false,1958,1840,118,219,00:00:31.000,2025-04-15 09:38:37.323
false,true,1971,1852,119,0,00:00:00.000,2025-04-15 09:38:55.343
false,false,2043,1917,126,245,00:00:30.000,2025-04-15 09:40:44.449
false,false,2068,1942,126,1034,00:00:32.000,2025-04-15 09:41:09.473
false,true,2068,1942,126,0,00:00:00.000,2025-04-15 09:41:14.477
false,false,2133,2004,129,1317,00:00:31.000,2025-04-15 09:42:26.554
false,false,2135,2006,129,1380,00:00:30.000,2025-04-15 09:42:28.555
false,false,2145,2015,130,1695,00:00:33.000,2025-04-15 09:42:38.568
false,false,2149,2018,131,1820,00:00:33.000,2025-04-15 09:42:42.572
false,false,2168,2036,132,2421,00:00:31.000,2025-04-15 09:43:01.589
false,false,2181,2048,133,2837,00:00:33.000,2025-04-15 09:43:14.600
false,false,2189,2055,134,3090,00:00:32.000,2025-04-15 09:43:22.609
false,false,2213,2077,136,3852,00:00:33.000,2025-04-15 09:43:46.638
false,false,2217,2080,137,3978,00:00:33.000,2025-04-15 09:43:50.642
false,false,1559,1466,93,1617,00:00:33.000,2025-04-14 11:37:15.023
false,false,1582,1487,95,2346,00:00:30.000,2025-04-14 11:38:01.058
false,false,1589,1494,95,63,00:00:32.000,2025-04-14 11:38:27.071
false,false,1288,1215,73,466,00:00:31.000,2025-04-14 11:25:24.497
false,false,1294,1221,73,97,00:00:32.000,2025-04-14 11:25:48.513
false,false,1330,1254,76,1228,00:00:31.000,2025-04-14 11:27:00.563
false,false,1338,1261,77,1485,00:00:33.000,2025-04-14 11:27:16.574
false,false,1357,1278,79,2077,00:00:30.000,2025-04-14 11:27:54.610
false,true,1438,1353,85,0,00:00:00.000,2025-04-14 11:32:02.787
false,false,1442,1357,85,33,00:00:33.000,2025-04-14 11:32:32.809
false,false,1446,1361,85,160,00:00:32.000,2025-04-14 11:32:40.817
false,false,1459,1374,85,567,00:00:31.000,2025-04-14 11:33:06.834
false,false,1501,1414,87,471,00:00:33.000,2025-04-14 11:35:06.921
false,false,1387,1305,82,382,00:00:30.000,2025-04-14 11:29:30.678
false,false,1398,1316,82,251,00:00:30.000,2025-04-14 11:30:04.705
false,false,1414,1331,83,444,00:00:32.000,2025-04-14 11:30:48.743
false,false,1422,1338,84,695,00:00:33.000,2025-04-14 11:31:04.750
false,false,1432,1347,85,124,00:00:30.000,2025-04-14 11:31:36.771
false,false,466,435,31,278,00:00:32.000,2025-04-16 10:23:26.971
false,false,420,391,29,1631,00:00:33.000,2025-04-16 10:22:51.918
false,false,434,403,31,2074,00:00:31.000,2025-04-16 10:22:58.929
false,false,267,249,18,606,00:00:30.000,2025-04-16 10:21:17.282
false,false,270,252,18,699,00:00:30.000,2025-04-16 10:21:18.784
false,false,277,259,18,125,00:00:30.000,2025-04-16 10:21:25.288
false,false,298,279,19,30,00:00:30.000,2025-04-16 10:21:41.811
false,true,310,289,21,0,00:00:00.000,2025-04-16 10:21:48.320
false,true,310,289,21,0,00:00:00.000,2025-04-16 10:21:53.328
false,true,235,218,17,0,00:00:00.000,2025-04-16 10:20:54.250
false,false,239,222,17,124,00:00:32.000,2025-04-16 10:20:57.254
false,false,326,303,23,498,00:00:33.000,2025-04-16 10:22:01.841
false,false,331,308,23,658,00:00:32.000,2025-04-16 10:22:04.345
false,false,350,325,25,1262,00:00:32.000,2025-04-16 10:22:13.863
false,false,398,371,27,936,00:00:30.000,2025-04-16 10:22:40.904
false,false,402,375,27,1064,00:00:33.000,2025-04-16 10:22:42.907
false,false,410,383,27,1314,00:00:33.000,2025-04-16 10:22:46.914
false,false,482,450,32,785,00:00:30.000,2025-04-16 10:23:34.983
false,true,482,450,32,0,00:00:00.000,2025-04-16 10:23:37.989
false,false,498,465,33,500,00:00:30.000,2025-04-16 10:23:49.003
false,false,500,467,33,564,00:00:33.000,2025-04-16 10:23:50.005
false,true,501,468,33,0,00:00:00.000,2025-04-16 10:23:52.007
false,true,501,468,33,0,00:00:00.000,2025-04-16 10:23:52.507
false,false,526,493,33,129,00:00:33.000,2025-04-16 10:24:12.039
false,false,1174,1105,69,1112,00:00:33.000,2025-04-15 09:21:32.252
false,false,1182,1112,70,1360,00:00:30.000,2025-04-15 09:21:40.259
false,false,1187,1116,71,33,00:00:33.000,2025-04-15 09:21:51.269
false,false,1189,1117,72,96,00:00:30.000,2025-04-15 09:21:53.272
false,false,1220,1146,74,829,00:00:32.000,2025-04-15 09:22:30.304
false,false,1221,1147,74,861,00:00:32.000,2025-04-15 09:22:31.304
false,false,1223,1149,74,926,00:00:32.000,2025-04-15 09:22:33.307
false,false,1230,1156,74,1151,00:00:33.000,2025-04-15 09:22:40.312
false,true,1263,1186,77,0,00:00:00.000,2025-04-15 09:23:21.356
false,false,1290,1209,81,855,00:00:31.000,2025-04-15 09:23:52.391
false,false,1303,1221,82,1265,00:00:32.000,2025-04-15 09:24:05.404
false,false,1316,1234,82,285,00:00:31.000,2025-04-15 09:24:24.423
false,false,1337,1254,83,944,00:00:30.000,2025-04-15 09:24:45.452
false,false,1345,1261,84,1191,00:00:30.000,2025-04-15 09:24:53.460
false,true,1354,1270,84,0,00:00:00.000,2025-04-15 09:25:11.481
false,true,1354,1270,84,0,00:00:00.000,2025-04-15 09:25:12.481
false,true,1354,1270,84,0,00:00:00.000,2025-04-15 09:25:13.482
false,true,1115,1049,66,0,00:00:00.000,2025-04-15 09:20:25.191
false,true,1452,1364,88,0,00:00:00.000,2025-04-15 09:27:08.605
false,false,1453,1365,88,33,00:00:33.000,2025-04-15 09:27:11.607
false,true,1463,1374,89,0,00:00:00.000,2025-04-15 09:27:22.620
false,false,1465,1375,90,62,00:00:30.000,2025-04-15 09:27:29.628
false,false,1466,1376,90,95,00:00:33.000,2025-04-15 09:27:30.629
false,false,1477,1387,90,64,00:00:33.000,2025-04-15 09:27:47.644
false,true,1508,1414,94,0,00:00:00.000,2025-04-15 09:28:25.680
false,false,1510,1416,94,62,00:00:31.000,2025-04-15 09:28:32.689
false,false,1531,1435,96,724,00:00:30.000,2025-04-15 09:28:53.709
false,true,1560,1462,98,0,00:00:00.000,2025-04-15 09:29:32.758
false,true,1608,1506,102,0,00:00:00.000,2025-04-15 09:30:39.821
false,false,1713,1605,108,3240,00:00:32.000,2025-04-15 09:32:31.924
false,false,1722,1613,109,3524,00:00:33.000,2025-04-15 09:32:40.932
false,false,1723,1614,109,3557,00:00:33.000,2025-04-15 09:32:41.934
false,false,1747,1638,109,96,00:00:32.000,2025-04-15 09:33:11.964
false,true,1753,1643,110,0,00:00:00.000,2025-04-15 09:33:21.978
false,true,1753,1643,110,0,00:00:00.000,2025-04-15 09:33:22.980
false,false,1649,1546,103,1222,00:00:31.000,2025-04-15 09:31:27.863
false,false,1662,1559,103,1632,00:00:30.000,2025-04-15 09:31:40.877
false,false,1697,1589,108,2734,00:00:30.000,2025-04-15 09:32:15.910
false,true,1786,1674,112,0,00:00:00.000,2025-04-15 09:34:19.040
false,false,1801,1688,113,246,00:00:30.000,2025-04-15 09:34:42.064
false,true,1811,1698,113,0,00:00:00.000,2025-04-15 09:34:54.079
false,false,1816,1703,113,161,00:00:33.000,2025-04-15 09:35:03.089
false,false,1834,1721,113,121,00:00:30.000,2025-04-15 09:35:39.126
false,false,1835,1722,113,151,00:00:30.000,2025-04-15 09:35:40.127
false,false,1864,1750,114,690,00:00:33.000,2025-04-15 09:36:15.165
false,true,1881,1766,115,0,00:00:00.000,2025-04-15 09:36:39.191
false,true,1881,1766,115,0,00:00:00.000,2025-04-15 09:36:40.193
false,false,1891,1775,116,315,00:00:33.000,2025-04-15 09:36:54.212
false,true,1891,1775,116,0,00:00:00.000,2025-04-15 09:36:55.214
false,true,1891,1775,116,0,00:00:00.000,2025-04-15 09:36:58.214
false,false,1893,1777,116,61,00:00:31.000,2025-04-15 09:37:02.218
false,false,1894,1778,116,91,00:00:30.000,2025-04-15 09:37:03.219
false,false,1895,1779,116,122,00:00:31.000,2025-04-15 09:37:04.220
false,false,1904,1788,116,398,00:00:31.000,2025-04-15 09:37:13.230
false,true,1916,1799,117,0,00:00:00.000,2025-04-15 09:37:35.253
false,false,1917,1800,117,31,00:00:31.000,2025-04-15 09:37:38.258
false,true,1929,1812,117,0,00:00:00.000,2025-04-15 09:37:53.273
false,false,1930,1813,117,31,00:00:31.000,2025-04-15 09:37:57.277
false,true,1931,1814,117,0,00:00:00.000,2025-04-15 09:38:02.283
false,false,1943,1825,118,382,00:00:31.000,2025-04-15 09:38:16.298
false,false,1946,1828,118,474,00:00:30.000,2025-04-15 09:38:19.301
false,true,1971,1852,119,0,00:00:00.000,2025-04-15 09:38:54.341
false,false,1974,1855,119,96,00:00:32.000,2025-04-15 09:38:59.348
false,false,2042,1916,126,215,00:00:30.000,2025-04-15 09:40:43.449
false,true,2068,1942,126,0,00:00:00.000,2025-04-15 09:41:13.475
false,false,2073,1946,127,161,00:00:32.000,2025-04-15 09:41:20.481
false,false,2078,1951,127,318,00:00:32.000,2025-04-15 09:41:25.487
false,false,2092,1965,127,30,00:00:30.000,2025-04-15 09:41:45.510
false,false,2101,1974,127,307,00:00:32.000,2025-04-15 09:41:54.520
false,false,2153,2022,131,1950,00:00:33.000,2025-04-15 09:42:46.577
false,false,2166,2034,132,2360,00:00:33.000,2025-04-15 09:42:59.587
false,false,2182,2049,133,2869,00:00:32.000,2025-04-15 09:43:15.601
false,false,2187,2054,133,3027,00:00:32.000,2025-04-15 09:43:20.606
false,false,2193,2059,134,3217,00:00:33.000,2025-04-15 09:43:26.616
false,false,1565,1472,93,1810,00:00:31.000,2025-04-14 11:37:27.033
false,false,1304,1231,73,413,00:00:33.000,2025-04-14 11:26:08.525
false,false,1458,1373,85,536,00:00:33.000,2025-04-14 11:33:04.832
false,false,1463,1378,85,696,00:00:33.000,2025-04-14 11:33:14.837
false,true,1473,1387,86,0,00:00:00.000,2025-04-14 11:33:38.854
false,true,1474,1388,86,0,00:00:00.000,2025-04-14 11:33:50.864
false,true,1474,1388,86,0,00:00:00.000,2025-04-14 11:33:56.870
false,false,1494,1407,87,249,00:00:30.000,2025-04-14 11:34:52.910
false,false,1497,1410,87,345,00:00:33.000,2025-04-14 11:34:58.914
false,false,1378,1298,80,95,00:00:32.000,2025-04-14 11:29:12.662
false,true,1400,1318,82,0,00:00:00.000,2025-04-14 11:30:20.719
false,false,1419,1336,83,600,00:00:32.000,2025-04-14 11:30:58.748
false,true,1436,1351,85,0,00:00:00.000,2025-04-14 11:31:46.777
false,true,457,426,31,0,00:00:00.000,2025-04-16 10:23:19.459
false,false,432,401,31,2012,00:00:33.000,2025-04-16 10:22:57.927
false,false,275,257,18,64,00:00:32.000,2025-04-16 10:21:24.287
false,true,282,264,18,0,00:00:00.000,2025-04-16 10:21:30.294
false,false,288,270,18,190,00:00:30.000,2025-04-16 10:21:33.798
false,false,289,270,19,222,00:00:32.000,2025-04-16 10:21:34.298
false,false,318,296,22,247,00:00:31.000,2025-04-16 10:21:57.837
false,true,235,218,17,0,00:00:00.000,2025-04-16 10:20:53.250
false,true,248,231,17,0,00:00:00.000,2025-04-16 10:21:05.768
false,true,248,231,17,0,00:00:00.000,2025-04-16 10:21:06.769
false,false,361,335,26,1607,00:00:31.000,2025-04-16 10:22:19.370
false,false,376,350,26,251,00:00:31.000,2025-04-16 10:22:29.887
false,false,378,352,26,313,00:00:31.000,2025-04-16 10:22:30.889
false,false,383,357,26,468,00:00:30.000,2025-04-16 10:22:33.393
false,false,391,364,27,719,00:00:32.000,2025-04-16 10:22:37.400
false,false,395,368,27,843,00:00:30.000,2025-04-16 10:22:39.403
false,false,469,438,31,374,00:00:31.000,2025-04-16 10:23:28.473
false,false,473,442,31,501,00:00:33.000,2025-04-16 10:23:30.478
false,false,480,448,32,723,00:00:33.000,2025-04-16 10:23:33.982
false,true,482,450,32,0,00:00:00.000,2025-04-16 10:23:36.986
false,true,482,450,32,0,00:00:00.000,2025-04-16 10:23:38.989
false,false,484,452,32,61,00:00:30.000,2025-04-16 10:23:41.994
false,false,511,478,33,314,00:00:32.000,2025-04-16 10:23:58.515
false,false,518,485,33,62,00:00:32.000,2025-04-16 10:24:05.028
false,false,521,488,33,155,00:00:32.000,2025-04-16 10:24:06.531
false,true,522,489,33,0,00:00:00.000,2025-04-16 10:24:09.536
false,true,1139,1072,67,0,00:00:00.000,2025-04-15 09:20:56.221
false,false,1148,1081,67,293,00:00:33.000,2025-04-15 09:21:06.228
false,false,1154,1087,67,481,00:00:30.000,2025-04-15 09:21:12.232
false,false,1155,1088,67,511,00:00:30.000,2025-04-15 09:21:13.233
false,false,1173,1104,69,1079,00:00:32.000,2025-04-15 09:21:31.252
false,false,1188,1116,72,66,00:00:33.000,2025-04-15 09:21:52.271
false,false,1217,1143,74,732,00:00:30.000,2025-04-15 09:22:27.301
false,false,1235,1160,75,1305,00:00:31.000,2025-04-15 09:22:45.318
false,false,1241,1166,75,1497,00:00:33.000,2025-04-15 09:22:51.325
false,false,1267,1190,77,124,00:00:30.000,2025-04-15 09:23:29.365
false,false,1273,1194,79,315,00:00:33.000,2025-04-15 09:23:35.373
false,false,1275,1196,79,378,00:00:32.000,2025-04-15 09:23:37.376
false,false,1286,1206,80,726,00:00:33.000,2025-04-15 09:23:48.385
false,false,1296,1214,82,1043,00:00:30.000,2025-04-15 09:23:58.398
false,true,1307,1225,82,0,00:00:00.000,2025-04-15 09:24:10.410
false,false,1308,1226,82,30,00:00:30.000,2025-04-15 09:24:16.415
false,false,1344,1260,84,1161,00:00:32.000,2025-04-15 09:24:52.458
false,false,1350,1266,84,1346,00:00:30.000,2025-04-15 09:24:58.467
false,false,1356,1272,84,62,00:00:32.000,2025-04-15 09:25:16.484
false,false,1357,1273,84,93,00:00:31.000,2025-04-15 09:25:17.486
false,false,1358,1274,84,123,00:00:30.000,2025-04-15 09:25:18.486
false,false,1374,1290,84,630,00:00:31.000,2025-04-15 09:25:34.505
false,false,1375,1291,84,663,00:00:33.000,2025-04-15 09:25:35.507
false,false,1386,1301,85,154,00:00:31.000,2025-04-15 09:25:52.526
false,false,1391,1305,86,306,00:00:30.000,2025-04-15 09:25:57.531
false,false,1392,1306,86,336,00:00:30.000,2025-04-15 09:25:58.531
false,false,1406,1319,87,783,00:00:33.000,2025-04-15 09:26:12.549
false,false,1407,1320,87,813,00:00:30.000,2025-04-15 09:26:13.551
false,true,1426,1339,87,0,00:00:00.000,2025-04-15 09:26:34.575
false,false,1427,1340,87,31,00:00:31.000,2025-04-15 09:26:39.578
false,false,1442,1355,87,501,00:00:30.000,2025-04-15 09:26:54.595
false,false,1450,1362,88,751,00:00:31.000,2025-04-15 09:27:02.600
false,false,1463,1374,89,347,00:00:30.000,2025-04-15 09:27:21.619
false,false,1475,1385,90,376,00:00:31.000,2025-04-15 09:27:39.638
false,true,1475,1385,90,0,00:00:00.000,2025-04-15 09:27:42.640
false,false,1487,1395,92,379,00:00:30.000,2025-04-15 09:27:57.653
false,true,1494,1402,92,0,00:00:00.000,2025-04-15 09:28:08.662
false,true,1494,1402,92,0,00:00:00.000,2025-04-15 09:28:09.662
false,false,1529,1433,96,662,00:00:33.000,2025-04-15 09:28:51.707
false,false,1545,1448,97,1166,00:00:33.000,2025-04-15 09:29:07.723
false,false,1552,1455,97,185,00:00:30.000,2025-04-15 09:29:20.741
false,false,1558,1460,98,374,00:00:32.000,2025-04-15 09:29:26.750
false,true,1560,1462,98,0,00:00:00.000,2025-04-15 09:29:29.753
false,false,1587,1485,102,63,00:00:33.000,2025-04-15 09:30:07.788
false,false,1593,1491,102,246,00:00:31.000,2025-04-15 09:30:13.794
false,false,1605,1503,102,379,00:00:30.000,2025-04-15 09:30:31.814
false,true,1608,1506,102,0,00:00:00.000,2025-04-15 09:30:36.818
false,false,1711,1603,108,3176,00:00:33.000,2025-04-15 09:32:29.922
false,false,1742,1633,109,4146,00:00:32.000,2025-04-15 09:33:00.951
false,false,1761,1651,110,259,00:00:33.000,2025-04-15 09:33:31.989
false,false,1766,1655,111,127,00:00:32.000,2025-04-15 09:33:43.003
false,false,1773,1662,111,125,00:00:31.000,2025-04-15 09:33:56.017
false,true,1610,1508,102,0,00:00:00.000,2025-04-15 09:30:48.827
false,false,1654,1551,103,1380,00:00:30.000,2025-04-15 09:31:32.868
false,false,1666,1561,105,1757,00:00:30.000,2025-04-15 09:31:44.881
false,false,1672,1567,105,1948,00:00:31.000,2025-04-15 09:31:50.887
false,false,1685,1578,107,2360,00:00:31.000,2025-04-15 09:32:03.897
false,false,1690,1582,108,2519,00:00:30.000,2025-04-15 09:32:08.901
false,false,1793,1681,112,221,00:00:32.000,2025-04-15 09:34:28.050
false,true,1793,1681,112,0,00:00:00.000,2025-04-15 09:34:31.054
false,false,1815,1702,113,128,00:00:32.000,2025-04-15 09:35:02.088
false,false,1820,1707,113,286,00:00:32.000,2025-04-15 09:35:07.094
false,true,1823,1710,113,0,00:00:00.000,2025-04-15 09:35:16.101
false,false,1843,1729,114,32,00:00:32.000,2025-04-15 09:35:54.142
false,false,1846,1732,114,126,00:00:30.000,2025-04-15 09:35:57.145
false,false,1877,1762,115,1093,00:00:30.000,2025-04-15 09:36:28.180
false,false,1884,1769,115,92,00:00:31.000,2025-04-15 09:36:47.203
false,false,1898,1782,116,213,00:00:30.000,2025-04-15 09:37:07.223
false,false,1901,1785,116,307,00:00:30.000,2025-04-15 09:37:10.227
false,false,1922,1805,117,190,00:00:33.000,2025-04-15 09:37:43.263
false,true,1929,1812,117,0,00:00:00.000,2025-04-15 09:37:55.274
false,false,1932,1815,117,31,00:00:31.000,2025-04-15 09:38:05.285
false,false,1935,1818,117,127,00:00:32.000,2025-04-15 09:38:08.288
false,true,1951,1833,118,0,00:00:00.000,2025-04-15 09:38:30.311
false,false,1954,1836,118,94,00:00:33.000,2025-04-15 09:38:33.318
false,false,1961,1843,118,316,00:00:33.000,2025-04-15 09:38:40.326
false,false,1965,1847,118,443,00:00:30.000,2025-04-15 09:38:44.332
false,false,2047,1921,126,373,00:00:32.000,2025-04-15 09:40:48.453
false,false,2056,1930,126,659,00:00:32.000,2025-04-15 09:40:57.459
false,false,2061,1935,126,817,00:00:32.000,2025-04-15 09:41:02.465
false,false,2064,1938,126,910,00:00:30.000,2025-04-15 09:41:05.469
false,false,2072,1946,126,129,00:00:33.000,2025-04-15 09:41:19.481
false,false,2085,1958,127,540,00:00:30.000,2025-04-15 09:41:32.496
false,true,2091,1964,127,0,00:00:00.000,2025-04-15 09:41:40.505
false,false,2112,1985,127,654,00:00:32.000,2025-04-15 09:42:05.531
false,false,2139,2009,130,1506,00:00:31.000,2025-04-15 09:42:32.560
false,false,2142,2012,130,1598,00:00:30.000,2025-04-15 09:42:35.564
false,false,2146,2016,130,1725,00:00:30.000,2025-04-15 09:42:39.568
false,false,2180,2047,133,2804,00:00:33.000,2025-04-15 09:43:13.598
false,false,2200,2065,135,3441,00:00:33.000,2025-04-15 09:43:33.623
false,false,2221,2083,138,4107,00:00:32.000,2025-04-15 09:43:54.648
false,false,2223,2084,139,4169,00:00:31.000,2025-04-15 09:43:56.650
false,false,1560,1467,93,1650,00:00:33.000,2025-04-14 11:37:17.024
false,false,1583,1488,95,2376,00:00:30.000,2025-04-14 11:38:03.059
false,true,1291,1218,73,0,00:00:00.000,2025-04-14 11:25:34.502
false,true,1291,1218,73,0,00:00:00.000,2025-04-14 11:25:42.510
false,false,1299,1226,73,258,00:00:32.000,2025-04-14 11:25:58.518
false,false,1301,1228,73,319,00:00:31.000,2025-04-14 11:26:02.521
false,false,1317,1242,75,824,00:00:32.000,2025-04-14 11:26:34.545
false,false,1332,1256,76,1291,00:00:33.000,2025-04-14 11:27:04.565
false,false,1366,1287,79,63,00:00:30.000,2025-04-14 11:28:24.632
false,false,1437,1352,85,30,00:00:30.000,2025-04-14 11:31:58.784
false,false,1440,1355,85,64,00:00:32.000,2025-04-14 11:32:16.794
false,true,1441,1356,85,0,00:00:00.000,2025-04-14 11:32:22.800
false,true,1441,1356,85,0,00:00:00.000,2025-04-14 11:32:24.803
false,false,1447,1362,85,191,00:00:31.000,2025-04-14 11:32:42.818
false,false,1476,1389,87,64,00:00:33.000,2025-04-14 11:34:04.876
false,false,1482,1395,87,258,00:00:32.000,2025-04-14 11:34:16.883
false,false,1495,1408,87,279,00:00:30.000,2025-04-14 11:34:54.911
false,true,1370,1290,80,0,00:00:00.000,2025-04-14 11:28:38.640
false,true,1390,1308,82,0,00:00:00.000,2025-04-14 11:29:40.683
false,true,1390,1308,82,0,00:00:00.000,2025-04-14 11:29:48.691
false,false,1404,1322,82,128,00:00:33.000,2025-04-14 11:30:28.725
false,false,1431,1346,85,94,00:00:31.000,2025-04-14 11:31:34.771
false,false,464,433,31,214,00:00:30.000,2025-04-16 10:23:25.970
false,false,425,394,31,1788,00:00:33.000,2025-04-16 10:22:54.422
false,false,266,248,18,576,00:00:32.000,2025-04-16 10:21:16.781
false,false,278,260,18,157,00:00:32.000,2025-04-16 10:21:25.789
false,false,282,264,18,282,00:00:31.000,2025-04-16 10:21:27.792
false,false,285,267,18,98,00:00:33.000,2025-04-16 10:21:32.297
false,true,297,278,19,0,00:00:00.000,2025-04-16 10:21:39.306
false,false,302,283,19,157,00:00:33.000,2025-04-16 10:21:43.814
false,false,236,219,17,31,00:00:31.000,2025-04-16 10:20:55.752
false,false,246,229,17,63,00:00:33.000,2025-04-16 10:21:03.765
false,false,248,231,17,124,00:00:31.000,2025-04-16 10:21:04.767
false,false,330,307,23,626,00:00:32.000,2025-04-16 10:22:03.845
false,false,341,317,24,976,00:00:30.000,2025-04-16 10:22:09.355
false,false,360,334,26,1576,00:00:33.000,2025-04-16 10:22:18.869
false,false,385,359,26,530,00:00:32.000,2025-04-16 10:22:34.394
false,false,387,360,27,594,00:00:32.000,2025-04-16 10:22:35.396
false,false,390,363,27,687,00:00:33.000,2025-04-16 10:22:36.899
false,false,399,372,27,966,00:00:30.000,2025-04-16 10:22:41.405
false,false,405,378,27,1161,00:00:32.000,2025-04-16 10:22:44.409
false,false,470,439,31,404,00:00:30.000,2025-04-16 10:23:28.974
false,false,478,446,32,657,00:00:31.000,2025-04-16 10:23:32.982
false,false,497,464,33,470,00:00:33.000,2025-04-16 10:23:48.502
false,false,531,497,34,285,00:00:30.000,2025-04-16 10:24:14.542
false,true,1139,1072,67,0,00:00:00.000,2025-04-15 09:20:54.219
false,false,1157,1090,67,576,00:00:32.000,2025-04-15 09:21:15.237
false,false,1165,1097,68,824,00:00:30.000,2025-04-15 09:21:23.245
false,false,1176,1106,70,1175,00:00:32.000,2025-04-15 09:21:34.253
false,true,1186,1115,71,0,00:00:00.000,2025-04-15 09:21:47.264
false,false,1207,1133,74,416,00:00:30.000,2025-04-15 09:22:17.293
false,false,1216,1142,74,702,00:00:32.000,2025-04-15 09:22:26.299
false,false,1229,1155,74,1118,00:00:33.000,2025-04-15 09:22:39.311
false,false,1246,1170,76,1651,00:00:31.000,2025-04-15 09:22:56.329
false,false,1281,1202,79,567,00:00:33.000,2025-04-15 09:23:43.379
false,false,1304,1222,82,1295,00:00:30.000,2025-04-15 09:24:06.406
false,false,1311,1229,82,126,00:00:32.000,2025-04-15 09:24:19.419
false,false,1312,1230,82,158,00:00:32.000,2025-04-15 09:24:20.420
false,false,1325,1243,82,573,00:00:32.000,2025-04-15 09:24:33.436
false,false,1326,1244,82,605,00:00:32.000,2025-04-15 09:24:34.438
false,false,1351,1267,84,1379,00:00:33.000,2025-04-15 09:24:59.469
false,false,1372,1288,84,568,00:00:31.000,2025-04-15 09:25:32.502
false,false,1126,1059,67,351,00:00:32.000,2025-04-15 09:20:38.205
false,false,1397,1310,87,493,00:00:30.000,2025-04-15 09:26:03.536
false,false,1420,1333,87,1221,00:00:30.000,2025-04-15 09:26:26.565
false,false,1423,1336,87,1316,00:00:31.000,2025-04-15 09:26:29.570
false,false,1437,1350,87,343,00:00:32.000,2025-04-15 09:26:49.589
false,true,1463,1374,89,0,00:00:00.000,2025-04-15 09:27:27.626
false,false,1468,1378,90,157,00:00:30.000,2025-04-15 09:27:32.630
false,false,1505,1411,94,348,00:00:30.000,2025-04-15 09:28:21.675
false,false,1507,1413,94,410,00:00:30.000,2025-04-15 09:28:23.678
false,false,1521,1427,94,407,00:00:32.000,2025-04-15 09:28:43.699
false,false,1524,1428,96,502,00:00:31.000,2025-04-15 09:28:46.703
false,false,1536,1439,97,879,00:00:31.000,2025-04-15 09:28:58.713
false,false,1542,1445,97,1069,00:00:32.000,2025-04-15 09:29:04.720
false,true,1560,1462,98,0,00:00:00.000,2025-04-15 09:29:33.759
false,false,1570,1471,99,316,00:00:30.000,2025-04-15 09:29:44.767
false,true,1585,1483,102,0,00:00:00.000,2025-04-15 09:30:02.783
false,false,1603,1501,102,318,00:00:31.000,2025-04-15 09:30:29.812
false,false,1704,1596,108,2956,00:00:32.000,2025-04-15 09:32:22.917
false,false,1745,1636,109,33,00:00:33.000,2025-04-15 09:33:09.960
false,true,1753,1643,110,0,00:00:00.000,2025-04-15 09:33:18.972
false,false,1754,1644,110,32,00:00:32.000,2025-04-15 09:33:24.983
false,false,1764,1653,111,64,00:00:31.000,2025-04-15 09:33:41.001
false,false,1765,1654,111,95,00:00:31.000,2025-04-15 09:33:42.001
false,true,1769,1658,111,0,00:00:00.000,2025-04-15 09:33:52.014
false,false,1777,1666,111,252,00:00:30.000,2025-04-15 09:34:00.018
false,false,1613,1511,102,94,00:00:32.000,2025-04-15 09:30:51.830
false,false,1637,1534,103,845,00:00:30.000,2025-04-15 09:31:15.854
false,false,1638,1535,103,876,00:00:31.000,2025-04-15 09:31:16.855
false,false,1650,1547,103,1255,00:00:33.000,2025-04-15 09:31:28.865
false,false,1651,1548,103,1286,00:00:31.000,2025-04-15 09:31:29.866
false,false,1656,1553,103,1444,00:00:31.000,2025-04-15 09:31:34.871
false,false,1667,1562,105,1789,00:00:32.000,2025-04-15 09:31:45.881
false,false,1670,1565,105,1884,00:00:31.000,2025-04-15 09:31:48.883
false,false,1675,1570,105,2042,00:00:31.000,2025-04-15 09:31:53.889
false,false,1683,1577,106,2299,00:00:31.000,2025-04-15 09:32:01.894
false,true,1777,1666,111,0,00:00:00.000,2025-04-15 09:34:05.025
false,true,1786,1674,112,0,00:00:00.000,2025-04-15 09:34:17.037
false,true,1793,1681,112,0,00:00:00.000,2025-04-15 09:34:32.055
false,false,1800,1687,113,216,00:00:30.000,2025-04-15 09:34:41.063
false,false,1803,1690,113,309,00:00:30.000,2025-04-15 09:34:44.065
false,true,1811,1698,113,0,00:00:00.000,2025-04-15 09:34:57.082
false,true,1823,1710,113,0,00:00:00.000,2025-04-15 09:35:15.101
false,false,1824,1711,113,30,00:00:30.000,2025-04-15 09:35:17.101
false,true,1826,1713,113,0,00:00:00.000,2025-04-15 09:35:20.106
false,false,1836,1722,114,182,00:00:31.000,2025-04-15 09:35:41.127
false,false,1849,1735,114,219,00:00:30.000,2025-04-15 09:36:00.147
false,false,1858,1744,114,497,00:00:31.000,2025-04-15 09:36:09.160
false,false,1869,1754,115,846,00:00:31.000,2025-04-15 09:36:20.172
false,true,1881,1766,115,0,00:00:00.000,2025-04-15 09:36:33.186
false,true,1881,1766,115,0,00:00:00.000,2025-04-15 09:36:37.189
false,false,1940,1823,117,286,00:00:33.000,2025-04-15 09:38:13.294
false,false,1942,1824,118,351,00:00:32.000,2025-04-15 09:38:15.296
false,true,1951,1833,118,0,00:00:00.000,2025-04-15 09:38:25.308
false,false,2063,1937,126,880,00:00:31.000,2025-04-15 09:41:04.468
false,false,2099,1972,127,245,00:00:31.000,2025-04-15 09:41:52.517
false,false,2118,1990,128,842,00:00:30.000,2025-04-15 09:42:11.538
false,false,2127,1998,129,1125,00:00:31.000,2025-04-15 09:42:20.549
false,false,2136,2007,129,1411,00:00:31.000,2025-04-15 09:42:29.556
false,false,2137,2007,130,1444,00:00:33.000,2025-04-15 09:42:30.557
false,false,2150,2019,131,1851,00:00:31.000,2025-04-15 09:42:43.573
false,false,2152,2021,131,1917,00:00:33.000,2025-04-15 09:42:45.576
false,false,2161,2029,132,2202,00:00:32.000,2025-04-15 09:42:54.584
false,false,2162,2030,132,2232,00:00:30.000,2025-04-15 09:42:55.584
false,false,2183,2050,133,2900,00:00:31.000,2025-04-15 09:43:16.602
false,false,2192,2058,134,3184,00:00:30.000,2025-04-15 09:43:25.614
false,false,2199,2064,135,3408,00:00:31.000,2025-04-15 09:43:32.621
false,false,2204,2069,135,3567,00:00:33.000,2025-04-15 09:43:37.628
false,false,1562,1469,93,1713,00:00:33.000,2025-04-14 11:37:21.027
false,false,1570,1476,94,1968,00:00:32.000,2025-04-14 11:37:37.041
false,false,1581,1486,95,2316,00:00:31.000,2025-04-14 11:37:59.056
false,true,1587,1492,95,0,00:00:00.000,2025-04-14 11:38:13.061
false,false,1320,1245,75,918,00:00:30.000,2025-04-14 11:26:40.550
false,false,1334,1257,77,1355,00:00:33.000,2025-04-14 11:27:08.569
false,false,1345,1267,78,1706,00:00:31.000,2025-04-14 11:27:30.586
false,false,1363,1284,79,2264,00:00:30.000,2025-04-14 11:28:06.620
false,false,1365,1286,79,33,00:00:33.000,2025-04-14 11:28:22.632
false,false,1441,1356,85,96,00:00:32.000,2025-04-14 11:32:18.796
false,false,1460,1375,85,600,00:00:33.000,2025-04-14 11:33:08.836
false,false,1464,1379,85,726,00:00:30.000,2025-04-14 11:33:16.840
false,false,1471,1385,86,944,00:00:32.000,2025-04-14 11:33:30.849
false,false,1473,1387,86,1008,00:00:32.000,2025-04-14 11:33:34.851
false,true,1473,1387,86,0,00:00:00.000,2025-04-14 11:33:36.853
false,true,1473,1387,86,0,00:00:00.000,2025-04-14 11:33:44.858
false,false,1484,1397,87,319,00:00:31.000,2025-04-14 11:34:20.888
false,true,1486,1399,87,0,00:00:00.000,2025-04-14 11:34:30.897
false,false,1492,1405,87,188,00:00:30.000,2025-04-14 11:34:48.908
false,false,1506,1417,89,626,00:00:31.000,2025-04-14 11:35:16.930
false,false,1376,1296,80,30,00:00:30.000,2025-04-14 11:29:08.660
false,false,1402,1320,82,63,00:00:30.000,2025-04-14 11:30:24.722
false,false,1407,1325,82,224,00:00:31.000,2025-04-14 11:30:34.729
false,false,1420,1336,84,630,00:00:30.000,2025-04-14 11:31:00.749
false,true,1428,1343,85,0,00:00:00.000,2025-04-14 11:31:26.764
false,false,1434,1349,85,185,00:00:31.000,2025-04-14 11:31:40.774
false,true,436,405,31,0,00:00:00.000,2025-04-16 10:23:01.432
false,true,436,405,31,0,00:00:00.000,2025-04-16 10:23:01.933
false,false,254,237,17,190,00:00:33.000,2025-04-16 10:21:10.773
false,true,273,255,18,0,00:00:00.000,2025-04-16 10:21:22.287
false,false,299,280,19,60,00:00:30.000,2025-04-16 10:21:42.312
false,false,300,281,19,92,00:00:32.000,2025-04-16 10:21:42.813
false,false,303,283,20,190,00:00:33.000,2025-04-16 10:21:44.316
false,true,310,289,21,0,00:00:00.000,2025-04-16 10:21:50.823
false,true,310,289,21,0,00:00:00.000,2025-04-16 10:21:52.827
false,true,244,227,17,0,00:00:00.000,2025-04-16 10:21:00.260
false,true,244,227,17,0,00:00:00.000,2025-04-16 10:21:01.762
false,false,328,305,23,561,00:00:33.000,2025-04-16 10:22:02.844
false,false,329,306,23,594,00:00:33.000,2025-04-16 10:22:03.345
false,false,349,324,25,1230,00:00:32.000,2025-04-16 10:22:13.361
false,false,352,327,25,1324,00:00:31.000,2025-04-16 10:22:14.865
false,false,362,336,26,1637,00:00:30.000,2025-04-16 10:22:19.871
false,true,368,342,26,0,00:00:00.000,2025-04-16 10:22:23.877
false,false,373,347,26,160,00:00:32.000,2025-04-16 10:22:28.385
false,false,389,362,27,654,00:00:30.000,2025-04-16 10:22:36.399
false,false,409,382,27,1281,00:00:30.000,2025-04-16 10:22:46.413
false,true,501,468,33,0,00:00:00.000,2025-04-16 10:23:51.006
false,false,506,473,33,153,00:00:30.000,2025-04-16 10:23:56.012
false,false,517,484,33,30,00:00:30.000,2025-04-16 10:24:04.527
false,false,524,491,33,65,00:00:32.000,2025-04-16 10:24:11.037
false,false,1136,1069,67,666,00:00:30.000,2025-04-15 09:20:48.211
false,false,1138,1071,67,729,00:00:32.000,2025-04-15 09:20:50.215
false,false,1172,1104,68,1047,00:00:33.000,2025-04-15 09:21:30.251
false,false,1179,1109,70,1266,00:00:31.000,2025-04-15 09:21:37.256
false,true,1194,1120,74,0,00:00:00.000,2025-04-15 09:22:04.281
false,false,1209,1135,74,481,00:00:33.000,2025-04-15 09:22:19.295
false,false,1253,1176,77,189,00:00:33.000,2025-04-15 09:23:09.344
false,false,1321,1239,82,445,00:00:33.000,2025-04-15 09:24:29.429
false,false,1343,1259,84,1129,00:00:32.000,2025-04-15 09:24:51.458
false,false,1347,1263,84,1252,00:00:30.000,2025-04-15 09:24:55.462
false,true,1352,1268,84,0,00:00:00.000,2025-04-15 09:25:01.470
false,true,1354,1270,84,0,00:00:00.000,2025-04-15 09:25:14.483
false,false,1367,1283,84,412,00:00:31.000,2025-04-15 09:25:27.496
false,false,1119,1053,66,127,00:00:30.000,2025-04-15 09:20:31.197
false,false,1123,1057,66,254,00:00:33.000,2025-04-15 09:20:35.202
false,false,1444,1357,87,561,00:00:30.000,2025-04-15 09:26:56.596
false,false,1448,1360,88,689,00:00:32.000,2025-04-15 09:27:00.599
false,false,1451,1363,88,783,00:00:32.000,2025-04-15 09:27:03.600
false,true,1463,1374,89,0,00:00:00.000,2025-04-15 09:27:23.622
false,true,1475,1385,90,0,00:00:00.000,2025-04-15 09:27:40.639
false,false,1482,1391,91,221,00:00:30.000,2025-04-15 09:27:52.648
false,true,1508,1414,94,0,00:00:00.000,2025-04-15 09:28:28.683
false,false,1543,1446,97,1102,00:00:33.000,2025-04-15 09:29:05.721
false,true,1546,1449,97,0,00:00:00.000,2025-04-15 09:29:12.729
false,false,1601,1499,102,255,00:00:33.000,2025-04-15 09:30:27.811
false,false,1606,1504,102,411,00:00:32.000,2025-04-15 09:30:32.815
false,true,1608,1506,102,0,00:00:00.000,2025-04-15 09:30:37.819
false,false,1710,1602,108,3143,00:00:30.000,2025-04-15 09:32:28.921
false,false,1757,1647,110,130,00:00:32.000,2025-04-15 09:33:27.985
false,true,1610,1508,102,0,00:00:00.000,2025-04-15 09:30:43.822
false,true,1610,1508,102,0,00:00:00.000,2025-04-15 09:30:46.825
false,false,1631,1528,103,659,00:00:33.000,2025-04-15 09:31:09.846
false,false,1688,1580,108,2457,00:00:32.000,2025-04-15 09:32:06.900
false,false,1784,1672,112,221,00:00:30.000,2025-04-15 09:34:13.034
false,false,1787,1675,112,32,00:00:32.000,2025-04-15 09:34:22.042
false,false,1789,1677,112,94,00:00:32.000,2025-04-15 09:34:24.044
false,false,1792,1680,112,189,00:00:33.000,2025-04-15 09:34:27.050
false,false,1797,1685,112,123,00:00:31.000,2025-04-15 09:34:38.060
false,false,1817,1704,113,191,00:00:30.000,2025-04-15 09:35:04.091
false,false,1821,1708,113,318,00:00:32.000,2025-04-15 09:35:08.095
false,false,1828,1715,113,62,00:00:31.000,2025-04-15 09:35:27.113
false,true,1830,1717,113,0,00:00:00.000,2025-04-15 09:35:30.116
false,false,1842,1728,114,370,00:00:32.000,2025-04-15 09:35:47.134
false,true,1842,1728,114,0,00:00:00.000,2025-04-15 09:35:51.137
false,false,1850,1736,114,251,00:00:32.000,2025-04-15 09:36:01.148
false,false,1863,1749,114,657,00:00:32.000,2025-04-15 09:36:14.164
false,false,1883,1768,115,61,00:00:31.000,2025-04-15 09:36:46.202
false,false,1888,1772,116,219,00:00:31.000,2025-04-15 09:36:51.208
false,true,1916,1799,117,0,00:00:00.000,2025-04-15 09:37:36.253
false,false,1964,1846,118,413,00:00:33.000,2025-04-15 09:38:43.331
false,true,1971,1852,119,0,00:00:00.000,2025-04-15 09:38:51.338
false,false,1973,1854,119,64,00:00:33.000,2025-04-15 09:38:58.346
false,true,1975,1856,119,0,00:00:00.000,2025-04-15 09:39:02.349
false,false,2057,1931,126,690,00:00:31.000,2025-04-15 09:40:58.460
false,false,2058,1932,126,723,00:00:33.000,2025-04-15 09:40:59.460
false,false,2059,1933,126,754,00:00:31.000,2025-04-15 09:41:00.462
false,false,2081,1954,127,415,00:00:32.000,2025-04-15 09:41:28.492
false,false,2098,1971,127,214,00:00:31.000,2025-04-15 09:41:51.517
false,false,2111,1984,127,622,00:00:33.000,2025-04-15 09:42:04.530
false,false,2158,2026,132,2106,00:00:30.000,2025-04-15 09:42:51.583
false,false,2184,2051,133,2931,00:00:31.000,2025-04-15 09:43:17.604
false,false,2194,2060,134,3249,00:00:32.000,2025-04-15 09:43:27.617
false,false,2215,2078,137,3913,00:00:31.000,2025-04-15 09:43:48.641
false,false,1573,1479,94,2060,00:00:32.000,2025-04-14 11:37:43.043
false,true,1587,1492,95,0,00:00:00.000,2025-04-14 11:38:21.068
false,false,1591,1496,95,126,00:00:32.000,2025-04-14 11:38:31.074
false,false,1285,1212,73,371,00:00:31.000,2025-04-14 11:25:18.496
false,false,1291,1218,73,563,00:00:33.000,2025-04-14 11:25:30.499
false,false,1302,1229,73,349,00:00:30.000,2025-04-14 11:26:04.522
false,false,1303,1230,73,380,00:00:31.000,2025-04-14 11:26:06.523
false,false,1306,1232,74,477,00:00:32.000,2025-04-14 11:26:12.528
false,false,1312,1237,75,661,00:00:30.000,2025-04-14 11:26:24.537
false,false,1327,1251,76,1134,00:00:31.000,2025-04-14 11:26:54.558
false,false,1354,1275,79,1986,00:00:32.000,2025-04-14 11:27:48.603
false,false,1360,1281,79,2170,00:00:31.000,2025-04-14 11:28:00.616
false,false,1367,1288,79,96,00:00:33.000,2025-04-14 11:28:26.633
false,false,1370,1290,80,190,00:00:31.000,2025-04-14 11:28:32.637
false,true,1370,1290,80,0,00:00:00.000,2025-04-14 11:28:34.637
false,true,1438,1353,85,0,00:00:00.000,2025-04-14 11:32:06.789
false,false,1452,1367,85,348,00:00:33.000,2025-04-14 11:32:52.823
false,false,1472,1386,86,976,00:00:32.000,2025-04-14 11:33:32.849
false,false,1498,1411,87,375,00:00:30.000,2025-04-14 11:35:00.916
false,false,1374,1294,80,125,00:00:31.000,2025-04-14 11:28:52.646
false,true,1375,1295,80,0,00:00:00.000,2025-04-14 11:29:06.660
false,false,1383,1301,82,257,00:00:33.000,2025-04-14 11:29:22.671
false,false,1385,1303,82,322,00:00:32.000,2025-04-14 11:29:26.675
false,false,1395,1313,82,156,00:00:33.000,2025-04-14 11:29:58.700
false,false,1396,1314,82,188,00:00:32.000,2025-04-14 11:30:00.703
false,false,1403,1321,82,95,00:00:32.000,2025-04-14 11:30:26.724
false,false,1408,1326,82,257,00:00:33.000,2025-04-14 11:30:36.731
false,false,1409,1327,82,287,00:00:30.000,2025-04-14 11:30:38.733
false,false,1421,1337,84,662,00:00:32.000,2025-04-14 11:31:02.749
false,true,457,426,31,0,00:00:00.000,2025-04-16 10:23:20.962
false,false,462,431,31,153,00:00:30.000,2025-04-16 10:23:24.969
false,false,433,402,31,2043,00:00:31.000,2025-04-16 10:22:58.428
false,false,437,406,31,32,00:00:32.000,2025-04-16 10:23:03.436
false,false,257,240,17,286,00:00:33.000,2025-04-16 10:21:12.275
false,false,262,244,18,447,00:00:32.000,2025-04-16 10:21:14.779
false,false,265,247,18,544,00:00:32.000,2025-04-16 10:21:16.281
false,false,271,253,18,730,00:00:31.000,2025-04-16 10:21:19.284
false,false,305,285,20,252,00:00:30.000,2025-04-16 10:21:45.317
false,false,316,294,22,185,00:00:31.000,2025-04-16 10:21:56.835
false,false,242,225,17,217,00:00:30.000,2025-04-16 10:20:58.758
false,false,243,226,17,247,00:00:30.000,2025-04-16 10:20:59.258
false,false,245,228,17,30,00:00:30.000,2025-04-16 10:21:03.263
false,true,248,231,17,0,00:00:00.000,2025-04-16 10:21:07.770
false,false,336,312,24,818,00:00:31.000,2025-04-16 10:22:06.851
false,true,368,342,26,0,00:00:00.000,2025-04-16 10:22:24.879
false,false,374,348,26,190,00:00:30.000,2025-04-16 10:22:28.887
false,false,397,370,27,906,00:00:31.000,2025-04-16 10:22:40.403
false,false,415,388,27,1471,00:00:32.000,2025-04-16 10:22:49.417
false,false,471,440,31,437,00:00:33.000,2025-04-16 10:23:29.475
false,false,475,443,32,562,00:00:30.000,2025-04-16 10:23:31.479
false,false,505,472,33,123,00:00:31.000,2025-04-16 10:23:55.511
false,true,516,483,33,0,00:00:00.000,2025-04-16 10:24:02.023
false,false,520,487,33,123,00:00:31.000,2025-04-16 10:24:06.031
false,false,522,489,33,185,00:00:30.000,2025-04-16 10:24:07.032
false,true,522,489,33,0,00:00:00.000,2025-04-16 10:24:10.037
false,false,532,497,35,315,00:00:30.000,2025-04-16 10:24:15.043
false,false,533,497,36,346,00:00:31.000,2025-04-16 10:24:15.543
false,true,534,498,36,0,00:00:00.000,2025-04-16 10:24:18.046
false,true,1139,1072,67,0,00:00:00.000,2025-04-15 09:20:57.221
false,false,1143,1076,67,129,00:00:32.000,2025-04-15 09:21:01.223
false,false,1167,1099,68,887,00:00:30.000,2025-04-15 09:21:25.246
false,false,1186,1115,71,1483,00:00:31.000,2025-04-15 09:21:44.263
false,false,1193,1119,74,217,00:00:30.000,2025-04-15 09:21:57.275
false,false,1205,1131,74,355,00:00:31.000,2025-04-15 09:22:15.291
false,false,1218,1144,74,764,00:00:32.000,2025-04-15 09:22:28.301
false,false,1240,1165,75,1464,00:00:33.000,2025-04-15 09:22:50.323
false,false,1262,1185,77,472,00:00:30.000,2025-04-15 09:23:18.354
false,false,1263,1186,77,503,00:00:31.000,2025-04-15 09:23:19.355
false,false,1279,1200,79,504,00:00:30.000,2025-04-15 09:23:41.377
false,false,1300,1218,82,1168,00:00:31.000,2025-04-15 09:24:02.402
false,false,1319,1237,82,379,00:00:31.000,2025-04-15 09:24:27.427
false,false,1331,1249,82,759,00:00:31.000,2025-04-15 09:24:39.443
false,true,1352,1268,84,0,00:00:00.000,2025-04-15 09:25:02.472
false,true,1352,1268,84,0,00:00:00.000,2025-04-15 09:25:05.475
false,false,1400,1313,87,590,00:00:33.000,2025-04-15 09:26:06.541
false,false,1405,1318,87,750,00:00:30.000,2025-04-15 09:26:11.548
false,false,1431,1344,87,153,00:00:31.000,2025-04-15 09:26:43.583
false,true,1452,1364,88,0,00:00:00.000,2025-04-15 09:27:09.606
false,false,1490,1398,92,470,00:00:30.000,2025-04-15 09:28:00.655
false,false,1492,1400,92,531,00:00:30.000,2025-04-15 09:28:02.656
false,false,1493,1401,92,564,00:00:33.000,2025-04-15 09:28:03.657
false,false,1504,1410,94,318,00:00:30.000,2025-04-15 09:28:20.674
false,true,1508,1414,94,0,00:00:00.000,2025-04-15 09:28:26.681
false,false,1534,1438,96,818,00:00:30.000,2025-04-15 09:28:56.712
false,false,1551,1454,97,155,00:00:31.000,2025-04-15 09:29:19.740
false,false,1564,1466,98,127,00:00:32.000,2025-04-15 09:29:38.760
false,false,1577,1477,100,541,00:00:33.000,2025-04-15 09:29:51.774
false,false,1597,1495,102,126,00:00:30.000,2025-04-15 09:30:23.805
false,false,1719,1610,109,3427,00:00:30.000,2025-04-15 09:32:37.930
false,false,1720,1611,109,3458,00:00:31.000,2025-04-15 09:32:38.931
false,true,1744,1635,109,0,00:00:00.000,2025-04-15 09:33:03.954
false,true,1762,1652,110,0,00:00:00.000,2025-04-15 09:33:33.991
false,true,1762,1652,110,0,00:00:00.000,2025-04-15 09:33:35.994
false,false,1763,1652,111,33,00:00:33.000,2025-04-15 09:33:40.000
false,false,1622,1520,102,375,00:00:30.000,2025-04-15 09:31:00.838
false,false,1629,1526,103,594,00:00:30.000,2025-04-15 09:31:07.845
false,false,1641,1538,103,970,00:00:33.000,2025-04-15 09:31:19.858
false,false,1646,1543,103,1129,00:00:32.000,2025-04-15 09:31:24.861
false,false,1648,1545,103,1191,00:00:32.000,2025-04-15 09:31:26.863
false,false,1671,1566,105,1917,00:00:33.000,2025-04-15 09:31:49.884
false,false,1674,1569,105,2011,00:00:31.000,2025-04-15 09:31:52.888
false,false,1680,1575,105,2205,00:00:33.000,2025-04-15 09:31:58.891
false,false,1785,1673,112,254,00:00:33.000,2025-04-15 09:34:14.034
false,false,1794,1682,112,32,00:00:32.000,2025-04-15 09:34:35.059
false,false,1799,1686,113,186,00:00:33.000,2025-04-15 09:34:40.061
false,false,1802,1689,113,279,00:00:33.000,2025-04-15 09:34:43.065
false,false,1810,1697,113,535,00:00:33.000,2025-04-15 09:34:51.074
false,true,1811,1698,113,0,00:00:00.000,2025-04-15 09:34:55.080
false,true,1823,1710,113,0,00:00:00.000,2025-04-15 09:35:11.098
false,true,1830,1717,113,0,00:00:00.000,2025-04-15 09:35:35.121
false,true,1842,1728,114,0,00:00:00.000,2025-04-15 09:35:50.137
false,false,1856,1742,114,436,00:00:30.000,2025-04-15 09:36:07.156
false,false,1878,1763,115,1123,00:00:30.000,2025-04-15 09:36:29.181
false,true,1881,1766,115,0,00:00:00.000,2025-04-15 09:36:43.198
false,false,1892,1776,116,30,00:00:30.000,2025-04-15 09:37:01.217
false,false,1902,1786,116,337,00:00:30.000,2025-04-15 09:37:11.229
false,false,1913,1796,117,685,00:00:32.000,2025-04-15 09:37:22.240
false,false,1918,1801,117,64,00:00:33.000,2025-04-15 09:37:39.259
false,false,1920,1803,117,125,00:00:30.000,2025-04-15 09:37:41.261
false,false,1947,1829,118,505,00:00:31.000,2025-04-15 09:38:20.301
false,false,1956,1838,118,156,00:00:31.000,2025-04-15 09:38:35.321
false,true,1971,1852,119,0,00:00:00.000,2025-04-15 09:38:53.340
false,false,2048,1922,126,406,00:00:33.000,2025-04-15 09:40:49.453
false,false,2060,1934,126,785,00:00:31.000,2025-04-15 09:41:01.463
false,false,2086,1959,127,571,00:00:31.000,2025-04-15 09:41:33.497
false,false,2096,1969,127,153,00:00:30.000,2025-04-15 09:41:49.515
false,false,2102,1975,127,339,00:00:32.000,2025-04-15 09:41:55.520
false,false,2115,1988,127,748,00:00:32.000,2025-04-15 09:42:08.535
false,false,2116,1988,128,779,00:00:31.000,2025-04-15 09:42:09.536
false,false,2173,2040,133,2578,00:00:31.000,2025-04-15 09:43:06.593
false,false,2177,2044,133,2706,00:00:30.000,2025-04-15 09:43:10.597
true,false,281,263,18,251,00:00:32.000,2025-04-16 10:21:27.292
true,false,292,273,19,314,00:00:31.000,2025-04-16 10:21:35.802
true,false,1401,1314,87,621,00:00:31.000,2025-04-15 09:26:07.543
true,true,1508,1414,94,0,00:00:00.000,2025-04-15 09:28:27.682
true,false,1621,1519,102,345,00:00:33.000,2025-04-15 09:30:59.837
true,false,1664,1560,104,1697,00:00:32.000,2025-04-15 09:31:42.879
true,false,1505,1417,88,595,00:00:33.000,2025-04-14 11:35:14.927
true,false,431,400,31,1979,00:00:32.000,2025-04-16 10:22:57.426
true,false,413,386,27,1407,00:00:31.000,2025-04-16 10:22:48.415
true,true,1744,1635,109,0,00:00:00.000,2025-04-15 09:33:04.954
true,false,1788,1676,112,62,00:00:30.000,2025-04-15 09:34:23.044
true,false,1307,1233,74,509,00:00:32.000,2025-04-14 11:26:14.529
true,false,1329,1253,76,1197,00:00:30.000,2025-04-14 11:26:58.563
true,false,1423,1339,84,727,00:00:32.000,2025-04-14 11:31:06.752
true,false,1164,1096,68,794,00:00:30.000,2025-04-15 09:21:22.245
true,false,1567,1468,99,223,00:00:33.000,2025-04-15 09:29:41.764
true,false,1660,1557,103,1571,00:00:31.000,2025-04-15 09:31:38.875
true,false,1916,1799,117,64,00:00:31.000,2025-04-15 09:37:31.251
true,false,2049,1923,126,437,00:00:31.000,2025-04-15 09:40:50.453
true,false,2104,1977,127,402,00:00:33.000,2025-04-15 09:41:57.523
true,false,1373,1293,80,94,00:00:31.000,2025-04-14 11:28:50.645
true,false,1379,1299,80,127,00:00:32.000,2025-04-14 11:29:14.662
true,false,1380,1299,81,160,00:00:33.000,2025-04-14 11:29:16.665
true,false,516,483,33,470,00:00:31.000,2025-04-16 10:24:01.021
true,false,2067,1941,126,1002,00:00:32.000,2025-04-15 09:41:08.474
true,false,1337,1260,77,1452,00:00:32.000,2025-04-14 11:27:14.573
true,false,1504,1416,88,562,00:00:31.000,2025-04-14 11:35:12.926
true,true,457,426,31,0,00:00:00.000,2025-04-16 10:23:20.460
true,false,337,313,24,848,00:00:30.000,2025-04-16 10:22:07.351
true,false,1535,1438,97,848,00:00:30.000,2025-04-15 09:28:57.713
true,false,1590,1488,102,154,00:00:30.000,2025-04-15 09:30:10.791
true,false,1616,1514,102,187,00:00:32.000,2025-04-15 09:30:54.832
true,false,1862,1748,114,625,00:00:31.000,2025-04-15 09:36:13.164
true,false,1170,1102,68,981,00:00:33.000,2025-04-15 09:21:28.250
true,false,1272,1194,78,282,00:00:30.000,2025-04-15 09:23:34.372
true,false,1276,1197,79,411,00:00:33.000,2025-04-15 09:23:38.375
true,false,1329,1247,82,698,00:00:30.000,2025-04-15 09:24:37.442
true,false,1528,1432,96,629,00:00:32.000,2025-04-15 09:28:50.706
true,true,1610,1508,102,0,00:00:00.000,2025-04-15 09:30:47.826
true,false,1934,1817,117,95,00:00:31.000,2025-04-15 09:38:07.287
true,false,2079,1952,127,350,00:00:32.000,2025-04-15 09:41:26.489
true,true,1587,1492,95,0,00:00:00.000,2025-04-14 11:38:23.070
true,false,1201,1127,74,227,00:00:33.000,2025-04-15 09:22:11.289
true,false,1204,1130,74,324,00:00:32.000,2025-04-15 09:22:14.290
true,false,1546,1449,97,1196,00:00:30.000,2025-04-15 09:29:08.726
true,false,1827,1714,113,31,00:00:31.000,2025-04-15 09:35:26.112
true,false,2185,2052,133,2962,00:00:31.000,2025-04-15 09:43:18.605
true,false,358,332,26,1510,00:00:32.000,2025-04-16 10:22:17.869
true,true,1115,1049,66,0,00:00:00.000,2025-04-15 09:20:24.191
true,false,1657,1554,103,1477,00:00:33.000,2025-04-15 09:31:35.872
true,false,1780,1669,111,96,00:00:33.000,2025-04-15 09:34:09.028
true,true,1951,1833,118,0,00:00:00.000,2025-04-15 09:38:27.311
true,false,1368,1289,79,129,00:00:33.000,2025-04-14 11:28:28.634
true,false,1413,1330,83,412,00:00:30.000,2025-04-14 11:30:46.741
true,false,493,461,32,343,00:00:32.000,2025-04-16 10:23:46.498
true,false,1771,1660,111,63,00:00:30.000,2025-04-15 09:33:54.015
true,false,1775,1664,111,189,00:00:33.000,2025-04-15 09:33:58.018
true,false,1811,1698,113,567,00:00:32.000,2025-04-15 09:34:52.076
true,false,1897,1781,116,183,00:00:30.000,2025-04-15 09:37:06.222
true,false,2207,2072,135,3661,00:00:32.000,2025-04-15 09:43:40.631
true,true,1441,1356,85,0,00:00:00.000,2025-04-14 11:32:30.807
true,true,1400,1318,82,0,00:00:00.000,2025-04-14 11:30:16.717
true,true,1436,1351,85,0,00:00:00.000,2025-04-14 11:31:50.779
true,false,465,434,31,246,00:00:32.000,2025-04-16 10:23:26.471
true,false,1371,1287,84,537,00:00:30.000,2025-04-15 09:25:31.501
true,false,1474,1384,90,345,00:00:32.000,2025-04-15 09:27:38.637
true,false,1566,1467,99,190,00:00:32.000,2025-04-15 09:29:40.762
true,false,1668,1563,105,1820,00:00:31.000,2025-04-15 09:31:46.881
true,false,1699,1591,108,2797,00:00:31.000,2025-04-15 09:32:17.913
true,false,2088,1961,127,633,00:00:30.000,2025-04-15 09:41:35.500
true,true,1438,1353,85,0,00:00:00.000,2025-04-14 11:32:04.787
true,false,1397,1315,82,221,00:00:33.000,2025-04-14 11:30:02.705
true,false,463,432,31,184,00:00:31.000,2025-04-16 10:23:25.469
true,true,248,231,17,0,00:00:00.000,2025-04-16 10:21:06.269
true,false,334,310,24,754,00:00:32.000,2025-04-16 10:22:05.849
true,false,371,345,26,97,00:00:32.000,2025-04-16 10:22:27.383
true,false,488,456,32,185,00:00:31.000,2025-04-16 10:23:43.995
true,false,1455,1366,89,97,00:00:33.000,2025-04-15 09:27:13.608
true,false,1469,1379,90,188,00:00:31.000,2025-04-15 09:27:33.631
true,false,1607,1505,102,441,00:00:30.000,2025-04-15 09:30:33.815
true,false,1344,1266,78,1675,00:00:32.000,2025-04-14 11:27:28.582
true,false,369,343,26,32,00:00:32.000,2025-04-16 10:22:26.381
true,false,1145,1078,67,195,00:00:33.000,2025-04-15 09:21:03.226
true,false,1181,1111,70,1330,00:00:32.000,2025-04-15 09:21:39.258
true,false,1467,1377,90,127,00:00:32.000,2025-04-15 09:27:31.630
true,false,1694,1586,108,2643,00:00:33.000,2025-04-15 09:32:12.907
true,true,1777,1666,111,0,00:00:00.000,2025-04-15 09:34:03.023
true,false,1321,1246,75,948,00:00:30.000,2025-04-14 11:26:42.551
true,false,514,481,33,409,00:00:31.000,2025-04-16 10:24:00.019
true,false,1305,1223,82,1326,00:00:31.000,2025-04-15 09:24:07.406
true,true,1307,1225,82,0,00:00:00.000,2025-04-15 09:24:14.414
true,false,1876,1761,115,1063,00:00:30.000,2025-04-15 09:36:27.179
true,true,2091,1964,127,0,00:00:00.000,2025-04-15 09:41:43.507
true,false,2105,1978,127,435,00:00:33.000,2025-04-15 09:41:58.524
true,false,1308,1234,74,539,00:00:30.000,2025-04-14 11:26:16.531
true,false,364,338,26,1700,00:00:31.000,2025-04-16 10:22:20.873
true,true,1381,1297,84,0,00:00:00.000,2025-04-15 09:25:43.514
true,false,1449,1361,88,720,00:00:31.000,2025-04-15 09:27:01.600
true,false,1499,1406,93,159,00:00:31.000,2025-04-15 09:28:15.669
true,false,269,251,18,669,00:00:32.000,2025-04-16 10:21:18.283
true,false,353,327,26,1356,00:00:32.000,2025-04-16 10:22:15.365
true,false,382,356,26,438,00:00:32.000,2025-04-16 10:22:32.892
true,false,1750,1640,110,192,00:00:32.000,2025-04-15 09:33:14.967
true,false,1962,1844,118,349,00:00:33.000,2025-04-15 09:38:41.327
true,true,1473,1387,86,0,00:00:00.000,2025-04-14 11:33:42.856
true,true,501,468,33,0,00:00:00.000,2025-04-16 10:23:53.508
true,true,1115,1049,66,0,00:00:00.000,2025-04-15 09:20:27.193
true,false,1941,1823,118,319,00:00:33.000,2025-04-15 09:38:14.295
true,false,1945,1827,118,444,00:00:32.000,2025-04-15 09:38:18.300
true,false,2123,1994,129,1000,00:00:32.000,2025-04-15 09:42:16.546
true,false,2179,2046,133,2771,00:00:32.000,2025-04-15 09:43:12.598
false,false,2186,2053,133,2995,00:00:33.000,2025-04-15 09:43:19.606
false,false,2205,2070,135,3598,00:00:31.000,2025-04-15 09:43:38.630
false,false,2210,2075,135,3754,00:00:30.000,2025-04-15 09:43:43.634
false,false,2226,2087,139,4264,00:00:30.000,2025-04-15 09:43:59.653
false,false,2228,2089,139,4329,00:00:33.000,2025-04-15 09:44:01.656
false,false,1977,1857,120,66,00:00:33.000,2025-04-15 09:39:08.355
false,true,1978,1857,121,0,00:00:00.000,2025-04-15 09:39:13.360
false,false,1982,1861,121,128,00:00:30.000,2025-04-15 09:39:19.364
false,false,1987,1865,122,288,00:00:32.000,2025-04-15 09:39:24.368
false,false,1988,1866,122,319,00:00:31.000,2025-04-15 09:39:25.368
false,true,1988,1866,122,0,00:00:00.000,2025-04-15 09:39:31.374
false,true,1996,1874,122,0,00:00:00.000,2025-04-15 09:39:47.387
false,false,2034,1909,125,1200,00:00:31.000,2025-04-15 09:40:29.437
false,true,2035,1910,125,0,00:00:00.000,2025-04-15 09:40:31.438
false,true,2035,1910,125,0,00:00:00.000,2025-04-15 09:40:35.440
false,false,2329,2182,147,96,00:00:33.000,2025-04-15 09:47:24.859
false,false,2331,2184,147,33,00:00:33.000,2025-04-15 09:47:32.866
false,false,2332,2185,147,64,00:00:31.000,2025-04-15 09:47:33.867
false,false,2372,2222,150,320,00:00:31.000,2025-04-15 09:48:25.927
false,false,2377,2227,150,476,00:00:33.000,2025-04-15 09:48:30.931
false,false,2397,2246,151,309,00:00:30.000,2025-04-15 09:48:56.960
false,true,2399,2248,151,0,00:00:00.000,2025-04-15 09:49:00.965
false,true,2282,2137,145,0,00:00:00.000,2025-04-15 09:45:45.755
false,true,2282,2137,145,0,00:00:00.000,2025-04-15 09:45:47.757
false,false,2285,2140,145,96,00:00:31.000,2025-04-15 09:45:52.762
false,true,2294,2148,146,0,00:00:00.000,2025-04-15 09:46:16.789
false,true,2312,2165,147,0,00:00:00.000,2025-04-15 09:46:53.823
false,false,2230,2091,139,4392,00:00:30.000,2025-04-15 09:44:03.659
false,false,2241,2101,140,4738,00:00:30.000,2025-04-15 09:44:14.669
false,false,2418,2266,152,594,00:00:31.000,2025-04-15 09:49:23.988
false,false,2427,2274,153,874,00:00:30.000,2025-04-15 09:49:32.995
false,false,2442,2288,154,1349,00:00:32.000,2025-04-15 09:49:48.011
false,false,2456,2301,155,1796,00:00:32.000,2025-04-15 09:50:02.021
false,true,2470,2315,155,0,00:00:00.000,2025-04-15 09:50:46.064
false,false,2473,2318,155,93,00:00:30.000,2025-04-15 09:50:49.068
false,false,2476,2320,156,186,00:00:32.000,2025-04-15 09:50:52.071
false,true,2479,2322,157,0,00:00:00.000,2025-04-15 09:50:56.076
false,false,2504,2347,157,785,00:00:30.000,2025-04-15 09:51:26.102
false,false,2507,2350,157,60,00:00:30.000,2025-04-15 09:51:35.113
false,false,2514,2356,158,276,00:00:33.000,2025-04-15 09:51:42.121
false,true,2514,2356,158,0,00:00:00.000,2025-04-15 09:51:43.122
false,false,2532,2374,158,569,00:00:30.000,2025-04-15 09:52:06.149
false,false,2534,2375,159,633,00:00:33.000,2025-04-15 09:52:08.150
false,false,2538,2379,159,757,00:00:31.000,2025-04-15 09:52:12.153
false,false,2540,2381,159,33,00:00:33.000,2025-04-15 09:52:20.159
false,false,2664,2497,167,708,00:00:31.000,2025-04-15 09:55:06.320
false,true,2672,2505,167,0,00:00:00.000,2025-04-15 09:55:21.335
false,true,2672,2505,167,0,00:00:00.000,2025-04-15 09:55:24.337
false,false,2544,2385,159,162,00:00:33.000,2025-04-15 09:52:24.164
false,false,2562,2403,159,542,00:00:33.000,2025-04-15 09:52:48.189
false,false,2563,2404,159,573,00:00:31.000,2025-04-15 09:52:49.190
false,false,2581,2421,160,1132,00:00:30.000,2025-04-15 09:53:07.208
false,false,2592,2432,160,348,00:00:31.000,2025-04-15 09:53:24.228
false,true,2600,2440,160,0,00:00:00.000,2025-04-15 09:53:36.239
false,true,2601,2441,160,0,00:00:00.000,2025-04-15 09:53:40.244
false,true,2601,2441,160,0,00:00:00.000,2025-04-15 09:53:46.250
false,true,2601,2441,160,0,00:00:00.000,2025-04-15 09:53:48.253
false,false,2604,2444,160,93,00:00:30.000,2025-04-15 09:53:54.257
false,false,2608,2447,161,221,00:00:30.000,2025-04-15 09:53:58.261
false,false,2732,2565,167,818,00:00:30.000,2025-04-15 09:56:50.417
false,false,2735,2568,167,914,00:00:33.000,2025-04-15 09:56:53.421
false,false,2755,2585,170,187,00:00:32.000,2025-04-15 09:57:31.465
false,false,2781,2609,172,724,00:00:32.000,2025-04-15 09:58:03.499
false,true,2786,2613,173,0,00:00:00.000,2025-04-15 09:58:09.505
false,false,2787,2614,173,32,00:00:32.000,2025-04-15 09:58:15.508
false,false,2708,2541,167,64,00:00:31.000,2025-04-15 09:56:26.392
false,true,2839,2665,174,0,00:00:00.000,2025-04-15 09:59:21.573
false,false,2850,2676,174,354,00:00:31.000,2025-04-15 09:59:36.588
false,false,2888,2711,177,411,00:00:30.000,2025-04-15 10:00:32.656
false,true,2895,2717,178,0,00:00:00.000,2025-04-15 10:00:41.669
false,true,2895,2717,178,0,00:00:00.000,2025-04-15 10:00:42.669
false,false,2909,2729,180,309,00:00:30.000,2025-04-15 10:01:05.693
false,true,2917,2736,181,0,00:00:00.000,2025-04-15 10:01:23.709
false,true,2917,2736,181,0,00:00:00.000,2025-04-15 10:01:24.711
false,false,3120,2932,188,811,00:00:33.000,2025-04-15 10:05:24.951
false,false,3123,2935,188,904,00:00:31.000,2025-04-15 10:05:27.953
false,false,3131,2942,189,221,00:00:30.000,2025-04-15 10:05:41.968
false,false,3143,2952,191,604,00:00:33.000,2025-04-15 10:05:53.976
false,false,3146,2955,191,698,00:00:30.000,2025-04-15 10:05:56.981
false,false,3147,2956,191,731,00:00:33.000,2025-04-15 10:05:57.981
false,false,3159,2967,192,32,00:00:32.000,2025-04-15 10:06:15.998
false,false,3180,2987,193,96,00:00:31.000,2025-04-15 10:06:43.024
false,false,3181,2988,193,127,00:00:31.000,2025-04-15 10:06:44.024
false,false,3193,2999,194,65,00:00:33.000,2025-04-15 10:07:02.041
false,false,3195,3001,194,130,00:00:32.000,2025-04-15 10:07:04.043
false,false,3205,3010,195,30,00:00:30.000,2025-04-15 10:07:20.057
false,false,3206,3011,195,61,00:00:31.000,2025-04-15 10:07:21.059
false,false,3208,3013,195,123,00:00:32.000,2025-04-15 10:07:23.062
false,true,3214,3019,195,0,00:00:00.000,2025-04-15 10:07:47.087
false,false,3217,3022,195,96,00:00:30.000,2025-04-15 10:07:50.088
false,false,2937,2755,182,316,00:00:30.000,2025-04-15 10:01:51.734
false,false,2957,2773,184,948,00:00:33.000,2025-04-15 10:02:11.759
false,false,2962,2778,184,1103,00:00:30.000,2025-04-15 10:02:16.764
false,false,2963,2779,184,1134,00:00:31.000,2025-04-15 10:02:17.765
false,false,2970,2786,184,1363,00:00:33.000,2025-04-15 10:02:24.773
false,false,2974,2789,185,1489,00:00:32.000,2025-04-15 10:02:28.774
false,false,2978,2793,185,1615,00:00:33.000,2025-04-15 10:02:32.779
false,false,2993,2808,185,2091,00:00:30.000,2025-04-15 10:02:47.797
false,false,3010,2825,185,2624,00:00:33.000,2025-04-15 10:03:04.817
false,false,3019,2834,185,121,00:00:31.000,2025-04-15 10:03:19.834
false,true,3043,2857,186,0,00:00:00.000,2025-04-15 10:03:50.856
false,false,3069,2883,186,287,00:00:32.000,2025-04-15 10:04:27.889
false,false,3095,2908,187,33,00:00:33.000,2025-04-15 10:04:59.925
false,false,3261,3062,199,190,00:00:30.000,2025-04-15 10:08:52.151
false,false,3303,3101,202,533,00:00:30.000,2025-04-15 10:09:40.199
false,false,3312,3110,202,818,00:00:30.000,2025-04-15 10:09:49.209
false,false,3338,3133,205,128,00:00:33.000,2025-04-15 10:10:21.245
false,true,3338,3133,205,0,00:00:00.000,2025-04-15 10:10:22.245
false,true,3338,3133,205,0,00:00:00.000,2025-04-15 10:10:23.247
false,true,3344,3139,205,0,00:00:00.000,2025-04-15 10:10:43.270
false,true,3344,3139,205,0,00:00:00.000,2025-04-15 10:10:45.271
false,true,3356,3151,205,0,00:00:00.000,2025-04-15 10:10:59.283
false,false,3382,3175,207,158,00:00:31.000,2025-04-15 10:11:35.319
false,true,3386,3178,208,0,00:00:00.000,2025-04-15 10:11:40.323
false,true,3455,3245,210,0,00:00:00.000,2025-04-15 10:13:25.432
false,true,3455,3245,210,0,00:00:00.000,2025-04-15 10:13:30.440
false,true,3455,3245,210,0,00:00:00.000,2025-04-15 10:13:35.445
false,false,3489,3277,212,693,00:00:32.000,2025-04-15 10:14:16.493
false,false,3584,3364,220,155,00:00:32.000,2025-04-15 10:16:45.646
false,false,3601,3381,220,467,00:00:30.000,2025-04-15 10:17:08.673
false,false,3615,3393,222,896,00:00:30.000,2025-04-15 10:17:22.684
false,false,3644,3419,225,1804,00:00:32.000,2025-04-15 10:17:51.712
false,false,3650,3425,225,1990,00:00:30.000,2025-04-15 10:17:57.717
false,false,3652,3427,225,2051,00:00:31.000,2025-04-15 10:17:59.719
false,true,3536,3320,216,0,00:00:00.000,2025-04-15 10:15:25.558
false,true,3536,3320,216,0,00:00:00.000,2025-04-15 10:15:27.560
false,true,3547,3330,217,0,00:00:00.000,2025-04-15 10:15:45.581
false,false,3556,3339,217,287,00:00:33.000,2025-04-15 10:15:59.594
false,true,3558,3341,217,0,00:00:00.000,2025-04-15 10:16:03.599
false,false,3567,3348,219,285,00:00:32.000,2025-04-15 10:16:16.615
false,false,3573,3353,220,475,00:00:30.000,2025-04-15 10:16:22.622
false,false,3576,3356,220,30,00:00:30.000,2025-04-15 10:16:31.630
false,false,3580,3360,220,30,00:00:30.000,2025-04-15 10:16:41.639
false,true,3690,3462,228,0,00:00:00.000,2025-04-15 10:18:50.773
false,false,3700,3469,231,310,00:00:30.000,2025-04-15 10:19:05.791
false,false,3708,3476,232,192,00:00:33.000,2025-04-15 10:19:19.808
false,false,3719,3486,233,536,00:00:31.000,2025-04-15 10:19:30.821
false,true,3721,3488,233,0,00:00:00.000,2025-04-15 10:19:38.827
false,false,3724,3491,233,97,00:00:33.000,2025-04-15 10:19:41.832
false,false,3728,3495,233,223,00:00:30.000,2025-04-15 10:19:45.837
false,false,3737,3504,233,64,00:00:31.000,2025-04-15 10:20:00.848
false,false,3739,3506,233,128,00:00:31.000,2025-04-15 10:20:02.851
false,false,3812,3574,238,31,00:00:31.000,2025-04-15 10:22:15.994
false,false,3816,3578,238,156,00:00:32.000,2025-04-15 10:22:19.999
false,false,3822,3584,238,349,00:00:33.000,2025-04-15 10:22:26.004
false,false,3824,3586,238,415,00:00:33.000,2025-04-15 10:22:28.005
false,false,3741,3507,234,192,00:00:31.000,2025-04-15 10:20:04.852
false,false,3760,3526,234,790,00:00:32.000,2025-04-15 10:20:23.873
false,false,3767,3533,234,1012,00:00:33.000,2025-04-15 10:20:30.881
false,false,3772,3538,234,1169,00:00:30.000,2025-04-15 10:20:35.888
false,false,3776,3541,235,95,00:00:31.000,2025-04-15 10:20:45.901
false,true,3781,3544,237,0,00:00:00.000,2025-04-15 10:20:53.911
false,false,3784,3547,237,91,00:00:30.000,2025-04-15 10:20:59.917
false,true,3791,3554,237,0,00:00:00.000,2025-04-15 10:21:24.942
false,false,3795,3558,237,127,00:00:32.000,2025-04-15 10:21:28.945
false,true,3797,3560,237,0,00:00:00.000,2025-04-15 10:21:32.949
false,false,3798,3561,237,32,00:00:32.000,2025-04-15 10:21:37.954
false,false,3388,3180,208,62,00:00:32.000,2025-04-15 10:11:47.331
false,false,3399,3191,208,31,00:00:31.000,2025-04-15 10:12:04.344
false,false,3405,3197,208,221,00:00:30.000,2025-04-15 10:12:10.352
false,true,3415,3207,208,0,00:00:00.000,2025-04-15 10:12:23.367
false,true,3437,3228,209,0,00:00:00.000,2025-04-15 10:13:02.410
false,false,3446,3237,209,282,00:00:30.000,2025-04-15 10:13:15.422
false,false,3447,3238,209,313,00:00:31.000,2025-04-15 10:13:16.422
false,false,3875,3631,244,467,00:00:31.000,2025-04-15 10:23:31.069
false,false,3914,3669,245,288,00:00:33.000,2025-04-15 10:24:22.124
false,true,3914,3669,245,0,00:00:00.000,2025-04-15 10:24:28.129
false,false,3919,3674,245,63,00:00:33.000,2025-04-15 10:24:39.141
false,false,4019,3769,250,1451,00:00:30.000,2025-04-15 10:26:49.274
false,false,4027,3776,251,249,00:00:32.000,2025-04-15 10:27:03.286
false,false,4041,3789,252,129,00:00:32.000,2025-04-15 10:27:23.306
false,false,4075,3823,252,446,00:00:31.000,2025-04-15 10:28:15.358
false,false,4312,4049,263,32,00:00:32.000,2025-04-15 10:33:36.714
false,true,4312,4049,263,0,00:00:00.000,2025-04-15 10:33:38.716
false,false,4331,4066,265,61,00:00:31.000,2025-04-15 10:34:13.758
false,false,4339,4074,265,187,00:00:32.000,2025-04-15 10:34:33.776
false,false,4346,4081,265,63,00:00:33.000,2025-04-15 10:34:46.790
false,false,4351,4086,265,217,00:00:31.000,2025-04-15 10:34:51.792
false,false,4236,3976,260,596,00:00:32.000,2025-04-15 10:31:50.591
false,true,4237,3977,260,0,00:00:00.000,2025-04-15 10:31:52.593
false,false,4275,4012,263,763,00:00:33.000,2025-04-15 10:32:41.653
false,false,4294,4031,263,219,00:00:30.000,2025-04-15 10:33:06.683
false,true,3942,3696,246,0,00:00:00.000,2025-04-15 10:25:12.174
false,false,3946,3700,246,129,00:00:31.000,2025-04-15 10:25:18.179
false,true,3964,3717,247,0,00:00:00.000,2025-04-15 10:25:42.202
false,false,4095,3842,253,1067,00:00:30.000,2025-04-15 10:28:35.382
false,false,4096,3843,253,1097,00:00:30.000,2025-04-15 10:28:36.383
false,false,4129,3875,254,350,00:00:31.000,2025-04-15 10:29:15.428
false,false,4147,3893,254,156,00:00:31.000,2025-04-15 10:29:39.448
false,false,4151,3896,255,281,00:00:30.000,2025-04-15 10:29:43.452
false,true,4179,3924,255,0,00:00:00.000,2025-04-15 10:30:29.503
false,true,4192,3935,257,0,00:00:00.000,2025-04-15 10:30:48.521
false,true,4194,3937,257,0,00:00:00.000,2025-04-15 10:30:54.526
false,false,4225,3966,259,247,00:00:33.000,2025-04-15 10:31:39.580
false,false,4398,4128,270,1483,00:00:31.000,2025-04-15 10:35:44.847
false,false,4409,4138,271,193,00:00:32.000,2025-04-15 10:36:01.866
false,false,4607,4326,281,534,00:00:32.000,2025-04-15 10:40:08.107
false,false,4610,4329,281,629,00:00:31.000,2025-04-15 10:40:11.111
false,false,4612,4329,283,693,00:00:33.000,2025-04-15 10:40:13.113
false,false,4617,4334,283,31,00:00:31.000,2025-04-15 10:40:24.124
false,true,4619,4336,283,0,00:00:00.000,2025-04-15 10:40:36.136
false,false,4637,4353,284,444,00:00:30.000,2025-04-15 10:41:02.162
false,true,4637,4353,284,0,00:00:00.000,2025-04-15 10:41:08.169
false,false,4643,4359,284,191,00:00:31.000,2025-04-15 10:41:14.177
false,true,4645,4360,285,0,00:00:00.000,2025-04-15 10:41:26.187
false,true,4648,4363,285,0,00:00:00.000,2025-04-15 10:41:32.192
false,true,4648,4363,285,0,00:00:00.000,2025-04-15 10:41:34.194
false,true,4648,4363,285,0,00:00:00.000,2025-04-15 10:41:36.196
false,false,4442,4169,273,466,00:00:32.000,2025-04-15 10:36:46.907
false,false,4466,4192,274,473,00:00:33.000,2025-04-15 10:37:16.938
false,false,4467,4193,274,506,00:00:33.000,2025-04-15 10:37:17.940
false,true,4469,4195,274,0,00:00:00.000,2025-04-15 10:37:23.944
false,false,4506,4229,277,1001,00:00:32.000,2025-04-15 10:38:08.991
false,false,4563,4284,279,731,00:00:32.000,2025-04-15 10:39:18.056
false,false,4567,4288,279,858,00:00:30.000,2025-04-15 10:39:22.060
false,false,4572,4293,279,1014,00:00:31.000,2025-04-15 10:39:27.063
false,false,4573,4293,280,1047,00:00:33.000,2025-04-15 10:39:28.065
false,false,4581,4301,280,1300,00:00:33.000,2025-04-15 10:39:36.070
false,true,4665,4379,286,0,00:00:00.000,2025-04-15 10:42:00.224
false,true,4679,4393,286,0,00:00:00.000,2025-04-15 10:42:19.235
false,false,4682,4395,287,97,00:00:33.000,2025-04-15 10:42:23.241
false,false,4696,4407,289,61,00:00:31.000,2025-04-15 10:42:43.259
false,true,4724,4432,292,0,00:00:00.000,2025-04-15 10:43:21.299
false,false,4725,4433,292,33,00:00:33.000,2025-04-15 10:43:24.301
false,false,4745,4452,293,410,00:00:33.000,2025-04-15 10:43:50.332
false,false,4756,4462,294,753,00:00:30.000,2025-04-15 10:44:01.343
false,true,4763,4469,294,0,00:00:00.000,2025-04-15 10:44:09.353
false,true,4776,4482,294,0,00:00:00.000,2025-04-15 10:44:36.386
false,false,4777,4483,294,33,00:00:33.000,2025-04-15 10:44:40.390
false,false,4813,4518,295,219,00:00:31.000,2025-04-15 10:45:22.427
false,true,4814,4519,295,0,00:00:00.000,2025-04-15 10:45:28.431
false,false,4836,4540,296,319,00:00:33.000,2025-04-15 10:46:03.466
false,true,4851,4553,298,0,00:00:00.000,2025-04-15 10:46:34.501
false,false,4862,4564,298,343,00:00:32.000,2025-04-15 10:46:47.515
false,false,4865,4567,298,437,00:00:31.000,2025-04-15 10:46:50.519
false,false,4888,4588,300,541,00:00:31.000,2025-04-15 10:47:19.554
false,false,4907,4607,300,1131,00:00:31.000,2025-04-15 10:47:38.577
false,false,4913,4612,301,63,00:00:30.000,2025-04-15 10:47:50.587
false,false,4933,4630,303,697,00:00:33.000,2025-04-15 10:48:10.610
false,false,5330,4995,335,853,00:00:33.000,2025-04-15 10:56:54.137
false,true,5334,4999,335,0,00:00:00.000,2025-04-15 10:57:01.143
false,false,5338,5003,335,125,00:00:31.000,2025-04-15 10:57:08.150
false,false,5345,5010,335,342,00:00:30.000,2025-04-15 10:57:15.153
false,false,5347,5012,335,32,00:00:32.000,2025-04-15 10:57:23.162
false,true,5364,5028,336,0,00:00:00.000,2025-04-15 10:57:43.182
false,false,5372,5034,338,256,00:00:33.000,2025-04-15 10:57:54.191
false,false,5394,5055,339,959,00:00:33.000,2025-04-15 10:58:16.211
false,false,5101,4784,317,570,00:00:32.000,2025-04-15 10:51:58.854
false,false,5105,4787,318,692,00:00:31.000,2025-04-15 10:52:02.856
false,true,5115,4797,318,0,00:00:00.000,2025-04-15 10:52:20.874
false,true,1975,1856,119,0,00:00:00.000,2025-04-15 09:39:05.353
false,false,1976,1857,119,33,00:00:33.000,2025-04-15 09:39:07.355
false,false,1990,1868,122,33,00:00:33.000,2025-04-15 09:39:39.380
false,false,1995,1873,122,193,00:00:31.000,2025-04-15 09:39:44.383
false,false,2016,1894,122,633,00:00:30.000,2025-04-15 09:40:11.415
false,false,2037,1912,125,60,00:00:30.000,2025-04-15 09:40:38.442
false,true,2330,2183,147,0,00:00:00.000,2025-04-15 09:47:27.863
false,false,2334,2187,147,127,00:00:33.000,2025-04-15 09:47:35.869
false,false,2338,2190,148,252,00:00:32.000,2025-04-15 09:47:39.876
false,true,2362,2213,149,0,00:00:00.000,2025-04-15 09:48:12.914
false,false,2379,2228,151,538,00:00:32.000,2025-04-15 09:48:32.934
false,true,2387,2236,151,0,00:00:00.000,2025-04-15 09:48:42.948
false,false,2388,2237,151,31,00:00:31.000,2025-04-15 09:48:47.952
false,true,2282,2137,145,0,00:00:00.000,2025-04-15 09:45:44.755
false,true,2291,2146,145,0,00:00:00.000,2025-04-15 09:45:59.770
false,true,2291,2146,145,0,00:00:00.000,2025-04-15 09:46:00.771
false,true,2291,2146,145,0,00:00:00.000,2025-04-15 09:46:05.777
false,false,2298,2152,146,124,00:00:32.000,2025-04-15 09:46:23.793
false,true,2298,2152,146,0,00:00:00.000,2025-04-15 09:46:24.794
false,true,2312,2165,147,0,00:00:00.000,2025-04-15 09:46:59.826
false,false,2314,2167,147,62,00:00:30.000,2025-04-15 09:47:03.830
false,false,2319,2172,147,220,00:00:33.000,2025-04-15 09:47:08.835
false,false,2262,2120,142,160,00:00:31.000,2025-04-15 09:45:11.723
false,false,2266,2124,142,63,00:00:30.000,2025-04-15 09:45:21.735
false,false,2276,2133,143,385,00:00:33.000,2025-04-15 09:45:31.745
false,false,2278,2135,143,447,00:00:31.000,2025-04-15 09:45:33.747
false,false,2410,2258,152,343,00:00:31.000,2025-04-15 09:49:15.982
false,false,2452,2297,155,1667,00:00:32.000,2025-04-15 09:49:58.018
false,false,2459,2304,155,1888,00:00:30.000,2025-04-15 09:50:05.024
false,true,2470,2315,155,0,00:00:00.000,2025-04-15 09:50:44.061
false,false,2471,2316,155,33,00:00:33.000,2025-04-15 09:50:47.066
false,false,2487,2330,157,252,00:00:32.000,2025-04-15 09:51:09.088
false,false,2489,2332,157,316,00:00:32.000,2025-04-15 09:51:11.089
false,false,2520,2362,158,184,00:00:31.000,2025-04-15 09:51:54.136
false,false,2524,2366,158,314,00:00:32.000,2025-04-15 09:51:58.140
false,false,2530,2372,158,506,00:00:32.000,2025-04-15 09:52:04.146
false,false,2536,2377,159,696,00:00:33.000,2025-04-15 09:52:10.152
false,false,2619,2457,162,573,00:00:33.000,2025-04-15 09:54:09.271
false,false,2620,2458,162,604,00:00:31.000,2025-04-15 09:54:10.273
false,true,2622,2460,162,0,00:00:00.000,2025-04-15 09:54:14.277
false,true,2622,2460,162,0,00:00:00.000,2025-04-15 09:54:17.281
false,false,2625,2463,162,96,00:00:32.000,2025-04-15 09:54:21.282
false,false,2641,2477,164,609,00:00:32.000,2025-04-15 09:54:37.295
false,false,2644,2480,164,66,00:00:33.000,2025-04-15 09:54:46.304
false,false,2658,2492,166,518,00:00:33.000,2025-04-15 09:55:00.316
false,false,2660,2493,167,579,00:00:31.000,2025-04-15 09:55:02.317
false,true,2671,2504,167,0,00:00:00.000,2025-04-15 09:55:18.332
false,true,2672,2505,167,0,00:00:00.000,2025-04-15 09:55:23.336
false,true,2676,2509,167,0,00:00:00.000,2025-04-15 09:55:41.353
false,false,2545,2386,159,192,00:00:30.000,2025-04-15 09:52:25.165
false,false,2546,2387,159,33,00:00:33.000,2025-04-15 09:52:32.171
false,false,2569,2410,159,757,00:00:30.000,2025-04-15 09:52:55.195
false,true,2600,2440,160,0,00:00:00.000,2025-04-15 09:53:35.238
false,false,2727,2560,167,664,00:00:33.000,2025-04-15 09:56:45.410
false,false,2736,2569,167,947,00:00:33.000,2025-04-15 09:56:54.423
false,true,2738,2570,168,0,00:00:00.000,2025-04-15 09:56:57.427
false,false,2742,2574,168,65,00:00:32.000,2025-04-15 09:57:12.445
false,false,2759,2588,171,30,00:00:30.000,2025-04-15 09:57:41.474
false,false,2761,2590,171,94,00:00:32.000,2025-04-15 09:57:43.475
false,false,2765,2594,171,220,00:00:32.000,2025-04-15 09:57:47.481
false,false,2780,2608,172,692,00:00:33.000,2025-04-15 09:58:02.497
false,false,2718,2551,167,380,00:00:32.000,2025-04-15 09:56:36.398
false,false,2807,2634,173,654,00:00:33.000,2025-04-15 09:58:35.526
false,true,2810,2636,174,0,00:00:00.000,2025-04-15 09:58:46.537
false,false,2818,2644,174,257,00:00:33.000,2025-04-15 09:58:58.546
false,false,2831,2657,174,661,00:00:32.000,2025-04-15 09:59:11.560
false,false,2854,2680,174,31,00:00:31.000,2025-04-15 09:59:46.600
false,false,2906,2727,179,216,00:00:32.000,2025-04-15 10:01:02.689
false,true,2927,2746,181,0,00:00:00.000,2025-04-15 10:01:37.725
false,false,3099,2912,187,154,00:00:30.000,2025-04-15 10:05:03.929
false,false,3107,2920,187,400,00:00:30.000,2025-04-15 10:05:11.938
false,false,3112,2924,188,557,00:00:30.000,2025-04-15 10:05:16.944
false,false,3117,2929,188,716,00:00:30.000,2025-04-15 10:05:21.949
false,true,3124,2936,188,0,00:00:00.000,2025-04-15 10:05:29.955
false,false,3144,2953,191,636,00:00:32.000,2025-04-15 10:05:54.978
false,false,3148,2956,192,762,00:00:31.000,2025-04-15 10:05:58.982
false,true,3191,2997,194,0,00:00:00.000,2025-04-15 10:07:00.040
false,false,3199,3004,195,254,00:00:31.000,2025-04-15 10:07:08.047
false,false,3201,3006,195,314,00:00:30.000,2025-04-15 10:07:10.048
false,false,3207,3012,195,91,00:00:30.000,2025-04-15 10:07:22.061
false,true,3209,3014,195,0,00:00:00.000,2025-04-15 10:07:25.065
false,false,3227,3032,195,413,00:00:33.000,2025-04-15 10:08:00.097
false,false,3231,3036,195,543,00:00:33.000,2025-04-15 10:08:04.101
false,false,2932,2751,181,159,00:00:31.000,2025-04-15 10:01:46.731
false,false,2965,2781,184,1198,00:00:32.000,2025-04-15 10:02:19.766
false,false,2988,2803,185,1933,00:00:32.000,2025-04-15 10:02:42.792
false,false,2990,2805,185,1997,00:00:32.000,2025-04-15 10:02:44.794
false,false,2992,2807,185,2061,00:00:33.000,2025-04-15 10:02:46.796
false,false,2999,2814,185,2276,00:00:32.000,2025-04-15 10:02:53.804
false,false,3005,2820,185,2466,00:00:32.000,2025-04-15 10:02:59.811
false,false,3007,2822,185,2526,00:00:30.000,2025-04-15 10:03:01.814
false,false,3011,2826,185,2657,00:00:33.000,2025-04-15 10:03:05.817
false,false,3024,2839,185,280,00:00:32.000,2025-04-15 10:03:24.839
false,false,3027,2842,185,377,00:00:33.000,2025-04-15 10:03:27.841
false,false,3030,2844,186,470,00:00:31.000,2025-04-15 10:03:30.842
false,true,3035,2849,186,0,00:00:00.000,2025-04-15 10:03:36.845
false,true,3043,2857,186,0,00:00:00.000,2025-04-15 10:03:51.858
false,false,3045,2859,186,63,00:00:30.000,2025-04-15 10:03:57.861
false,false,3061,2875,186,32,00:00:32.000,2025-04-15 10:04:19.881
false,false,3247,3051,196,220,00:00:32.000,2025-04-15 10:08:26.123
false,false,3248,3052,196,251,00:00:31.000,2025-04-15 10:08:27.125
false,false,3253,3056,197,63,00:00:31.000,2025-04-15 10:08:38.136
false,true,3255,3057,198,0,00:00:00.000,2025-04-15 10:08:42.141
false,false,3269,3068,201,444,00:00:32.000,2025-04-15 10:09:00.159
false,true,3286,3085,201,0,00:00:00.000,2025-04-15 10:09:18.177
false,true,3334,3129,205,0,00:00:00.000,2025-04-15 10:10:15.237
false,false,3336,3131,205,64,00:00:31.000,2025-04-15 10:10:19.242
false,true,3340,3135,205,0,00:00:00.000,2025-04-15 10:10:35.262
false,true,3344,3139,205,0,00:00:00.000,2025-04-15 10:10:44.270
false,false,3351,3146,205,219,00:00:30.000,2025-04-15 10:10:52.277
false,false,3375,3169,206,605,00:00:32.000,2025-04-15 10:11:22.305
false,true,3377,3171,206,0,00:00:00.000,2025-04-15 10:11:27.309
false,true,3386,3178,208,0,00:00:00.000,2025-04-15 10:11:43.326
false,true,3455,3245,210,0,00:00:00.000,2025-04-15 10:13:29.439
false,false,3456,3246,210,31,00:00:31.000,2025-04-15 10:13:37.447
false,false,3460,3250,210,158,00:00:31.000,2025-04-15 10:13:41.452
false,false,3464,3254,210,284,00:00:33.000,2025-04-15 10:13:45.454
false,true,3467,3257,210,0,00:00:00.000,2025-04-15 10:13:49.461
false,true,3467,3257,210,0,00:00:00.000,2025-04-15 10:13:51.464
false,false,3469,3258,211,64,00:00:32.000,2025-04-15 10:13:56.471
false,false,3486,3274,212,597,00:00:33.000,2025-04-15 10:14:13.492
false,true,3490,3278,212,0,00:00:00.000,2025-04-15 10:14:20.499
false,true,3512,3298,214,0,00:00:00.000,2025-04-15 10:14:50.529
false,true,3586,3366,220,0,00:00:00.000,2025-04-15 10:16:51.652
false,true,3586,3366,220,0,00:00:00.000,2025-04-15 10:16:52.652
false,false,3613,3392,221,833,00:00:30.000,2025-04-15 10:17:20.683
false,false,3614,3392,222,866,00:00:33.000,2025-04-15 10:17:21.683
false,false,3637,3413,224,1587,00:00:30.000,2025-04-15 10:17:44.707
false,false,3649,3424,225,1960,00:00:30.000,2025-04-15 10:17:56.717
false,false,3657,3432,225,2211,00:00:32.000,2025-04-15 10:18:04.724
false,true,3659,3434,225,0,00:00:00.000,2025-04-15 10:18:12.731
false,false,3668,3442,226,280,00:00:33.000,2025-04-15 10:18:21.742
false,true,3531,3316,215,0,00:00:00.000,2025-04-15 10:15:13.546
false,false,3546,3329,217,163,00:00:33.000,2025-04-15 10:15:43.578
false,false,3574,3354,220,505,00:00:30.000,2025-04-15 10:16:23.623
false,true,3575,3355,220,0,00:00:00.000,2025-04-15 10:16:25.624
false,true,3579,3359,220,0,00:00:00.000,2025-04-15 10:16:36.633
false,false,3671,3445,226,376,00:00:33.000,2025-04-15 10:18:24.745
false,false,3674,3448,226,468,00:00:31.000,2025-04-15 10:18:27.747
false,false,3718,3485,233,505,00:00:30.000,2025-04-15 10:19:29.820
false,false,3723,3490,233,64,00:00:33.000,2025-04-15 10:19:40.830
false,true,3735,3502,233,0,00:00:00.000,2025-04-15 10:19:54.844
false,false,3804,3566,238,64,00:00:32.000,2025-04-15 10:21:55.973
false,false,3810,3572,238,92,00:00:31.000,2025-04-15 10:22:07.986
false,true,3831,3592,239,0,00:00:00.000,2025-04-15 10:22:41.017
false,false,3839,3599,240,251,00:00:30.000,2025-04-15 10:22:49.022
false,true,3860,3616,244,0,00:00:00.000,2025-04-15 10:23:16.052
false,false,3862,3618,244,63,00:00:30.000,2025-04-15 10:23:18.053
false,false,3752,3518,234,540,00:00:33.000,2025-04-15 10:20:15.862
false,false,3797,3560,237,193,00:00:33.000,2025-04-15 10:21:30.946
false,true,3386,3178,208,0,00:00:00.000,2025-04-15 10:11:44.326
false,false,3409,3201,208,353,00:00:33.000,2025-04-15 10:12:14.356
false,false,3422,3213,209,33,00:00:33.000,2025-04-15 10:12:39.388
false,false,3436,3227,209,470,00:00:30.000,2025-04-15 10:12:53.400
false,false,3445,3236,209,252,00:00:32.000,2025-04-15 10:13:14.421
false,false,3893,3648,245,93,00:00:31.000,2025-04-15 10:23:55.093
false,false,3898,3653,245,251,00:00:33.000,2025-04-15 10:24:00.101
false,false,3938,3692,246,319,00:00:31.000,2025-04-15 10:25:04.166
false,true,4019,3769,250,0,00:00:00.000,2025-04-15 10:26:50.274
false,true,4019,3769,250,0,00:00:00.000,2025-04-15 10:26:53.278
false,true,4045,3793,252,0,00:00:00.000,2025-04-15 10:27:28.313
false,true,4055,3803,252,0,00:00:00.000,2025-04-15 10:27:44.326
false,false,4056,3804,252,31,00:00:31.000,2025-04-15 10:27:50.333
false,false,4083,3830,253,693,00:00:31.000,2025-04-15 10:28:23.367
false,false,4325,4061,264,154,00:00:32.000,2025-04-15 10:34:01.742
false,false,4333,4068,265,123,00:00:31.000,2025-04-15 10:34:15.759
false,false,4335,4070,265,61,00:00:30.000,2025-04-15 10:34:29.772
false,false,4349,4084,265,155,00:00:32.000,2025-04-15 10:34:49.791
false,true,4351,4086,265,0,00:00:00.000,2025-04-15 10:34:57.798
false,false,4244,3982,262,221,00:00:30.000,2025-04-15 10:32:04.608
false,false,4246,3984,262,284,00:00:31.000,2025-04-15 10:32:06.611
false,false,4249,3987,262,378,00:00:30.000,2025-04-15 10:32:09.616
false,false,4267,4004,263,505,00:00:31.000,2025-04-15 10:32:33.644
false,false,4274,4011,263,730,00:00:33.000,2025-04-15 10:32:40.652
false,false,4296,4033,263,283,00:00:33.000,2025-04-15 10:33:08.685
false,false,3939,3693,246,349,00:00:30.000,2025-04-15 10:25:05.168
false,false,3947,3701,246,160,00:00:31.000,2025-04-15 10:25:19.179
false,false,3952,3706,246,316,00:00:31.000,2025-04-15 10:25:24.186
false,false,3965,3717,248,31,00:00:31.000,2025-04-15 10:25:43.204
false,false,3967,3719,248,65,00:00:32.000,2025-04-15 10:25:51.213
false,false,3970,3721,249,157,00:00:31.000,2025-04-15 10:25:54.217
false,true,3973,3724,249,0,00:00:00.000,2025-04-15 10:25:58.222
false,false,3984,3735,249,349,00:00:31.000,2025-04-15 10:26:14.240
false,false,3998,3748,250,792,00:00:31.000,2025-04-15 10:26:28.255
false,false,4009,3759,250,1135,00:00:30.000,2025-04-15 10:26:39.266
false,false,4099,3846,253,1193,00:00:31.000,2025-04-15 10:28:39.387
false,false,4105,3852,253,1375,00:00:30.000,2025-04-15 10:28:45.394
false,false,4115,3862,253,1696,00:00:33.000,2025-04-15 10:28:55.404
false,false,4119,3866,253,32,00:00:32.000,2025-04-15 10:29:05.416
false,false,4123,3870,253,162,00:00:31.000,2025-04-15 10:29:09.421
false,false,4124,3871,253,193,00:00:31.000,2025-04-15 10:29:10.421
false,false,4130,3876,254,382,00:00:32.000,2025-04-15 10:29:16.429
false,false,4137,3883,254,605,00:00:31.000,2025-04-15 10:29:23.434
false,true,4164,3909,255,0,00:00:00.000,2025-04-15 10:29:58.466
false,false,4189,3933,256,308,00:00:30.000,2025-04-15 10:30:39.512
false,false,4193,3936,257,32,00:00:32.000,2025-04-15 10:30:49.521
false,true,4201,3944,257,0,00:00:00.000,2025-04-15 10:31:04.537
false,false,4219,3961,258,61,00:00:31.000,2025-04-15 10:31:33.572
false,false,4359,4092,267,252,00:00:30.000,2025-04-15 10:35:05.808
false,false,4390,4121,269,1234,00:00:33.000,2025-04-15 10:35:36.839
false,true,4403,4132,271,0,00:00:00.000,2025-04-15 10:35:54.858
false,true,4416,4145,271,0,00:00:00.000,2025-04-15 10:36:10.874
false,true,4427,4155,272,0,00:00:00.000,2025-04-15 10:36:30.892
false,false,4428,4156,272,30,00:00:30.000,2025-04-15 10:36:32.893
false,false,4436,4163,273,276,00:00:31.000,2025-04-15 10:36:40.902
false,false,4437,4164,273,307,00:00:31.000,2025-04-15 10:36:41.903
false,false,4438,4165,273,340,00:00:33.000,2025-04-15 10:36:42.904
false,true,4619,4336,283,0,00:00:00.000,2025-04-15 10:40:38.138
false,true,4623,4340,283,0,00:00:00.000,2025-04-15 10:40:44.145
false,true,4623,4340,283,0,00:00:00.000,2025-04-15 10:40:48.149
false,true,4645,4360,285,0,00:00:00.000,2025-04-15 10:41:19.181
false,true,4648,4363,285,0,00:00:00.000,2025-04-15 10:41:33.193
false,true,4648,4363,285,0,00:00:00.000,2025-04-15 10:41:37.197
false,false,4443,4170,273,499,00:00:33.000,2025-04-15 10:36:47.908
false,false,4462,4188,274,345,00:00:30.000,2025-04-15 10:37:12.934
false,true,4469,4195,274,0,00:00:00.000,2025-04-15 10:37:24.944
false,false,4481,4206,275,216,00:00:30.000,2025-04-15 10:37:43.965
false,false,4484,4209,275,309,00:00:32.000,2025-04-15 10:37:46.970
false,false,4487,4211,276,401,00:00:31.000,2025-04-15 10:37:49.974
false,false,4500,4223,277,808,00:00:30.000,2025-04-15 10:38:02.984
false,false,4514,4236,278,1255,00:00:32.000,2025-04-15 10:38:16.999
false,false,4516,4238,278,1320,00:00:33.000,2025-04-15 10:38:19.001
false,false,4521,4243,278,1478,00:00:32.000,2025-04-15 10:38:24.007
false,false,4522,4243,279,1509,00:00:31.000,2025-04-15 10:38:25.008
false,false,4525,4246,279,1604,00:00:31.000,2025-04-15 10:38:28.010
false,false,4528,4249,279,1694,00:00:30.000,2025-04-15 10:38:31.014
false,true,4540,4261,279,0,00:00:00.000,2025-04-15 10:38:51.030
false,true,4540,4261,279,0,00:00:00.000,2025-04-15 10:38:55.034
false,false,4541,4262,279,31,00:00:31.000,2025-04-15 10:38:56.036
false,false,4542,4263,279,63,00:00:32.000,2025-04-15 10:38:57.036
false,false,4549,4270,279,283,00:00:32.000,2025-04-15 10:39:04.041
false,false,4577,4297,280,1174,00:00:33.000,2025-04-15 10:39:32.067
false,false,4583,4303,280,1361,00:00:30.000,2025-04-15 10:39:38.073
false,false,4597,4317,280,222,00:00:31.000,2025-04-15 10:39:58.095
false,false,4662,4376,286,442,00:00:31.000,2025-04-15 10:41:51.213
false,false,4688,4400,288,283,00:00:32.000,2025-04-15 10:42:29.246
false,true,4694,4405,289,0,00:00:00.000,2025-04-15 10:42:36.252
false,true,4694,4405,289,0,00:00:00.000,2025-04-15 10:42:38.255
false,true,4701,4412,289,0,00:00:00.000,2025-04-15 10:42:50.267
false,false,4707,4418,289,186,00:00:30.000,2025-04-15 10:43:00.278
false,false,4720,4428,292,594,00:00:31.000,2025-04-15 10:43:13.294
false,false,4733,4441,292,32,00:00:32.000,2025-04-15 10:43:38.318
false,false,4735,4443,292,95,00:00:33.000,2025-04-15 10:43:40.319
false,false,4759,4465,294,845,00:00:31.000,2025-04-15 10:44:04.347
false,false,4763,4469,294,973,00:00:33.000,2025-04-15 10:44:08.352
false,true,4763,4469,294,0,00:00:00.000,2025-04-15 10:44:13.359
false,false,4774,4480,294,125,00:00:31.000,2025-04-15 10:44:31.380
false,true,4776,4482,294,0,00:00:00.000,2025-04-15 10:44:37.386
false,false,4791,4497,294,475,00:00:32.000,2025-04-15 10:44:54.403
false,false,4796,4501,295,633,00:00:33.000,2025-04-15 10:44:59.406
false,false,4837,4541,296,349,00:00:30.000,2025-04-15 10:46:04.466
false,false,4850,4552,298,340,00:00:32.000,2025-04-15 10:46:29.495
false,false,4869,4570,299,561,00:00:31.000,2025-04-15 10:46:54.524
false,false,4874,4575,299,93,00:00:32.000,2025-04-15 10:47:05.538
false,false,4901,4601,300,947,00:00:33.000,2025-04-15 10:47:32.568
false,true,4911,4611,300,0,00:00:00.000,2025-04-15 10:47:45.583
false,true,4911,4611,300,0,00:00:00.000,2025-04-15 10:47:46.583
false,false,4917,4616,301,183,00:00:30.000,2025-04-15 10:47:54.592
false,false,5332,4997,335,915,00:00:32.000,2025-04-15 10:56:56.139
false,false,5342,5007,335,249,00:00:33.000,2025-04-15 10:57:12.152
false,false,5349,5014,335,96,00:00:31.000,2025-04-15 10:57:25.163
false,false,5351,5016,335,156,00:00:30.000,2025-04-15 10:57:27.167
false,false,5361,5025,336,479,00:00:33.000,2025-04-15 10:57:37.177
false,true,5110,4792,318,0,00:00:00.000,2025-04-15 10:52:09.861
false,false,5111,4793,318,31,00:00:31.000,2025-04-15 10:52:14.867
false,true,5115,4797,318,0,00:00:00.000,2025-04-15 10:52:21.875
false,false,5118,4800,318,63,00:00:33.000,2025-04-15 10:52:33.883
false,false,5130,4811,319,434,00:00:30.000,2025-04-15 10:52:45.897
false,false,5136,4816,320,627,00:00:32.000,2025-04-15 10:52:51.905
false,false,1984,1862,122,190,00:00:30.000,2025-04-15 09:39:21.365
false,false,1992,1870,122,97,00:00:33.000,2025-04-15 09:39:41.381
false,false,2019,1896,123,727,00:00:30.000,2025-04-15 09:40:14.418
false,false,2031,1906,125,1105,00:00:31.000,2025-04-15 09:40:26.433
false,true,2035,1910,125,0,00:00:00.000,2025-04-15 09:40:36.440
false,false,2036,1911,125,30,00:00:30.000,2025-04-15 09:40:37.440
false,false,2348,2199,149,573,00:00:32.000,2025-04-15 09:47:49.889
false,false,2352,2203,149,699,00:00:30.000,2025-04-15 09:47:53.894
false,false,2355,2206,149,794,00:00:32.000,2025-04-15 09:47:56.897
false,true,2356,2207,149,0,00:00:00.000,2025-04-15 09:47:58.898
false,true,2362,2213,149,0,00:00:00.000,2025-04-15 09:48:11.912
false,false,2380,2229,151,570,00:00:32.000,2025-04-15 09:48:33.935
false,true,2387,2236,151,0,00:00:00.000,2025-04-15 09:48:43.949
false,false,2392,2241,151,157,00:00:30.000,2025-04-15 09:48:51.955
false,false,2396,2245,151,279,00:00:30.000,2025-04-15 09:48:55.960
false,true,2282,2137,145,0,00:00:00.000,2025-04-15 09:45:48.758
false,true,2298,2152,146,0,00:00:00.000,2025-04-15 09:46:28.797
false,false,2300,2153,147,65,00:00:33.000,2025-04-15 09:46:31.801
false,true,2312,2165,147,0,00:00:00.000,2025-04-15 09:46:52.822
false,false,2321,2174,147,283,00:00:32.000,2025-04-15 09:47:10.838
false,false,2323,2176,147,346,00:00:31.000,2025-04-15 09:47:12.842
false,true,2326,2179,147,0,00:00:00.000,2025-04-15 09:47:17.849
false,true,2242,2102,140,0,00:00:00.000,2025-04-15 09:44:16.670
false,true,2242,2102,140,0,00:00:00.000,2025-04-15 09:44:21.677
false,false,2243,2103,140,30,00:00:30.000,2025-04-15 09:44:22.678
false,false,2246,2106,140,31,00:00:31.000,2025-04-15 09:44:31.686
false,true,2250,2109,141,0,00:00:00.000,2025-04-15 09:44:42.695
false,true,2251,2110,141,0,00:00:00.000,2025-04-15 09:44:51.703
false,false,2253,2112,141,65,00:00:32.000,2025-04-15 09:44:56.708
false,false,2411,2259,152,374,00:00:31.000,2025-04-15 09:49:16.983
false,false,2426,2273,153,844,00:00:32.000,2025-04-15 09:49:31.995
false,false,2434,2281,153,1095,00:00:32.000,2025-04-15 09:49:40.001
false,false,2435,2282,153,1125,00:00:30.000,2025-04-15 09:49:41.003
false,false,2441,2287,154,1317,00:00:33.000,2025-04-15 09:49:47.009
false,false,2453,2298,155,1700,00:00:33.000,2025-04-15 09:49:59.019
false,false,2458,2303,155,1858,00:00:30.000,2025-04-15 09:50:04.024
false,false,2467,2312,155,63,00:00:32.000,2025-04-15 09:50:19.035
false,true,2468,2313,155,0,00:00:00.000,2025-04-15 09:50:29.043
false,true,2470,2315,155,0,00:00:00.000,2025-04-15 09:50:43.060
false,false,2493,2336,157,441,00:00:31.000,2025-04-15 09:51:15.092
false,true,2622,2460,162,0,00:00:00.000,2025-04-15 09:54:13.275
false,false,2647,2483,164,165,00:00:33.000,2025-04-15 09:54:49.307
false,false,2667,2500,167,805,00:00:32.000,2025-04-15 09:55:09.323
false,true,2545,2386,159,0,00:00:00.000,2025-04-15 09:52:28.168
false,false,2553,2394,159,258,00:00:30.000,2025-04-15 09:52:39.180
false,false,2577,2417,160,1007,00:00:31.000,2025-04-15 09:53:03.204
false,true,2581,2421,160,0,00:00:00.000,2025-04-15 09:53:13.217
false,false,2583,2423,160,61,00:00:30.000,2025-04-15 09:53:15.218
false,true,2600,2440,160,0,00:00:00.000,2025-04-15 09:53:34.237
false,false,2609,2448,161,254,00:00:33.000,2025-04-15 09:53:59.262
false,true,2738,2570,168,0,00:00:00.000,2025-04-15 09:57:02.433
false,true,2749,2579,170,0,00:00:00.000,2025-04-15 09:57:25.457
false,false,2752,2582,170,92,00:00:30.000,2025-04-15 09:57:28.461
false,false,2758,2587,171,285,00:00:32.000,2025-04-15 09:57:34.467
false,true,2786,2613,173,0,00:00:00.000,2025-04-15 09:58:14.508
false,false,2790,2617,173,127,00:00:31.000,2025-04-15 09:58:18.510
false,false,2714,2547,167,253,00:00:30.000,2025-04-15 09:56:32.397
false,false,2801,2628,173,462,00:00:30.000,2025-04-15 09:58:29.522
false,false,2808,2634,174,685,00:00:31.000,2025-04-15 09:58:36.528
false,true,2809,2635,174,0,00:00:00.000,2025-04-15 09:58:42.534
false,true,2810,2636,174,0,00:00:00.000,2025-04-15 09:58:49.540
false,false,2826,2652,174,506,00:00:30.000,2025-04-15 09:59:06.554
false,false,2832,2658,174,694,00:00:33.000,2025-04-15 09:59:12.561
false,false,2836,2662,174,826,00:00:33.000,2025-04-15 09:59:16.565
false,false,2840,2666,174,32,00:00:32.000,2025-04-15 09:59:26.577
false,true,2859,2685,174,0,00:00:00.000,2025-04-15 09:59:52.607
false,false,2861,2686,175,63,00:00:32.000,2025-04-15 09:59:59.615
false,false,2863,2688,175,123,00:00:30.000,2025-04-15 10:00:01.617
false,true,2875,2699,176,0,00:00:00.000,2025-04-15 10:00:16.636
false,true,2895,2717,178,0,00:00:00.000,2025-04-15 10:00:40.667
false,true,2895,2717,178,0,00:00:00.000,2025-04-15 10:00:45.672
false,false,2896,2718,178,31,00:00:31.000,2025-04-15 10:00:46.674
false,true,2899,2721,178,0,00:00:00.000,2025-04-15 10:00:54.680
false,false,2926,2745,181,284,00:00:33.000,2025-04-15 10:01:34.724
false,true,3124,2936,188,0,00:00:00.000,2025-04-15 10:05:30.957
false,false,3126,2938,188,63,00:00:31.000,2025-04-15 10:05:36.963
false,false,3129,2941,188,160,00:00:33.000,2025-04-15 10:05:39.967
false,false,3132,2943,189,253,00:00:32.000,2025-04-15 10:05:42.969
false,false,3133,2944,189,285,00:00:32.000,2025-04-15 10:05:43.969
false,false,3149,2957,192,794,00:00:32.000,2025-04-15 10:05:59.982
false,false,3153,2961,192,919,00:00:30.000,2025-04-15 10:06:03.986
false,false,3178,2985,193,32,00:00:32.000,2025-04-15 10:06:41.023
false,true,3211,3016,195,0,00:00:00.000,2025-04-15 10:07:35.076
false,true,3211,3016,195,0,00:00:00.000,2025-04-15 10:07:38.081
false,true,3214,3019,195,0,00:00:00.000,2025-04-15 10:07:45.086
false,false,3235,3040,195,668,00:00:31.000,2025-04-15 10:08:08.106
false,false,2956,2772,184,915,00:00:33.000,2025-04-15 10:02:10.758
false,false,2996,2811,185,2183,00:00:31.000,2025-04-15 10:02:50.800
false,false,3004,2819,185,2434,00:00:32.000,2025-04-15 10:02:58.810
false,false,3050,2864,186,222,00:00:31.000,2025-04-15 10:04:02.863
false,false,3055,2869,186,382,00:00:32.000,2025-04-15 10:04:07.870
false,false,3071,2885,186,350,00:00:31.000,2025-04-15 10:04:29.890
false,false,3073,2887,186,412,00:00:30.000,2025-04-15 10:04:31.892
false,false,3086,2900,186,819,00:00:31.000,2025-04-15 10:04:44.906
false,false,3087,2901,186,850,00:00:31.000,2025-04-15 10:04:45.905
false,true,3094,2907,187,0,00:00:00.000,2025-04-15 10:04:56.921
false,false,3098,2911,187,124,00:00:31.000,2025-04-15 10:05:02.928
false,false,3259,3060,199,127,00:00:32.000,2025-04-15 10:08:50.149
false,false,3299,3097,202,408,00:00:30.000,2025-04-15 10:09:36.196
false,false,3335,3130,205,33,00:00:33.000,2025-04-15 10:10:18.241
false,true,3338,3133,205,0,00:00:00.000,2025-04-15 10:10:27.253
false,false,3354,3149,205,317,00:00:32.000,2025-04-15 10:10:55.280
false,true,3356,3151,205,0,00:00:00.000,2025-04-15 10:11:01.285
false,true,3386,3178,208,0,00:00:00.000,2025-04-15 10:11:41.323
false,false,3458,3248,210,95,00:00:33.000,2025-04-15 10:13:39.450
false,false,3459,3249,210,127,00:00:32.000,2025-04-15 10:13:40.451
false,false,3478,3266,212,348,00:00:33.000,2025-04-15 10:14:05.481
false,false,3487,3275,212,630,00:00:33.000,2025-04-15 10:14:14.493
false,false,3500,3286,214,318,00:00:32.000,2025-04-15 10:14:33.512
false,false,3510,3296,214,627,00:00:30.000,2025-04-15 10:14:43.523
false,false,3588,3368,220,61,00:00:31.000,2025-04-15 10:16:55.656
false,false,3607,3387,220,649,00:00:31.000,2025-04-15 10:17:14.677
false,false,3612,3391,221,803,00:00:33.000,2025-04-15 10:17:19.682
false,false,3631,3408,223,1400,00:00:32.000,2025-04-15 10:17:38.700
false,false,3655,3430,225,2146,00:00:31.000,2025-04-15 10:18:02.722
false,false,3527,3312,215,465,00:00:30.000,2025-04-15 10:15:06.540
false,false,3539,3322,217,94,00:00:31.000,2025-04-15 10:15:30.564
false,false,3541,3324,217,155,00:00:30.000,2025-04-15 10:15:32.567
false,true,3547,3330,217,0,00:00:00.000,2025-04-15 10:15:46.581
false,false,3549,3332,217,63,00:00:31.000,2025-04-15 10:15:52.588
false,false,3568,3349,219,318,00:00:33.000,2025-04-15 10:16:17.616
false,false,3581,3361,220,61,00:00:31.000,2025-04-15 10:16:42.641
false,true,3676,3450,226,0,00:00:00.000,2025-04-15 10:18:30.750
false,false,3702,3471,231,374,00:00:31.000,2025-04-15 10:19:07.794
false,false,3709,3477,232,224,00:00:32.000,2025-04-15 10:19:20.809
false,false,3730,3497,233,286,00:00:31.000,2025-04-15 10:19:47.838
false,false,3800,3562,238,61,00:00:30.000,2025-04-15 10:21:45.965
false,false,3801,3563,238,93,00:00:32.000,2025-04-15 10:21:46.966
false,true,3811,3573,238,0,00:00:00.000,2025-04-15 10:22:10.989
false,true,3831,3592,239,0,00:00:00.000,2025-04-15 10:22:36.013
false,false,3840,3600,240,284,00:00:33.000,2025-04-15 10:22:50.024
false,false,3846,3603,243,468,00:00:30.000,2025-04-15 10:22:56.032
false,false,3850,3606,244,596,00:00:31.000,2025-04-15 10:23:00.034
false,false,3859,3615,244,871,00:00:30.000,2025-04-15 10:23:09.044
false,false,3861,3617,244,33,00:00:33.000,2025-04-15 10:23:17.053
false,false,3866,3622,244,190,00:00:32.000,2025-04-15 10:23:22.057
false,false,3764,3530,234,917,00:00:32.000,2025-04-15 10:20:27.877
false,false,3766,3532,234,979,00:00:32.000,2025-04-15 10:20:29.879
false,false,3404,3196,208,191,00:00:32.000,2025-04-15 10:12:09.351
false,false,3411,3203,208,416,00:00:31.000,2025-04-15 10:12:16.359
false,true,3415,3207,208,0,00:00:00.000,2025-04-15 10:12:25.369
false,false,3426,3217,209,156,00:00:31.000,2025-04-15 10:12:43.392
false,false,3432,3223,209,348,00:00:31.000,2025-04-15 10:12:49.395
false,false,3441,3232,209,123,00:00:30.000,2025-04-15 10:13:10.417
false,false,3879,3634,245,596,00:00:32.000,2025-04-15 10:23:35.069
false,false,3887,3642,245,851,00:00:33.000,2025-04-15 10:23:43.078
false,true,3890,3645,245,0,00:00:00.000,2025-04-15 10:23:52.089
false,false,3905,3660,245,470,00:00:33.000,2025-04-15 10:24:07.109
false,false,3909,3664,245,129,00:00:31.000,2025-04-15 10:24:17.121
false,false,3911,3666,245,194,00:00:32.000,2025-04-15 10:24:19.122
false,false,4043,3791,252,190,00:00:31.000,2025-04-15 10:27:25.308
false,true,4045,3793,252,0,00:00:00.000,2025-04-15 10:27:29.313
false,false,4052,3800,252,220,00:00:32.000,2025-04-15 10:27:40.323
false,false,4060,3808,252,157,00:00:32.000,2025-04-15 10:27:54.337
false,true,4061,3809,252,0,00:00:00.000,2025-04-15 10:28:00.342
false,false,4064,3812,252,94,00:00:33.000,2025-04-15 10:28:04.348
false,false,4073,3821,252,383,00:00:32.000,2025-04-15 10:28:13.356
false,false,4319,4056,263,222,00:00:32.000,2025-04-15 10:33:49.729
false,true,4320,4057,263,0,00:00:00.000,2025-04-15 10:33:52.732
false,true,4320,4057,263,0,00:00:00.000,2025-04-15 10:33:56.736
false,true,4344,4079,265,0,00:00:00.000,2025-04-15 10:34:44.788
false,true,4237,3977,260,0,00:00:00.000,2025-04-15 10:31:54.596
false,true,4237,3977,260,0,00:00:00.000,2025-04-15 10:31:56.599
false,true,4287,4024,263,0,00:00:00.000,2025-04-15 10:32:56.671
false,false,4291,4028,263,129,00:00:33.000,2025-04-15 10:33:03.680
false,false,4300,4037,263,408,00:00:30.000,2025-04-15 10:33:12.691
false,true,3942,3696,246,0,00:00:00.000,2025-04-15 10:25:11.174
false,false,3948,3702,246,193,00:00:33.000,2025-04-15 10:25:20.180
false,false,3962,3715,247,631,00:00:31.000,2025-04-15 10:25:34.193
false,true,3973,3724,249,0,00:00:00.000,2025-04-15 10:26:01.225
false,false,3992,3743,249,603,00:00:32.000,2025-04-15 10:26:22.247
false,false,4003,3753,250,949,00:00:30.000,2025-04-15 10:26:33.258
false,false,4008,3758,250,1105,00:00:32.000,2025-04-15 10:26:38.266
false,false,4091,3838,253,943,00:00:33.000,2025-04-15 10:28:31.377
false,true,4118,3865,253,0,00:00:00.000,2025-04-15 10:28:59.409
false,false,4128,3874,254,319,00:00:32.000,2025-04-15 10:29:14.427
false,true,4164,3909,255,0,00:00:00.000,2025-04-15 10:30:02.471
false,false,4165,3910,255,30,00:00:30.000,2025-04-15 10:30:03.471
false,false,4200,3943,257,191,00:00:33.000,2025-04-15 10:31:02.534
false,false,4212,3954,258,346,00:00:30.000,2025-04-15 10:31:20.556
false,false,4217,3959,258,503,00:00:33.000,2025-04-15 10:31:25.563
false,false,4223,3964,259,184,00:00:31.000,2025-04-15 10:31:37.577
false,false,4387,4118,269,1137,00:00:33.000,2025-04-15 10:35:33.834
false,false,4389,4120,269,1201,00:00:31.000,2025-04-15 10:35:35.837
false,false,4393,4124,269,1328,00:00:32.000,2025-04-15 10:35:39.843
false,false,4403,4132,271,1635,00:00:31.000,2025-04-15 10:35:49.853
false,true,4403,4132,271,0,00:00:00.000,2025-04-15 10:35:50.855
false,false,4421,4149,272,154,00:00:30.000,2025-04-15 10:36:19.881
false,true,4618,4335,283,0,00:00:00.000,2025-04-15 10:40:28.129
false,true,4619,4336,283,0,00:00:00.000,2025-04-15 10:40:33.132
false,false,4627,4344,283,130,00:00:33.000,2025-04-15 10:40:52.153
false,false,4642,4358,284,160,00:00:33.000,2025-04-15 10:41:13.176
false,true,4645,4360,285,0,00:00:00.000,2025-04-15 10:41:17.180
false,true,4645,4360,285,0,00:00:00.000,2025-04-15 10:41:28.187
false,true,4451,4177,274,0,00:00:00.000,2025-04-15 10:37:00.922
false,true,4451,4177,274,0,00:00:00.000,2025-04-15 10:37:01.923
false,false,4473,4199,274,127,00:00:31.000,2025-04-15 10:37:29.948
false,false,4477,4202,275,92,00:00:32.000,2025-04-15 10:37:39.959
false,false,4496,4220,276,683,00:00:33.000,2025-04-15 10:37:58.982
false,false,4505,4228,277,969,00:00:32.000,2025-04-15 10:38:07.989
false,false,4512,4234,278,1190,00:00:31.000,2025-04-15 10:38:14.997
false,false,4515,4237,278,1287,00:00:32.000,2025-04-15 10:38:18.000
false,false,4568,4289,279,889,00:00:31.000,2025-04-15 10:39:23.060
false,false,4579,4299,280,1234,00:00:30.000,2025-04-15 10:39:34.068
false,false,4595,4315,280,159,00:00:33.000,2025-04-15 10:39:56.094
false,false,4596,4316,280,191,00:00:32.000,2025-04-15 10:39:57.094
false,false,4661,4375,286,411,00:00:31.000,2025-04-15 10:41:50.212
false,true,4665,4379,286,0,00:00:00.000,2025-04-15 10:41:58.223
false,false,4674,4388,286,277,00:00:33.000,2025-04-15 10:42:09.230
false,false,4687,4399,288,251,00:00:32.000,2025-04-15 10:42:28.245
false,false,4712,4421,291,346,00:00:32.000,2025-04-15 10:43:05.285
false,true,4724,4432,292,0,00:00:00.000,2025-04-15 10:43:18.297
false,false,4729,4437,292,162,00:00:33.000,2025-04-15 10:43:28.307
false,false,4746,4453,293,442,00:00:32.000,2025-04-15 10:43:51.333
false,false,4762,4468,294,940,00:00:31.000,2025-04-15 10:44:07.351
false,true,4770,4476,294,0,00:00:00.000,2025-04-15 10:44:25.373
false,false,4775,4481,294,157,00:00:32.000,2025-04-15 10:44:32.381
false,false,4808,4513,295,62,00:00:32.000,2025-04-15 10:45:17.424
false,false,4809,4514,295,93,00:00:31.000,2025-04-15 10:45:18.424
false,false,4821,4526,295,222,00:00:32.000,2025-04-15 10:45:36.439
false,true,4825,4530,295,0,00:00:00.000,2025-04-15 10:45:44.445
false,true,4826,4531,295,0,00:00:00.000,2025-04-15 10:45:49.450
false,false,4846,4549,297,216,00:00:31.000,2025-04-15 10:46:25.489
false,false,4855,4557,298,124,00:00:30.000,2025-04-15 10:46:40.509
false,false,4863,4565,298,375,00:00:32.000,2025-04-15 10:46:48.516
false,false,4879,4580,299,253,00:00:32.000,2025-04-15 10:47:10.543
false,true,4911,4611,300,0,00:00:00.000,2025-04-15 10:47:44.583
false,true,4935,4631,304,0,00:00:00.000,2025-04-15 10:48:15.614
false,true,4935,4631,304,0,00:00:00.000,2025-04-15 10:48:16.616
false,true,5334,4999,335,0,00:00:00.000,2025-04-15 10:56:59.141
false,false,5344,5009,335,312,00:00:31.000,2025-04-15 10:57:14.153
false,false,5346,5011,335,374,00:00:32.000,2025-04-15 10:57:16.154
false,false,5353,5018,335,222,00:00:33.000,2025-04-15 10:57:29.169
false,true,5364,5028,336,0,00:00:00.000,2025-04-15 10:57:42.181
false,false,5367,5030,337,95,00:00:33.000,2025-04-15 10:57:49.187
false,false,5384,5046,338,639,00:00:31.000,2025-04-15 10:58:06.204
false,false,5391,5052,339,860,00:00:31.000,2025-04-15 10:58:13.208
false,true,5116,4798,318,0,00:00:00.000,2025-04-15 10:52:29.881
false,false,5132,4812,320,499,00:00:32.000,2025-04-15 10:52:47.899
false,false,5138,4818,320,689,00:00:31.000,2025-04-15 10:52:53.906
false,false,1979,1858,121,33,00:00:33.000,2025-04-15 09:39:16.362
false,false,2029,1904,125,1042,00:00:30.000,2025-04-15 09:40:24.429
false,true,2035,1910,125,0,00:00:00.000,2025-04-15 09:40:34.439
false,false,2328,2181,147,63,00:00:30.000,2025-04-15 09:47:23.858
false,true,2330,2183,147,0,00:00:00.000,2025-04-15 09:47:29.864
false,false,2360,2211,149,123,00:00:30.000,2025-04-15 09:48:07.908
false,false,2362,2213,149,186,00:00:33.000,2025-04-15 09:48:09.910
false,false,2365,2216,149,96,00:00:33.000,2025-04-15 09:48:18.919
false,false,2366,2217,149,128,00:00:32.000,2025-04-15 09:48:19.921
false,false,2374,2224,150,383,00:00:30.000,2025-04-15 09:48:27.929
false,false,2391,2240,151,127,00:00:31.000,2025-04-15 09:48:50.955
false,false,2393,2242,151,188,00:00:31.000,2025-04-15 09:48:52.956
false,true,2294,2148,146,0,00:00:00.000,2025-04-15 09:46:17.790
false,false,2311,2164,147,31,00:00:31.000,2025-04-15 09:46:48.818
false,true,2245,2105,140,0,00:00:00.000,2025-04-15 09:44:28.684
false,true,2250,2109,141,0,00:00:00.000,2025-04-15 09:44:45.698
false,false,2270,2127,143,192,00:00:33.000,2025-04-15 09:45:25.740
false,false,2280,2136,144,510,00:00:30.000,2025-04-15 09:45:35.747
false,true,2399,2248,151,0,00:00:00.000,2025-04-15 09:49:03.970
false,false,2425,2272,153,812,00:00:31.000,2025-04-15 09:49:30.995
false,false,2449,2294,155,1570,00:00:31.000,2025-04-15 09:49:55.016
false,true,2470,2315,155,0,00:00:00.000,2025-04-15 09:50:36.053
false,true,2470,2315,155,0,00:00:00.000,2025-04-15 09:50:38.055
false,true,2479,2322,157,0,00:00:00.000,2025-04-15 09:51:01.081
false,false,2485,2328,157,190,00:00:33.000,2025-04-15 09:51:07.087
false,false,2496,2339,157,535,00:00:31.000,2025-04-15 09:51:18.095
false,true,2505,2348,157,0,00:00:00.000,2025-04-15 09:51:30.107
false,true,2514,2356,158,0,00:00:00.000,2025-04-15 09:51:45.125
false,true,2539,2380,159,0,00:00:00.000,2025-04-15 09:52:15.155
false,false,2542,2383,159,96,00:00:31.000,2025-04-15 09:52:22.161
false,false,2627,2465,162,160,00:00:33.000,2025-04-15 09:54:23.284
false,false,2657,2491,166,485,00:00:33.000,2025-04-15 09:54:59.315
false,false,2662,2495,167,645,00:00:33.000,2025-04-15 09:55:04.319
false,false,2665,2498,167,741,00:00:33.000,2025-04-15 09:55:07.321
false,false,2675,2508,167,92,00:00:31.000,2025-04-15 09:55:35.347
false,false,2676,2509,167,124,00:00:32.000,2025-04-15 09:55:36.348
false,true,2676,2509,167,0,00:00:00.000,2025-04-15 09:55:42.356
false,false,2586,2426,160,158,00:00:33.000,2025-04-15 09:53:18.222
false,false,2590,2430,160,286,00:00:32.000,2025-04-15 09:53:22.226
false,false,2593,2433,160,379,00:00:31.000,2025-04-15 09:53:25.229
false,true,2601,2441,160,0,00:00:00.000,2025-04-15 09:53:49.253
false,false,2730,2563,167,756,00:00:30.000,2025-04-15 09:56:48.414
false,true,2738,2570,168,0,00:00:00.000,2025-04-15 09:56:59.429
false,true,2740,2572,168,0,00:00:00.000,2025-04-15 09:57:05.437
false,true,2740,2572,168,0,00:00:00.000,2025-04-15 09:57:06.438
false,false,2757,2586,171,253,00:00:33.000,2025-04-15 09:57:33.466
false,false,2764,2593,171,188,00:00:33.000,2025-04-15 09:57:46.478
false,false,2768,2597,171,316,00:00:30.000,2025-04-15 09:57:50.485
false,false,2771,2600,171,408,00:00:32.000,2025-04-15 09:57:53.489
false,false,2794,2621,173,250,00:00:30.000,2025-04-15 09:58:22.513
false,false,2800,2627,173,432,00:00:31.000,2025-04-15 09:58:28.520
false,false,2809,2635,174,717,00:00:32.000,2025-04-15 09:58:37.529
false,true,2809,2635,174,0,00:00:00.000,2025-04-15 09:58:39.532
false,true,2809,2635,174,0,00:00:00.000,2025-04-15 09:58:41.533
false,false,2825,2651,174,476,00:00:32.000,2025-04-15 09:59:05.554
false,false,2833,2659,174,727,00:00:33.000,2025-04-15 09:59:13.563
false,true,2839,2665,174,0,00:00:00.000,2025-04-15 09:59:23.576
false,false,2848,2674,174,290,00:00:33.000,2025-04-15 09:59:34.586
false,false,2872,2696,176,412,00:00:31.000,2025-04-15 10:00:10.628
false,true,2911,2731,180,0,00:00:00.000,2025-04-15 10:01:10.697
false,false,2917,2736,181,189,00:00:32.000,2025-04-15 10:01:19.708
false,false,3122,2934,188,873,00:00:32.000,2025-04-15 10:05:26.953
false,false,3130,2942,188,191,00:00:31.000,2025-04-15 10:05:40.968
false,false,3137,2947,190,414,00:00:32.000,2025-04-15 10:05:47.972
false,false,3160,2968,192,64,00:00:32.000,2025-04-15 10:06:17.000
false,false,3162,2970,192,130,00:00:33.000,2025-04-15 10:06:19.001
false,false,3186,2992,194,283,00:00:33.000,2025-04-15 10:06:49.029
false,true,3214,3019,195,0,00:00:00.000,2025-04-15 10:07:46.087
false,false,3218,3023,195,127,00:00:31.000,2025-04-15 10:07:51.090
false,false,3224,3029,195,314,00:00:30.000,2025-04-15 10:07:57.095
false,false,3229,3034,195,477,00:00:32.000,2025-04-15 10:08:02.100
false,true,3240,3044,196,0,00:00:00.000,2025-04-15 10:08:15.113
false,false,3244,3048,196,128,00:00:33.000,2025-04-15 10:08:23.119
false,false,3008,2823,185,2559,00:00:33.000,2025-04-15 10:03:02.814
false,true,3015,2830,185,0,00:00:00.000,2025-04-15 10:03:13.825
false,false,3029,2843,186,439,00:00:32.000,2025-04-15 10:03:29.842
false,false,3036,2850,186,32,00:00:32.000,2025-04-15 10:03:42.851
false,false,3040,2854,186,159,00:00:31.000,2025-04-15 10:03:46.854
false,false,3063,2877,186,95,00:00:31.000,2025-04-15 10:04:21.883
false,false,3090,2903,187,945,00:00:31.000,2025-04-15 10:04:48.909
false,false,3091,2904,187,976,00:00:31.000,2025-04-15 10:04:49.911
false,true,3094,2907,187,0,00:00:00.000,2025-04-15 10:04:55.919
false,false,3096,2909,187,63,00:00:30.000,2025-04-15 10:05:00.925
false,true,3251,3054,197,0,00:00:00.000,2025-04-15 10:08:35.133
false,false,3256,3058,198,31,00:00:31.000,2025-04-15 10:08:47.146
false,false,3262,3062,200,223,00:00:33.000,2025-04-15 10:08:53.152
false,false,3277,3076,201,700,00:00:31.000,2025-04-15 10:09:08.168
false,false,3297,3095,202,348,00:00:30.000,2025-04-15 10:09:34.195
false,false,3301,3099,202,472,00:00:33.000,2025-04-15 10:09:38.198
false,false,3316,3113,203,945,00:00:33.000,2025-04-15 10:09:53.213
false,false,3326,3123,203,1257,00:00:30.000,2025-04-15 10:10:03.223
false,false,3327,3124,203,1288,00:00:31.000,2025-04-15 10:10:04.224
false,true,3334,3129,205,0,00:00:00.000,2025-04-15 10:10:12.234
false,true,3334,3129,205,0,00:00:00.000,2025-04-15 10:10:13.234
false,false,3341,3136,205,32,00:00:32.000,2025-04-15 10:10:36.263
false,true,3356,3151,205,0,00:00:00.000,2025-04-15 10:10:58.283
false,false,3359,3154,205,95,00:00:32.000,2025-04-15 10:11:06.291
false,true,3377,3171,206,0,00:00:00.000,2025-04-15 10:11:25.307
false,false,3467,3257,210,381,00:00:32.000,2025-04-15 10:13:48.459
false,true,3467,3257,210,0,00:00:00.000,2025-04-15 10:13:52.465
false,true,3467,3257,210,0,00:00:00.000,2025-04-15 10:13:53.467
false,false,3474,3263,211,220,00:00:31.000,2025-04-15 10:14:01.477
false,false,3480,3268,212,411,00:00:32.000,2025-04-15 10:14:07.483
false,false,3488,3276,212,661,00:00:31.000,2025-04-15 10:14:15.493
false,true,3490,3278,212,0,00:00:00.000,2025-04-15 10:14:22.499
false,false,3509,3295,214,597,00:00:30.000,2025-04-15 10:14:42.523
false,false,3521,3306,215,284,00:00:33.000,2025-04-15 10:15:00.536
false,false,3610,3389,221,740,00:00:30.000,2025-04-15 10:17:17.681
false,false,3626,3403,223,1243,00:00:31.000,2025-04-15 10:17:33.695
false,true,3531,3316,215,0,00:00:00.000,2025-04-15 10:15:14.548
false,false,3533,3318,215,64,00:00:31.000,2025-04-15 10:15:18.554
false,false,3550,3333,217,95,00:00:32.000,2025-04-15 10:15:53.589
false,false,3552,3335,217,160,00:00:33.000,2025-04-15 10:15:55.590
false,false,3566,3348,218,253,00:00:32.000,2025-04-15 10:16:15.613
false,false,3688,3460,228,376,00:00:31.000,2025-04-15 10:18:47.769
false,true,3702,3471,231,0,00:00:00.000,2025-04-15 10:19:13.801
false,true,3721,3488,233,0,00:00:00.000,2025-04-15 10:19:33.822
false,true,3721,3488,233,0,00:00:00.000,2025-04-15 10:19:34.823
false,false,3803,3565,238,32,00:00:32.000,2025-04-15 10:21:54.971
false,false,3807,3569,238,156,00:00:30.000,2025-04-15 10:21:58.975
false,true,3807,3569,238,0,00:00:00.000,2025-04-15 10:22:00.977
false,false,3819,3581,238,253,00:00:33.000,2025-04-15 10:22:23.001
false,false,3826,3588,238,480,00:00:32.000,2025-04-15 10:22:30.007
false,true,3831,3592,239,0,00:00:00.000,2025-04-15 10:22:37.014
false,true,3860,3616,244,0,00:00:00.000,2025-04-15 10:23:13.049
false,false,3744,3510,234,286,00:00:30.000,2025-04-15 10:20:07.855
false,false,3748,3514,234,412,00:00:32.000,2025-04-15 10:20:11.859
false,false,3761,3527,234,822,00:00:32.000,2025-04-15 10:20:24.874
false,false,3762,3528,234,852,00:00:30.000,2025-04-15 10:20:25.875
false,false,3783,3546,237,61,00:00:30.000,2025-04-15 10:20:58.915
false,true,3797,3560,237,0,00:00:00.000,2025-04-15 10:21:33.950
false,true,3798,3561,237,0,00:00:00.000,2025-04-15 10:21:43.962
false,false,3433,3224,209,380,00:00:32.000,2025-04-15 10:12:50.397
false,false,3440,3231,209,93,00:00:30.000,2025-04-15 10:13:09.415
false,false,3442,3233,209,155,00:00:32.000,2025-04-15 10:13:11.418
false,false,3872,3628,244,375,00:00:30.000,2025-04-15 10:23:28.063
false,false,3896,3651,245,188,00:00:33.000,2025-04-15 10:23:58.098
false,true,3905,3660,245,0,00:00:00.000,2025-04-15 10:24:11.115
false,false,3913,3668,245,255,00:00:30.000,2025-04-15 10:24:21.124
false,true,3917,3672,245,0,00:00:00.000,2025-04-15 10:24:33.134
false,false,3918,3673,245,30,00:00:30.000,2025-04-15 10:24:38.140
false,false,4023,3773,250,123,00:00:30.000,2025-04-15 10:26:59.283
false,false,4031,3779,252,375,00:00:33.000,2025-04-15 10:27:07.289
false,true,4037,3785,252,0,00:00:00.000,2025-04-15 10:27:16.298
false,true,4037,3785,252,0,00:00:00.000,2025-04-15 10:27:17.300
false,false,4314,4051,263,64,00:00:32.000,2025-04-15 10:33:44.721
false,true,4320,4057,263,0,00:00:00.000,2025-04-15 10:33:53.733
false,false,4326,4062,264,187,00:00:33.000,2025-04-15 10:34:02.743
false,true,4333,4068,265,0,00:00:00.000,2025-04-15 10:34:27.770
false,false,4336,4071,265,94,00:00:33.000,2025-04-15 10:34:30.772
false,true,4344,4079,265,0,00:00:00.000,2025-04-15 10:34:42.787
false,false,4345,4080,265,30,00:00:30.000,2025-04-15 10:34:45.789
false,false,4231,3972,259,436,00:00:31.000,2025-04-15 10:31:45.585
false,false,4284,4021,263,1047,00:00:30.000,2025-04-15 10:32:50.665
false,false,4288,4025,263,30,00:00:30.000,2025-04-15 10:33:00.676
false,false,4293,4030,263,189,00:00:30.000,2025-04-15 10:33:05.682
false,false,4295,4032,263,250,00:00:31.000,2025-04-15 10:33:07.685
false,false,3964,3717,247,691,00:00:30.000,2025-04-15 10:25:36.196
false,false,3972,3723,249,218,00:00:31.000,2025-04-15 10:25:56.220
false,false,4012,3762,250,1231,00:00:33.000,2025-04-15 10:26:42.267
false,false,4087,3834,253,817,00:00:32.000,2025-04-15 10:28:27.373
false,false,4094,3841,253,1037,00:00:30.000,2025-04-15 10:28:34.381
false,false,4104,3851,253,1345,00:00:31.000,2025-04-15 10:28:44.393
false,false,4106,3853,253,1408,00:00:33.000,2025-04-15 10:28:46.394
false,false,4108,3855,253,1470,00:00:31.000,2025-04-15 10:28:48.397
false,false,4141,3887,254,732,00:00:32.000,2025-04-15 10:29:27.436
false,true,4142,3888,254,0,00:00:00.000,2025-04-15 10:29:29.437
false,true,4142,3888,254,0,00:00:00.000,2025-04-15 10:29:33.441
false,false,4172,3917,255,253,00:00:33.000,2025-04-15 10:30:10.478
false,false,4173,3918,255,286,00:00:33.000,2025-04-15 10:30:11.479
false,false,4175,3920,255,31,00:00:31.000,2025-04-15 10:30:19.490
false,true,4192,3935,257,0,00:00:00.000,2025-04-15 10:30:46.519
false,true,4194,3937,257,0,00:00:00.000,2025-04-15 10:30:51.523
false,true,4201,3944,257,0,00:00:00.000,2025-04-15 10:31:07.541
false,false,4204,3947,257,95,00:00:32.000,2025-04-15 10:31:12.547
false,false,4206,3948,258,159,00:00:31.000,2025-04-15 10:31:14.549
false,true,4217,3959,258,0,00:00:00.000,2025-04-15 10:31:26.564
false,false,4370,4102,268,600,00:00:30.000,2025-04-15 10:35:16.817
false,false,4377,4108,269,820,00:00:31.000,2025-04-15 10:35:23.826
false,false,4394,4125,269,1361,00:00:33.000,2025-04-15 10:35:40.844
false,false,4397,4128,269,1452,00:00:30.000,2025-04-15 10:35:43.846
false,true,4403,4132,271,0,00:00:00.000,2025-04-15 10:35:51.856
false,false,4404,4133,271,33,00:00:33.000,2025-04-15 10:35:56.862
false,false,4405,4134,271,64,00:00:31.000,2025-04-15 10:35:57.862
false,true,4416,4145,271,0,00:00:00.000,2025-04-15 10:36:12.876
false,true,4427,4155,272,0,00:00:00.000,2025-04-15 10:36:27.890
false,true,4427,4155,272,0,00:00:00.000,2025-04-15 10:36:29.891
false,true,4619,4336,283,0,00:00:00.000,2025-04-15 10:40:37.137
false,false,4652,4367,285,128,00:00:32.000,2025-04-15 10:41:41.203
false,false,4450,4177,273,716,00:00:30.000,2025-04-15 10:36:54.916
false,true,4451,4177,274,0,00:00:00.000,2025-04-15 10:36:56.919
false,false,4472,4198,274,96,00:00:33.000,2025-04-15 10:37:28.947
false,true,4474,4199,275,0,00:00:00.000,2025-04-15 10:37:34.953
false,false,4498,4222,276,747,00:00:32.000,2025-04-15 10:38:00.984
false,false,4531,4252,279,1789,00:00:31.000,2025-04-15 10:38:34.016
false,false,4551,4272,279,347,00:00:33.000,2025-04-15 10:39:06.041
false,false,4559,4280,279,601,00:00:33.000,2025-04-15 10:39:14.050
false,false,4580,4300,280,1267,00:00:33.000,2025-04-15 10:39:35.069
false,false,4590,4310,280,1582,00:00:31.000,2025-04-15 10:39:45.079
false,false,4659,4373,286,347,00:00:31.000,2025-04-15 10:41:48.210
false,false,4679,4393,286,434,00:00:30.000,2025-04-15 10:42:14.234
false,true,4679,4393,286,0,00:00:00.000,2025-04-15 10:42:15.234
false,false,4692,4403,289,412,00:00:30.000,2025-04-15 10:42:33.247
false,false,4697,4408,289,94,00:00:33.000,2025-04-15 10:42:44.259
false,false,4699,4410,289,156,00:00:30.000,2025-04-15 10:42:46.261
false,true,4763,4469,294,0,00:00:00.000,2025-04-15 10:44:14.360
false,false,4787,4493,294,346,00:00:31.000,2025-04-15 10:44:50.398
false,false,4805,4510,295,915,00:00:32.000,2025-04-15 10:45:08.417
false,true,4814,4519,295,0,00:00:00.000,2025-04-15 10:45:26.429
false,true,4814,4519,295,0,00:00:00.000,2025-04-15 10:45:27.430
false,false,4823,4528,295,286,00:00:31.000,2025-04-15 10:45:38.441
false,false,4826,4531,295,32,00:00:32.000,2025-04-15 10:45:47.449
false,false,4841,4544,297,63,00:00:31.000,2025-04-15 10:46:20.483
false,false,4843,4546,297,125,00:00:30.000,2025-04-15 10:46:22.485
false,false,4853,4555,298,63,00:00:31.000,2025-04-15 10:46:38.507
false,false,4897,4597,300,821,00:00:31.000,2025-04-15 10:47:28.564
false,false,4910,4610,300,1226,00:00:31.000,2025-04-15 10:47:41.579
false,false,4914,4613,301,93,00:00:30.000,2025-04-15 10:47:51.588
false,false,4918,4617,301,216,00:00:33.000,2025-04-15 10:47:55.593
false,false,4921,4620,301,310,00:00:33.000,2025-04-15 10:47:58.596
false,true,4935,4631,304,0,00:00:00.000,2025-04-15 10:48:14.614
false,true,4935,4631,304,0,00:00:00.000,2025-04-15 10:48:17.616
false,false,5337,5002,335,94,00:00:30.000,2025-04-15 10:57:07.149
false,true,5346,5011,335,0,00:00:00.000,2025-04-15 10:57:17.155
false,true,5364,5028,336,0,00:00:00.000,2025-04-15 10:57:45.183
false,false,5370,5033,337,191,00:00:33.000,2025-04-15 10:57:52.189
false,false,5371,5033,338,223,00:00:32.000,2025-04-15 10:57:53.190
false,false,5396,5057,339,1024,00:00:33.000,2025-04-15 10:58:18.212
false,false,5401,5061,340,1179,00:00:30.000,2025-04-15 10:58:23.216
false,false,5096,4780,316,409,00:00:31.000,2025-04-15 10:51:53.849
false,true,5116,4798,318,0,00:00:00.000,2025-04-15 10:52:30.881
false,false,2229,2090,139,4362,00:00:33.000,2025-04-15 09:44:02.657
false,false,1983,1861,122,160,00:00:32.000,2025-04-15 09:39:20.364
false,true,1988,1866,122,0,00:00:00.000,2025-04-15 09:39:28.369
false,false,1989,1867,122,30,00:00:30.000,2025-04-15 09:39:32.375
false,true,1989,1867,122,0,00:00:00.000,2025-04-15 09:39:34.375
false,true,1989,1867,122,0,00:00:00.000,2025-04-15 09:39:37.377
false,false,2002,1880,122,190,00:00:31.000,2025-04-15 09:39:57.398
false,false,2021,1898,123,790,00:00:31.000,2025-04-15 09:40:16.420
false,false,2032,1907,125,1136,00:00:31.000,2025-04-15 09:40:27.434
false,false,2335,2188,147,160,00:00:33.000,2025-04-15 09:47:36.872
false,false,2337,2190,147,220,00:00:30.000,2025-04-15 09:47:38.875
false,false,2346,2197,149,510,00:00:33.000,2025-04-15 09:47:47.886
false,true,2356,2207,149,0,00:00:00.000,2025-04-15 09:48:00.900
false,true,2356,2207,149,0,00:00:00.000,2025-04-15 09:48:02.902
false,false,2283,2138,145,33,00:00:33.000,2025-04-15 09:45:50.759
false,false,2289,2144,145,224,00:00:33.000,2025-04-15 09:45:56.768
false,false,2293,2147,146,63,00:00:31.000,2025-04-15 09:46:12.787
false,false,2307,2160,147,286,00:00:30.000,2025-04-15 09:46:38.808
false,true,2312,2165,147,0,00:00:00.000,2025-04-15 09:46:55.824
false,true,2326,2179,147,0,00:00:00.000,2025-04-15 09:47:21.854
false,false,2327,2180,147,33,00:00:33.000,2025-04-15 09:47:22.856
false,false,2240,2100,140,4708,00:00:33.000,2025-04-15 09:44:13.669
false,true,2242,2102,140,0,00:00:00.000,2025-04-15 09:44:20.676
false,true,2264,2122,142,0,00:00:00.000,2025-04-15 09:45:14.727
false,true,2264,2122,142,0,00:00:00.000,2025-04-15 09:45:17.729
false,true,2264,2122,142,0,00:00:00.000,2025-04-15 09:45:18.731
false,true,2264,2122,142,0,00:00:00.000,2025-04-15 09:45:19.732
false,false,2273,2130,143,289,00:00:33.000,2025-04-15 09:45:28.743
false,false,2446,2291,155,1475,00:00:30.000,2025-04-15 09:49:52.014
false,true,2470,2315,155,0,00:00:00.000,2025-04-15 09:50:40.057
false,true,2470,2315,155,0,00:00:00.000,2025-04-15 09:50:41.058
false,false,2482,2325,157,94,00:00:32.000,2025-04-15 09:51:04.083
false,false,2484,2327,157,157,00:00:33.000,2025-04-15 09:51:06.085
false,false,2508,2351,157,90,00:00:30.000,2025-04-15 09:51:36.113
false,false,2513,2355,158,243,00:00:30.000,2025-04-15 09:51:41.120
false,true,2539,2380,159,0,00:00:00.000,2025-04-15 09:52:16.156
false,false,2642,2478,164,640,00:00:31.000,2025-04-15 09:54:38.296
false,true,2671,2504,167,0,00:00:00.000,2025-04-15 09:55:14.328
false,true,2672,2505,167,0,00:00:00.000,2025-04-15 09:55:28.339
false,true,2676,2509,167,0,00:00:00.000,2025-04-15 09:55:39.352
false,false,2677,2510,167,33,00:00:33.000,2025-04-15 09:55:43.357
false,false,2555,2396,159,321,00:00:33.000,2025-04-15 09:52:41.182
false,true,2581,2421,160,0,00:00:00.000,2025-04-15 09:53:10.214
false,false,2597,2437,160,506,00:00:33.000,2025-04-15 09:53:29.233
false,false,2603,2443,160,63,00:00:32.000,2025-04-15 09:53:53.256
false,true,2738,2570,168,0,00:00:00.000,2025-04-15 09:56:58.428
false,false,2748,2579,169,253,00:00:30.000,2025-04-15 09:57:18.450
false,false,2754,2584,170,155,00:00:30.000,2025-04-15 09:57:30.464
false,true,2758,2587,171,0,00:00:00.000,2025-04-15 09:57:40.473
false,false,2803,2630,173,524,00:00:31.000,2025-04-15 09:58:31.523
false,true,2810,2636,174,0,00:00:00.000,2025-04-15 09:58:50.540
false,false,2819,2645,174,289,00:00:32.000,2025-04-15 09:58:59.548
false,true,2859,2685,174,0,00:00:00.000,2025-04-15 09:59:53.608
false,false,2875,2699,176,508,00:00:30.000,2025-04-15 10:00:13.631
false,true,2917,2736,181,0,00:00:00.000,2025-04-15 10:01:21.709
false,false,2924,2743,181,218,00:00:32.000,2025-04-15 10:01:32.722
false,false,3115,2927,188,653,00:00:30.000,2025-04-15 10:05:19.947
false,true,3158,2966,192,0,00:00:00.000,2025-04-15 10:06:09.992
false,true,3158,2966,192,0,00:00:00.000,2025-04-15 10:06:13.997
false,false,3170,2978,192,378,00:00:31.000,2025-04-15 10:06:27.008
false,false,3173,2981,192,472,00:00:30.000,2025-04-15 10:06:30.009
false,true,3204,3009,195,0,00:00:00.000,2025-04-15 10:07:18.056
false,true,3209,3014,195,0,00:00:00.000,2025-04-15 10:07:30.072
false,false,3210,3015,195,30,00:00:30.000,2025-04-15 10:07:31.073
false,false,3223,3028,195,284,00:00:33.000,2025-04-15 10:07:56.095
false,false,3233,3038,195,605,00:00:32.000,2025-04-15 10:08:06.104
false,true,3240,3044,196,0,00:00:00.000,2025-04-15 10:08:18.116
false,false,2945,2762,183,569,00:00:32.000,2025-04-15 10:01:59.745
false,false,2954,2771,183,849,00:00:30.000,2025-04-15 10:02:08.756
false,false,2958,2774,184,980,00:00:32.000,2025-04-15 10:02:12.760
false,false,2964,2780,184,1166,00:00:32.000,2025-04-15 10:02:18.766
false,false,2977,2792,185,1582,00:00:33.000,2025-04-15 10:02:31.778
false,false,3002,2817,185,2370,00:00:30.000,2025-04-15 10:02:56.807
false,false,3035,2849,186,629,00:00:32.000,2025-04-15 10:03:35.844
false,false,3044,2858,186,33,00:00:33.000,2025-04-15 10:03:56.861
false,false,3046,2860,186,95,00:00:32.000,2025-04-15 10:03:58.861
false,true,3060,2874,186,0,00:00:00.000,2025-04-15 10:04:14.875
false,false,3067,2881,186,223,00:00:33.000,2025-04-15 10:04:25.888
false,false,3068,2882,186,255,00:00:32.000,2025-04-15 10:04:26.889
false,false,3083,2897,186,727,00:00:31.000,2025-04-15 10:04:41.904
false,false,3084,2898,186,758,00:00:31.000,2025-04-15 10:04:42.904
false,false,3245,3049,196,158,00:00:30.000,2025-04-15 10:08:24.120
false,true,3251,3054,197,0,00:00:00.000,2025-04-15 10:08:32.130
false,true,3251,3054,197,0,00:00:00.000,2025-04-15 10:08:33.131
false,false,3276,3075,201,669,00:00:33.000,2025-04-15 10:09:07.168
false,false,3286,3085,201,979,00:00:31.000,2025-04-15 10:09:17.176
false,false,3288,3087,201,65,00:00:32.000,2025-04-15 10:09:25.184
false,false,3309,3107,202,724,00:00:32.000,2025-04-15 10:09:46.206
false,false,3317,3114,203,977,00:00:32.000,2025-04-15 10:09:54.214
false,false,3337,3132,205,95,00:00:31.000,2025-04-15 10:10:20.243
false,false,3339,3134,205,33,00:00:33.000,2025-04-15 10:10:28.254
false,true,3340,3135,205,0,00:00:00.000,2025-04-15 10:10:31.256
false,false,3343,3138,205,95,00:00:32.000,2025-04-15 10:10:38.265
false,true,3377,3171,206,0,00:00:00.000,2025-04-15 10:11:26.309
false,true,3377,3171,206,0,00:00:00.000,2025-04-15 10:11:30.312
false,false,3385,3178,207,249,00:00:30.000,2025-04-15 10:11:38.322
false,false,3386,3178,208,280,00:00:31.000,2025-04-15 10:11:39.323
false,true,3455,3245,210,0,00:00:00.000,2025-04-15 10:13:34.443
false,false,3491,3279,212,31,00:00:31.000,2025-04-15 10:14:24.501
false,false,3497,3284,213,223,00:00:33.000,2025-04-15 10:14:30.509
false,false,3503,3289,214,413,00:00:32.000,2025-04-15 10:14:36.516
false,true,3512,3298,214,0,00:00:00.000,2025-04-15 10:14:48.527
false,true,3512,3298,214,0,00:00:00.000,2025-04-15 10:14:49.528
false,false,3516,3301,215,123,00:00:30.000,2025-04-15 10:14:55.532
false,false,3519,3304,215,218,00:00:30.000,2025-04-15 10:14:58.534
false,true,3586,3366,220,0,00:00:00.000,2025-04-15 10:16:49.651
false,false,3595,3375,220,283,00:00:31.000,2025-04-15 10:17:02.667
false,false,3603,3383,220,527,00:00:30.000,2025-04-15 10:17:10.675
false,false,3654,3429,225,2115,00:00:32.000,2025-04-15 10:18:01.720
false,false,3661,3436,225,60,00:00:30.000,2025-04-15 10:18:14.733
false,false,3666,3440,226,214,00:00:31.000,2025-04-15 10:18:19.740
false,false,3525,3310,215,405,00:00:30.000,2025-04-15 10:15:04.539
false,false,3528,3313,215,498,00:00:33.000,2025-04-15 10:15:07.542
false,false,3536,3320,216,162,00:00:33.000,2025-04-15 10:15:21.556
false,true,3541,3324,217,0,00:00:00.000,2025-04-15 10:15:38.573
false,false,3542,3325,217,31,00:00:31.000,2025-04-15 10:15:39.574
false,false,3579,3359,220,123,00:00:32.000,2025-04-15 10:16:34.632
false,true,3676,3450,226,0,00:00:00.000,2025-04-15 10:18:33.753
false,false,3684,3456,228,254,00:00:33.000,2025-04-15 10:18:43.764
false,false,3686,3458,228,315,00:00:30.000,2025-04-15 10:18:45.766
false,false,3692,3463,229,63,00:00:30.000,2025-04-15 10:18:57.780
false,false,3710,3478,232,255,00:00:31.000,2025-04-15 10:19:21.809
false,false,3722,3489,233,31,00:00:31.000,2025-04-15 10:19:39.829
false,false,3799,3562,237,31,00:00:31.000,2025-04-15 10:21:44.963
false,false,3802,3564,238,126,00:00:33.000,2025-04-15 10:21:47.967
false,true,3802,3564,238,0,00:00:00.000,2025-04-15 10:21:52.968
false,true,3807,3569,238,0,00:00:00.000,2025-04-15 10:22:01.979
false,false,3808,3570,238,31,00:00:31.000,2025-04-15 10:22:05.984
false,false,3815,3577,238,124,00:00:33.000,2025-04-15 10:22:18.997
false,false,3836,3596,240,156,00:00:31.000,2025-04-15 10:22:46.021
false,false,3858,3614,244,841,00:00:32.000,2025-04-15 10:23:08.043
false,false,3860,3616,244,901,00:00:30.000,2025-04-15 10:23:10.045
false,false,3750,3516,234,474,00:00:32.000,2025-04-15 10:20:13.859
false,false,3753,3519,234,572,00:00:32.000,2025-04-15 10:20:16.863
false,false,3755,3521,234,634,00:00:32.000,2025-04-15 10:20:18.865
false,false,3765,3531,234,947,00:00:30.000,2025-04-15 10:20:28.878
false,false,3773,3538,235,1200,00:00:31.000,2025-04-15 10:20:36.889
false,true,3773,3538,235,0,00:00:00.000,2025-04-15 10:20:38.893
false,true,3773,3538,235,0,00:00:00.000,2025-04-15 10:20:40.895
false,false,3774,3539,235,31,00:00:31.000,2025-04-15 10:20:43.899
false,false,3780,3543,237,218,00:00:30.000,2025-04-15 10:20:49.906
false,true,3781,3544,237,0,00:00:00.000,2025-04-15 10:20:51.907
false,true,3781,3544,237,0,00:00:00.000,2025-04-15 10:20:54.912
false,true,3781,3544,237,0,00:00:00.000,2025-04-15 10:20:56.914
false,false,3792,3555,237,32,00:00:32.000,2025-04-15 10:21:25.943
false,true,3386,3178,208,0,00:00:00.000,2025-04-15 10:11:45.328
false,true,3398,3190,208,0,00:00:00.000,2025-04-15 10:12:00.340
false,false,3407,3199,208,287,00:00:33.000,2025-04-15 10:12:12.355
false,false,3413,3205,208,476,00:00:30.000,2025-04-15 10:12:18.362
false,true,3421,3212,209,0,00:00:00.000,2025-04-15 10:12:35.383
false,true,3421,3212,209,0,00:00:00.000,2025-04-15 10:12:37.385
false,false,3429,3220,209,251,00:00:33.000,2025-04-15 10:12:46.393
false,false,3443,3234,209,188,00:00:33.000,2025-04-15 10:13:12.419
false,false,3878,3633,245,564,00:00:33.000,2025-04-15 10:23:34.069
false,true,3890,3645,245,0,00:00:00.000,2025-04-15 10:23:49.086
false,false,3897,3652,245,218,00:00:30.000,2025-04-15 10:23:59.098
false,false,3910,3665,245,162,00:00:33.000,2025-04-15 10:24:18.121
false,true,3917,3672,245,0,00:00:00.000,2025-04-15 10:24:36.139
false,false,3920,3675,245,94,00:00:31.000,2025-04-15 10:24:40.143
false,false,3924,3678,246,220,00:00:31.000,2025-04-15 10:24:44.146
false,false,3931,3685,246,95,00:00:33.000,2025-04-15 10:24:57.157
false,false,3933,3687,246,160,00:00:32.000,2025-04-15 10:24:59.160
false,false,3936,3690,246,255,00:00:33.000,2025-04-15 10:25:02.163
false,false,4016,3766,250,1356,00:00:30.000,2025-04-15 10:26:46.271
false,false,4018,3768,250,1421,00:00:33.000,2025-04-15 10:26:48.273
false,true,4019,3769,250,0,00:00:00.000,2025-04-15 10:26:55.279
false,false,4034,3782,252,467,00:00:30.000,2025-04-15 10:27:10.290
false,false,4038,3786,252,32,00:00:32.000,2025-04-15 10:27:20.301
false,false,4051,3799,252,188,00:00:30.000,2025-04-15 10:27:39.322
false,false,4061,3809,252,188,00:00:31.000,2025-04-15 10:27:55.338
false,true,4061,3809,252,0,00:00:00.000,2025-04-15 10:27:57.340
false,false,4072,3820,252,351,00:00:33.000,2025-04-15 10:28:12.355
false,false,4074,3822,252,415,00:00:32.000,2025-04-15 10:28:14.357
false,true,4320,4057,263,0,00:00:00.000,2025-04-15 10:33:54.734
false,true,4320,4057,263,0,00:00:00.000,2025-04-15 10:33:55.735
false,false,4338,4073,265,155,00:00:30.000,2025-04-15 10:34:32.775
false,true,4344,4079,265,0,00:00:00.000,2025-04-15 10:34:43.788
false,true,4251,3988,263,0,00:00:00.000,2025-04-15 10:32:17.628
false,false,4269,4006,263,568,00:00:30.000,2025-04-15 10:32:35.648
false,false,4273,4010,263,697,00:00:32.000,2025-04-15 10:32:39.651
false,false,4290,4027,263,96,00:00:33.000,2025-04-15 10:33:02.679
false,false,4299,4036,263,378,00:00:32.000,2025-04-15 10:33:11.690
false,false,3963,3716,247,661,00:00:30.000,2025-04-15 10:25:35.195
false,true,3964,3717,247,0,00:00:00.000,2025-04-15 10:25:37.198
false,true,3973,3724,249,0,00:00:00.000,2025-04-15 10:25:59.223
false,false,3983,3734,249,318,00:00:30.000,2025-04-15 10:26:13.239
false,false,4001,3751,250,886,00:00:31.000,2025-04-15 10:26:31.257
false,false,4010,3760,250,1168,00:00:33.000,2025-04-15 10:26:40.266
false,false,4139,3885,254,669,00:00:31.000,2025-04-15 10:29:25.436
false,false,4142,3888,254,764,00:00:32.000,2025-04-15 10:29:28.437
false,false,4143,3889,254,32,00:00:32.000,2025-04-15 10:29:35.443
false,false,4154,3899,255,374,00:00:30.000,2025-04-15 10:29:46.454
false,true,4164,3909,255,0,00:00:00.000,2025-04-15 10:30:00.468
false,false,4178,3923,255,122,00:00:30.000,2025-04-15 10:30:22.494
false,false,4190,3934,256,340,00:00:32.000,2025-04-15 10:30:40.513
false,true,4194,3937,257,0,00:00:00.000,2025-04-15 10:30:56.529
false,false,4196,3939,257,62,00:00:31.000,2025-04-15 10:30:58.530
false,false,4198,3941,257,125,00:00:30.000,2025-04-15 10:31:00.532
false,false,4221,3962,259,123,00:00:31.000,2025-04-15 10:31:35.574
false,false,4367,4100,267,507,00:00:33.000,2025-04-15 10:35:13.813
false,true,4403,4132,271,0,00:00:00.000,2025-04-15 10:35:53.858
false,false,4417,4146,271,31,00:00:31.000,2025-04-15 10:36:15.877
false,false,4419,4147,272,93,00:00:32.000,2025-04-15 10:36:17.880
false,false,4426,4154,272,313,00:00:32.000,2025-04-15 10:36:24.885
false,false,4440,4167,273,403,00:00:31.000,2025-04-15 10:36:44.905
false,false,4611,4329,282,660,00:00:31.000,2025-04-15 10:40:12.111
false,false,4620,4337,283,30,00:00:30.000,2025-04-15 10:40:39.139
false,false,4623,4340,283,129,00:00:33.000,2025-04-15 10:40:42.142
false,false,4641,4357,284,127,00:00:32.000,2025-04-15 10:41:12.175
false,true,4645,4360,285,0,00:00:00.000,2025-04-15 10:41:18.180
false,false,4648,4363,285,97,00:00:32.000,2025-04-15 10:41:31.191
false,false,4649,4364,285,31,00:00:31.000,2025-04-15 10:41:38.198
false,false,4447,4174,273,625,00:00:32.000,2025-04-15 10:36:51.911
false,true,4451,4177,274,0,00:00:00.000,2025-04-15 10:36:57.920
false,true,4474,4199,275,0,00:00:00.000,2025-04-15 10:37:31.951
false,false,4479,4204,275,156,00:00:31.000,2025-04-15 10:37:41.961
false,false,4488,4212,276,433,00:00:32.000,2025-04-15 10:37:50.974
false,false,4508,4231,277,1064,00:00:32.000,2025-04-15 10:38:10.992
false,true,4537,4258,279,0,00:00:00.000,2025-04-15 10:38:41.022
false,true,4540,4261,279,0,00:00:00.000,2025-04-15 10:38:52.032
false,false,4545,4266,279,156,00:00:31.000,2025-04-15 10:39:00.038
false,false,4555,4276,279,472,00:00:31.000,2025-04-15 10:39:10.046
false,false,4558,4279,279,568,00:00:30.000,2025-04-15 10:39:13.049
false,false,4565,4286,279,795,00:00:31.000,2025-04-15 10:39:20.057
false,false,4576,4296,280,1141,00:00:31.000,2025-04-15 10:39:31.066
false,false,4585,4305,280,1422,00:00:31.000,2025-04-15 10:39:40.076
false,false,4664,4378,286,506,00:00:31.000,2025-04-15 10:41:53.215
false,true,4665,4379,286,0,00:00:00.000,2025-04-15 10:41:55.219
false,false,4668,4382,286,93,00:00:30.000,2025-04-15 10:42:03.226
false,false,4694,4405,289,474,00:00:30.000,2025-04-15 10:42:35.250
false,false,4695,4406,289,30,00:00:30.000,2025-04-15 10:42:42.258
false,false,4701,4412,289,217,00:00:31.000,2025-04-15 10:42:48.264
false,false,4706,4417,289,156,00:00:31.000,2025-04-15 10:42:59.278
false,false,4714,4423,291,408,00:00:31.000,2025-04-15 10:43:07.287
false,false,4732,4440,292,258,00:00:32.000,2025-04-15 10:43:31.310
false,false,4737,4444,293,158,00:00:30.000,2025-04-15 10:43:42.321
false,true,4763,4469,294,0,00:00:00.000,2025-04-15 10:44:11.355
false,false,4764,4470,294,32,00:00:32.000,2025-04-15 10:44:15.361
false,false,4779,4485,294,95,00:00:32.000,2025-04-15 10:44:42.391
false,false,4788,4494,294,378,00:00:32.000,2025-04-15 10:44:51.399
false,false,4810,4515,295,123,00:00:30.000,2025-04-15 10:45:19.424
false,false,4828,4533,295,62,00:00:30.000,2025-04-15 10:45:55.454
false,false,4831,4536,295,160,00:00:33.000,2025-04-15 10:45:58.460
false,false,4833,4538,295,223,00:00:33.000,2025-04-15 10:46:00.462
false,true,4839,4543,296,0,00:00:00.000,2025-04-15 10:46:14.475
false,true,4839,4543,296,0,00:00:00.000,2025-04-15 10:46:18.480
false,false,4854,4556,298,94,00:00:31.000,2025-04-15 10:46:39.508
false,true,4871,4572,299,0,00:00:00.000,2025-04-15 10:47:02.534
false,false,4873,4574,299,61,00:00:30.000,2025-04-15 10:47:04.537
false,false,4894,4594,300,728,00:00:31.000,2025-04-15 10:47:25.559
false,false,4919,4618,301,247,00:00:31.000,2025-04-15 10:47:56.594
false,false,4926,4624,302,471,00:00:32.000,2025-04-15 10:48:03.602
false,false,4930,4628,302,601,00:00:32.000,2025-04-15 10:48:07.606
false,false,5343,5008,335,281,00:00:32.000,2025-04-15 10:57:13.152
false,false,5366,5029,337,62,00:00:30.000,2025-04-15 10:57:48.186
false,false,5383,5045,338,608,00:00:32.000,2025-04-15 10:58:05.202
false,false,5390,5051,339,829,00:00:31.000,2025-04-15 10:58:12.208
false,false,5393,5054,339,926,00:00:33.000,2025-04-15 10:58:15.210
false,false,5403,5063,340,1240,00:00:31.000,2025-04-15 10:58:25.220
false,false,5093,4777,316,313,00:00:30.000,2025-04-15 10:51:50.846
false,true,5116,4798,318,0,00:00:00.000,2025-04-15 10:52:26.879
false,false,5125,4807,318,279,00:00:32.000,2025-04-15 10:52:40.888
false,false,5145,4825,320,911,00:00:31.000,2025-04-15 10:53:00.910
false,false,1981,1860,121,98,00:00:32.000,2025-04-15 09:39:18.363
false,true,1988,1866,122,0,00:00:00.000,2025-04-15 09:39:26.368
false,false,1999,1877,122,96,00:00:33.000,2025-04-15 09:39:54.395
false,false,2009,1887,122,409,00:00:32.000,2025-04-15 09:40:04.405
false,false,2012,1890,122,506,00:00:33.000,2025-04-15 09:40:07.409
false,false,2030,1905,125,1074,00:00:32.000,2025-04-15 09:40:25.430
false,true,2035,1910,125,0,00:00:00.000,2025-04-15 09:40:32.438
false,true,2330,2183,147,0,00:00:00.000,2025-04-15 09:47:30.865
false,true,2330,2183,147,0,00:00:00.000,2025-04-15 09:47:31.865
false,false,2345,2197,148,477,00:00:32.000,2025-04-15 09:47:46.885
false,false,2353,2204,149,732,00:00:33.000,2025-04-15 09:47:54.895
false,false,2358,2209,149,62,00:00:31.000,2025-04-15 09:48:05.906
false,false,2363,2214,149,31,00:00:31.000,2025-04-15 09:48:16.916
false,false,2367,2218,149,161,00:00:33.000,2025-04-15 09:48:20.922
false,false,2370,2221,149,257,00:00:30.000,2025-04-15 09:48:23.925
false,true,2387,2236,151,0,00:00:00.000,2025-04-15 09:48:45.951
false,true,2282,2137,145,0,00:00:00.000,2025-04-15 09:45:43.754
false,false,2284,2139,145,65,00:00:32.000,2025-04-15 09:45:51.761
false,true,2298,2152,146,0,00:00:00.000,2025-04-15 09:46:27.797
false,true,2310,2163,147,0,00:00:00.000,2025-04-15 09:46:44.813
false,true,2312,2165,147,0,00:00:00.000,2025-04-15 09:46:56.825
false,true,2246,2106,140,0,00:00:00.000,2025-04-15 09:44:33.686
false,false,2268,2126,142,127,00:00:31.000,2025-04-15 09:45:23.737
false,false,2274,2131,143,320,00:00:31.000,2025-04-15 09:45:29.743
false,true,2282,2137,145,0,00:00:00.000,2025-04-15 09:45:39.753
false,true,2282,2137,145,0,00:00:00.000,2025-04-15 09:45:42.754
false,false,2415,2263,152,498,00:00:30.000,2025-04-15 09:49:20.986
false,false,2419,2267,152,624,00:00:30.000,2025-04-15 09:49:24.989
false,false,2428,2275,153,905,00:00:31.000,2025-04-15 09:49:33.997
false,false,2429,2276,153,938,00:00:33.000,2025-04-15 09:49:34.997
false,false,2445,2290,155,1445,00:00:33.000,2025-04-15 09:49:51.013
false,false,2455,2300,155,1764,00:00:32.000,2025-04-15 09:50:01.021
false,true,2465,2310,155,0,00:00:00.000,2025-04-15 09:50:13.031
false,true,2465,2310,155,0,00:00:00.000,2025-04-15 09:50:15.031
false,true,2465,2310,155,0,00:00:00.000,2025-04-15 09:50:16.032
false,false,2466,2311,155,31,00:00:31.000,2025-04-15 09:50:18.034
false,false,2468,2313,155,94,00:00:31.000,2025-04-15 09:50:20.035
false,false,2479,2322,157,276,00:00:30.000,2025-04-15 09:50:55.075
false,true,2479,2322,157,0,00:00:00.000,2025-04-15 09:50:59.078
false,false,2481,2324,157,62,00:00:31.000,2025-04-15 09:51:03.083
false,false,2492,2335,157,410,00:00:31.000,2025-04-15 09:51:14.091
false,false,2499,2342,157,628,00:00:30.000,2025-04-15 09:51:21.096
false,false,2505,2348,157,818,00:00:33.000,2025-04-15 09:51:27.103
false,false,2527,2369,158,409,00:00:31.000,2025-04-15 09:52:01.143
false,false,2528,2370,158,442,00:00:33.000,2025-04-15 09:52:02.144
false,false,2631,2468,163,285,00:00:33.000,2025-04-15 09:54:27.288
false,false,2649,2484,165,230,00:00:32.000,2025-04-15 09:54:51.308
false,false,2552,2393,159,228,00:00:33.000,2025-04-15 09:52:38.179
false,false,2561,2402,159,509,00:00:32.000,2025-04-15 09:52:47.187
false,false,2591,2431,160,317,00:00:31.000,2025-04-15 09:53:23.227
false,true,2600,2440,160,0,00:00:00.000,2025-04-15 09:53:37.241
false,true,2601,2441,160,0,00:00:00.000,2025-04-15 09:53:44.249
false,false,2762,2591,171,124,00:00:30.000,2025-04-15 09:57:44.477
false,false,2769,2598,171,346,00:00:30.000,2025-04-15 09:57:51.486
false,false,2784,2611,173,822,00:00:33.000,2025-04-15 09:58:06.503
false,false,2709,2542,167,97,00:00:33.000,2025-04-15 09:56:27.392
false,false,2711,2544,167,158,00:00:31.000,2025-04-15 09:56:29.394
false,false,2796,2623,173,310,00:00:30.000,2025-04-15 09:58:24.516
false,false,2797,2624,173,340,00:00:30.000,2025-04-15 09:58:25.517
false,false,2799,2626,173,401,00:00:31.000,2025-04-15 09:58:27.520
false,false,2844,2670,174,160,00:00:31.000,2025-04-15 09:59:30.582
false,true,2859,2685,174,0,00:00:00.000,2025-04-15 09:59:56.612
false,false,2874,2698,176,478,00:00:33.000,2025-04-15 10:00:12.630
false,false,2876,2700,176,32,00:00:32.000,2025-04-15 10:00:20.642
false,false,2892,2715,177,531,00:00:30.000,2025-04-15 10:00:36.663
false,false,2895,2717,178,627,00:00:32.000,2025-04-15 10:00:39.667
false,false,2905,2726,179,184,00:00:30.000,2025-04-15 10:01:01.687
false,false,2908,2729,179,279,00:00:32.000,2025-04-15 10:01:04.692
false,false,2911,2731,180,370,00:00:30.000,2025-04-15 10:01:07.695
false,true,2911,2731,180,0,00:00:00.000,2025-04-15 10:01:13.701
false,true,2917,2736,181,0,00:00:00.000,2025-04-15 10:01:22.709
false,false,2919,2738,181,62,00:00:32.000,2025-04-15 10:01:27.714
false,false,2920,2739,181,93,00:00:31.000,2025-04-15 10:01:28.715
false,false,3109,2921,188,465,00:00:33.000,2025-04-15 10:05:13.942
false,false,3118,2930,188,746,00:00:30.000,2025-04-15 10:05:22.950
false,false,3119,2931,188,778,00:00:32.000,2025-04-15 10:05:23.951
false,true,3124,2936,188,0,00:00:00.000,2025-04-15 10:05:34.961
false,false,3127,2939,188,94,00:00:31.000,2025-04-15 10:05:37.965
false,true,3177,2985,192,0,00:00:00.000,2025-04-15 10:06:35.016
false,false,3202,3007,195,345,00:00:31.000,2025-04-15 10:07:11.049
false,true,3204,3009,195,0,00:00:00.000,2025-04-15 10:07:19.057
false,false,3214,3019,195,95,00:00:32.000,2025-04-15 10:07:41.085
false,false,2940,2758,182,406,00:00:30.000,2025-04-15 10:01:54.739
false,false,2943,2760,183,505,00:00:33.000,2025-04-15 10:01:57.742
false,false,2948,2765,183,665,00:00:30.000,2025-04-15 10:02:02.750
false,false,2950,2767,183,725,00:00:30.000,2025-04-15 10:02:04.751
false,false,2980,2795,185,1677,00:00:31.000,2025-04-15 10:02:34.781
false,false,2981,2796,185,1707,00:00:30.000,2025-04-15 10:02:35.782
false,false,2983,2798,185,1773,00:00:33.000,2025-04-15 10:02:37.784
false,false,2989,2804,185,1965,00:00:32.000,2025-04-15 10:02:43.793
false,false,2991,2806,185,2028,00:00:31.000,2025-04-15 10:02:45.795
false,false,3012,2827,185,2689,00:00:32.000,2025-04-15 10:03:06.818
false,false,3014,2829,185,2752,00:00:32.000,2025-04-15 10:03:08.821
false,false,3015,2830,185,2783,00:00:31.000,2025-04-15 10:03:09.822
false,false,3059,2873,186,508,00:00:32.000,2025-04-15 10:04:11.873
false,true,3251,3054,197,0,00:00:00.000,2025-04-15 10:08:36.134
false,false,3271,3070,201,508,00:00:32.000,2025-04-15 10:09:02.160
false,true,3286,3085,201,0,00:00:00.000,2025-04-15 10:09:21.180
false,false,3293,3091,202,221,00:00:32.000,2025-04-15 10:09:30.189
false,false,3324,3121,203,1196,00:00:32.000,2025-04-15 10:10:01.221
false,false,3349,3144,205,158,00:00:31.000,2025-04-15 10:10:50.276
false,false,3371,3165,206,480,00:00:33.000,2025-04-15 10:11:18.301
false,true,3377,3171,206,0,00:00:00.000,2025-04-15 10:11:28.311
false,true,3377,3171,206,0,00:00:00.000,2025-04-15 10:11:29.311
false,true,3455,3245,210,0,00:00:00.000,2025-04-15 10:13:32.442
false,false,3465,3255,210,316,00:00:32.000,2025-04-15 10:13:46.457
false,false,3468,3257,211,32,00:00:32.000,2025-04-15 10:13:55.470
false,false,3477,3265,212,315,00:00:32.000,2025-04-15 10:14:04.480
false,false,3498,3284,214,256,00:00:33.000,2025-04-15 10:14:31.509
false,false,3583,3363,220,123,00:00:30.000,2025-04-15 10:16:44.644
false,false,3621,3398,223,1086,00:00:30.000,2025-04-15 10:17:28.689
false,false,3636,3412,224,1557,00:00:31.000,2025-04-15 10:17:43.706
false,false,3640,3416,224,1680,00:00:31.000,2025-04-15 10:17:47.709
false,false,3647,3422,225,1900,00:00:33.000,2025-04-15 10:17:54.715
false,false,3665,3440,225,183,00:00:32.000,2025-04-15 10:18:18.739
false,false,3543,3326,217,64,00:00:33.000,2025-04-15 10:15:40.575
false,true,3558,3341,217,0,00:00:00.000,2025-04-15 10:16:06.603
false,false,3561,3343,218,95,00:00:32.000,2025-04-15 10:16:10.606
false,false,3570,3351,219,383,00:00:33.000,2025-04-15 10:16:19.618
false,true,3575,3355,220,0,00:00:00.000,2025-04-15 10:16:26.626
false,true,3575,3355,220,0,00:00:00.000,2025-04-15 10:16:30.630
false,false,3577,3357,220,60,00:00:30.000,2025-04-15 10:16:32.630
false,true,3579,3359,220,0,00:00:00.000,2025-04-15 10:16:38.637
false,false,3689,3461,228,408,00:00:32.000,2025-04-15 10:18:48.770
false,false,3811,3573,238,124,00:00:32.000,2025-04-15 10:22:08.987
false,true,3811,3573,238,0,00:00:00.000,2025-04-15 10:22:13.992
false,false,3813,3575,238,61,00:00:30.000,2025-04-15 10:22:16.995
false,false,3828,3590,238,544,00:00:32.000,2025-04-15 10:22:32.010
false,false,3843,3601,242,376,00:00:31.000,2025-04-15 10:22:53.029
false,true,3860,3616,244,0,00:00:00.000,2025-04-15 10:23:12.048
false,false,3867,3623,244,223,00:00:33.000,2025-04-15 10:23:23.057
false,true,3785,3548,237,0,00:00:00.000,2025-04-15 10:21:03.922
false,true,3785,3548,237,0,00:00:00.000,2025-04-15 10:21:04.924
false,true,3785,3548,237,0,00:00:00.000,2025-04-15 10:21:05.924
false,true,3786,3549,237,0,00:00:00.000,2025-04-15 10:21:12.932
false,false,3793,3556,237,64,00:00:32.000,2025-04-15 10:21:26.945
false,true,3798,3561,237,0,00:00:00.000,2025-04-15 10:21:40.958
false,true,3398,3190,208,0,00:00:00.000,2025-04-15 10:12:01.341
false,true,3398,3190,208,0,00:00:00.000,2025-04-15 10:12:02.342
false,false,3403,3195,208,159,00:00:30.000,2025-04-15 10:12:08.350
false,true,3421,3212,209,0,00:00:00.000,2025-04-15 10:12:33.381
false,false,3917,3672,245,95,00:00:31.000,2025-04-15 10:24:31.132
false,true,4019,3769,250,0,00:00:00.000,2025-04-15 10:26:51.276
false,false,4025,3775,250,186,00:00:32.000,2025-04-15 10:27:01.284
false,true,4045,3793,252,0,00:00:00.000,2025-04-15 10:27:30.314
false,false,4049,3797,252,125,00:00:31.000,2025-04-15 10:27:37.321
false,false,4054,3802,252,282,00:00:32.000,2025-04-15 10:27:42.324
false,false,4062,3810,252,30,00:00:30.000,2025-04-15 10:28:02.345
false,false,4067,3815,252,189,00:00:31.000,2025-04-15 10:28:07.351
false,false,4307,4044,263,151,00:00:31.000,2025-04-15 10:33:25.707
false,true,4312,4049,263,0,00:00:00.000,2025-04-15 10:33:42.719
false,true,4329,4065,264,0,00:00:00.000,2025-04-15 10:34:07.750
false,false,4334,4069,265,31,00:00:31.000,2025-04-15 10:34:28.771
false,false,4343,4078,265,314,00:00:32.000,2025-04-15 10:34:37.779
false,true,4251,3988,263,0,00:00:00.000,2025-04-15 10:32:13.622
false,false,4258,3995,263,223,00:00:31.000,2025-04-15 10:32:24.636
false,false,4276,4013,263,796,00:00:33.000,2025-04-15 10:32:42.655
false,false,4279,4016,263,892,00:00:33.000,2025-04-15 10:32:45.659
false,false,4286,4023,263,1107,00:00:30.000,2025-04-15 10:32:52.667
false,false,4289,4026,263,63,00:00:33.000,2025-04-15 10:33:01.678
false,true,4302,4039,263,0,00:00:00.000,2025-04-15 10:33:15.695
false,false,3940,3694,246,382,00:00:33.000,2025-04-15 10:25:06.169
false,true,3942,3696,246,0,00:00:00.000,2025-04-15 10:25:10.174
false,true,3964,3717,247,0,00:00:00.000,2025-04-15 10:25:41.201
false,false,3971,3722,249,187,00:00:30.000,2025-04-15 10:25:55.218
false,false,3985,3736,249,379,00:00:30.000,2025-04-15 10:26:15.241
false,false,4000,3750,250,855,00:00:32.000,2025-04-15 10:26:30.255
false,false,4002,3752,250,919,00:00:33.000,2025-04-15 10:26:32.258
false,false,4004,3754,250,981,00:00:32.000,2025-04-15 10:26:34.260
false,false,4116,3863,253,1729,00:00:33.000,2025-04-15 10:28:56.405
false,true,4142,3888,254,0,00:00:00.000,2025-04-15 10:29:30.438
false,true,4174,3919,255,0,00:00:00.000,2025-04-15 10:30:17.487
false,false,4195,3938,257,31,00:00:31.000,2025-04-15 10:30:57.530
false,false,4203,3946,257,63,00:00:31.000,2025-04-15 10:31:11.546
false,false,4211,3953,258,316,00:00:32.000,2025-04-15 10:31:19.555
false,false,4215,3957,258,440,00:00:30.000,2025-04-15 10:31:23.559
false,true,4217,3959,258,0,00:00:00.000,2025-04-15 10:31:30.567
false,false,4401,4130,271,1574,00:00:30.000,2025-04-15 10:35:47.850
false,false,4411,4140,271,256,00:00:33.000,2025-04-15 10:36:03.867
false,false,4412,4141,271,287,00:00:31.000,2025-04-15 10:36:04.868
false,false,4420,4148,272,124,00:00:31.000,2025-04-15 10:36:18.880
false,false,4429,4157,272,60,00:00:30.000,2025-04-15 10:36:33.893
false,false,4435,4162,273,245,00:00:30.000,2025-04-15 10:36:39.901
false,false,4606,4325,281,502,00:00:30.000,2025-04-15 10:40:07.106
false,false,4608,4327,281,566,00:00:32.000,2025-04-15 10:40:09.109
false,true,4619,4336,283,0,00:00:00.000,2025-04-15 10:40:34.133
false,false,4626,4343,283,97,00:00:31.000,2025-04-15 10:40:51.153
false,false,4629,4346,283,191,00:00:31.000,2025-04-15 10:40:54.156
false,false,4630,4347,283,222,00:00:31.000,2025-04-15 10:40:55.156
false,false,4633,4349,284,317,00:00:30.000,2025-04-15 10:40:58.159
false,true,4645,4360,285,0,00:00:00.000,2025-04-15 10:41:27.187
false,false,4453,4179,274,60,00:00:30.000,2025-04-15 10:37:03.925
false,false,4454,4180,274,93,00:00:33.000,2025-04-15 10:37:04.926
false,false,4463,4189,274,376,00:00:31.000,2025-04-15 10:37:13.934
false,true,4469,4195,274,0,00:00:00.000,2025-04-15 10:37:25.945
false,false,4486,4210,276,370,00:00:30.000,2025-04-15 10:37:48.972
false,false,4511,4233,278,1159,00:00:31.000,2025-04-15 10:38:13.995
false,false,4513,4235,278,1223,00:00:33.000,2025-04-15 10:38:15.998
false,false,4524,4245,279,1573,00:00:33.000,2025-04-15 10:38:27.010
false,false,4539,4260,279,61,00:00:30.000,2025-04-15 10:38:48.028
false,true,4540,4261,279,0,00:00:00.000,2025-04-15 10:38:50.029
false,false,4588,4308,280,1518,00:00:33.000,2025-04-15 10:39:43.079
false,true,4590,4310,280,0,00:00:00.000,2025-04-15 10:39:48.083
false,false,4592,4312,280,63,00:00:31.000,2025-04-15 10:39:53.091
false,false,4603,4323,280,411,00:00:30.000,2025-04-15 10:40:04.102
false,false,4667,4381,286,63,00:00:33.000,2025-04-15 10:42:02.226
false,true,4679,4393,286,0,00:00:00.000,2025-04-15 10:42:17.235
false,true,4694,4405,289,0,00:00:00.000,2025-04-15 10:42:39.256
false,false,4738,4445,293,188,00:00:30.000,2025-04-15 10:43:43.323
false,false,4747,4454,293,472,00:00:30.000,2025-04-15 10:43:52.334
false,false,4751,4457,294,598,00:00:30.000,2025-04-15 10:43:56.339
false,false,4785,4491,294,285,00:00:33.000,2025-04-15 10:44:48.397
false,false,4802,4507,295,819,00:00:31.000,2025-04-15 10:45:05.413
false,true,4806,4511,295,0,00:00:00.000,2025-04-15 10:45:10.418
false,true,4806,4511,295,0,00:00:00.000,2025-04-15 10:45:12.418
false,true,4806,4511,295,0,00:00:00.000,2025-04-15 10:45:15.421
false,false,4820,4525,295,190,00:00:30.000,2025-04-15 10:45:35.439
false,true,4826,4531,295,0,00:00:00.000,2025-04-15 10:45:50.451
false,true,4837,4541,296,0,00:00:00.000,2025-04-15 10:46:07.469
false,false,4851,4553,298,373,00:00:33.000,2025-04-15 10:46:30.496
false,false,4867,4568,299,499,00:00:32.000,2025-04-15 10:46:52.522
false,true,4871,4572,299,0,00:00:00.000,2025-04-15 10:46:58.528
false,false,4893,4593,300,697,00:00:30.000,2025-04-15 10:47:24.558
false,false,4906,4606,300,1100,00:00:30.000,2025-04-15 10:47:37.575
false,false,4915,4614,301,123,00:00:30.000,2025-04-15 10:47:52.589
false,false,4923,4622,301,375,00:00:32.000,2025-04-15 10:48:00.600
false,false,4931,4629,302,634,00:00:33.000,2025-04-15 10:48:08.607
false,true,4935,4631,304,0,00:00:00.000,2025-04-15 10:48:13.613
false,false,5358,5022,336,382,00:00:30.000,2025-04-15 10:57:34.172
false,true,5364,5028,336,0,00:00:00.000,2025-04-15 10:57:44.183
false,false,5375,5037,338,354,00:00:33.000,2025-04-15 10:57:57.194
false,false,5402,5062,340,1209,00:00:30.000,2025-04-15 10:58:24.217
false,false,5099,4782,317,507,00:00:33.000,2025-04-15 10:51:56.853
false,false,5123,4805,318,216,00:00:32.000,2025-04-15 10:52:38.886
false,false,5141,4821,320,784,00:00:32.000,2025-04-15 10:52:56.909
false,false,1991,1869,122,64,00:00:31.000,2025-04-15 09:39:40.381
false,false,2004,1882,122,254,00:00:31.000,2025-04-15 09:39:59.399
false,false,2015,1893,122,603,00:00:33.000,2025-04-15 09:40:10.414
false,false,2033,1908,125,1169,00:00:33.000,2025-04-15 09:40:28.435
false,false,2347,2198,149,541,00:00:31.000,2025-04-15 09:47:48.888
false,false,2371,2222,149,289,00:00:32.000,2025-04-15 09:48:24.926
false,false,2384,2233,151,698,00:00:32.000,2025-04-15 09:48:37.941
false,true,2387,2236,151,0,00:00:00.000,2025-04-15 09:48:46.951
false,true,2399,2248,151,0,00:00:00.000,2025-04-15 09:48:59.964
false,true,2291,2146,145,0,00:00:00.000,2025-04-15 09:46:09.784
false,false,2301,2154,147,97,00:00:32.000,2025-04-15 09:46:32.804
false,false,2306,2159,147,256,00:00:33.000,2025-04-15 09:46:37.807
false,true,2312,2165,147,0,00:00:00.000,2025-04-15 09:46:58.826
false,false,2325,2178,147,411,00:00:32.000,2025-04-15 09:47:14.844
false,false,2326,2179,147,444,00:00:33.000,2025-04-15 09:47:15.846
false,true,2326,2179,147,0,00:00:00.000,2025-04-15 09:47:20.853
false,false,2242,2102,140,4770,00:00:32.000,2025-04-15 09:44:15.670
false,true,2242,2102,140,0,00:00:00.000,2025-04-15 09:44:19.674
false,false,2254,2113,141,98,00:00:33.000,2025-04-15 09:44:57.708
false,false,2269,2126,143,159,00:00:32.000,2025-04-15 09:45:24.739
false,false,2271,2128,143,223,00:00:31.000,2025-04-15 09:45:26.741
false,true,2282,2137,145,0,00:00:00.000,2025-04-15 09:45:40.753
false,true,2399,2248,151,0,00:00:00.000,2025-04-15 09:49:04.970
false,false,2430,2277,153,969,00:00:31.000,2025-04-15 09:49:35.998
false,false,2433,2280,153,1063,00:00:33.000,2025-04-15 09:49:39.000
false,false,2437,2283,154,1188,00:00:32.000,2025-04-15 09:49:43.004
false,false,2438,2284,154,1221,00:00:33.000,2025-04-15 09:49:44.005
false,true,2465,2310,155,0,00:00:00.000,2025-04-15 09:50:12.030
false,true,2468,2313,155,0,00:00:00.000,2025-04-15 09:50:25.039
false,true,2468,2313,155,0,00:00:00.000,2025-04-15 09:50:26.039
false,true,2479,2322,157,0,00:00:00.000,2025-04-15 09:50:58.078
false,false,2519,2361,158,153,00:00:30.000,2025-04-15 09:51:53.134
false,true,2539,2380,159,0,00:00:00.000,2025-04-15 09:52:18.158
false,false,2541,2382,159,65,00:00:32.000,2025-04-15 09:52:21.161
false,false,2632,2469,163,318,00:00:33.000,2025-04-15 09:54:28.288
false,false,2670,2503,167,902,00:00:33.000,2025-04-15 09:55:12.327
false,true,2676,2509,167,0,00:00:00.000,2025-04-15 09:55:38.350
false,false,2571,2411,160,821,00:00:32.000,2025-04-15 09:52:57.197
false,false,2606,2445,161,159,00:00:33.000,2025-04-15 09:53:56.259
false,false,2738,2570,168,1007,00:00:30.000,2025-04-15 09:56:56.426
false,false,2749,2579,170,285,00:00:32.000,2025-04-15 09:57:19.451
false,false,2770,2599,171,376,00:00:30.000,2025-04-15 09:57:52.487
false,false,2792,2619,173,187,00:00:30.000,2025-04-15 09:58:20.511
false,false,2716,2549,167,317,00:00:32.000,2025-04-15 09:56:34.398
false,false,2802,2629,173,493,00:00:31.000,2025-04-15 09:58:30.522
false,false,2812,2638,174,65,00:00:33.000,2025-04-15 09:58:52.543
false,false,2815,2641,174,162,00:00:32.000,2025-04-15 09:58:55.545
false,false,2837,2663,174,856,00:00:30.000,2025-04-15 09:59:17.566
false,true,2839,2665,174,0,00:00:00.000,2025-04-15 09:59:22.574
false,true,2875,2699,176,0,00:00:00.000,2025-04-15 10:00:19.641
false,false,2894,2716,178,595,00:00:31.000,2025-04-15 10:00:38.666
false,false,2910,2730,180,340,00:00:31.000,2025-04-15 10:01:06.693
false,false,3100,2913,187,184,00:00:30.000,2025-04-15 10:05:04.931
false,false,3106,2919,187,370,00:00:30.000,2025-04-15 10:05:10.937
false,false,3110,2922,188,495,00:00:30.000,2025-04-15 10:05:14.942
false,false,3116,2928,188,686,00:00:33.000,2025-04-15 10:05:20.948
false,true,3124,2936,188,0,00:00:00.000,2025-04-15 10:05:32.959
false,false,3135,2946,189,349,00:00:31.000,2025-04-15 10:05:45.971
false,false,3140,2950,190,509,00:00:32.000,2025-04-15 10:05:50.975
false,false,3141,2951,190,541,00:00:32.000,2025-04-15 10:05:51.976
false,false,3152,2960,192,889,00:00:32.000,2025-04-15 10:06:02.986
false,false,3155,2963,192,983,00:00:33.000,2025-04-15 10:06:05.987
false,false,3158,2966,192,1076,00:00:30.000,2025-04-15 10:06:08.990
false,true,3158,2966,192,0,00:00:00.000,2025-04-15 10:06:12.997
false,false,3161,2969,192,97,00:00:33.000,2025-04-15 10:06:18.000
false,false,3164,2972,192,193,00:00:33.000,2025-04-15 10:06:21.003
false,true,3191,2997,194,0,00:00:00.000,2025-04-15 10:06:56.035
false,false,3228,3033,195,445,00:00:32.000,2025-04-15 10:08:01.098
false,true,3240,3044,196,0,00:00:00.000,2025-04-15 10:08:17.115
false,false,3242,3046,196,63,00:00:31.000,2025-04-15 10:08:21.119
false,false,3243,3047,196,95,00:00:32.000,2025-04-15 10:08:22.119
false,false,2959,2775,184,1012,00:00:32.000,2025-04-15 10:02:13.761
false,false,2960,2776,184,1042,00:00:30.000,2025-04-15 10:02:14.762
false,false,2967,2783,184,1264,00:00:33.000,2025-04-15 10:02:21.770
false,false,2969,2785,184,1330,00:00:33.000,2025-04-15 10:02:23.772
false,false,2987,2802,185,1901,00:00:31.000,2025-04-15 10:02:41.790
false,true,3015,2830,185,0,00:00:00.000,2025-04-15 10:03:14.826
false,true,3015,2830,185,0,00:00:00.000,2025-04-15 10:03:15.827
false,true,3035,2849,186,0,00:00:00.000,2025-04-15 10:03:37.846
false,true,3035,2849,186,0,00:00:00.000,2025-04-15 10:03:39.846
false,false,3038,2852,186,96,00:00:33.000,2025-04-15 10:03:44.852
false,true,3043,2857,186,0,00:00:00.000,2025-04-15 10:03:53.860
false,false,3056,2870,186,412,00:00:30.000,2025-04-15 10:04:08.871
false,true,3094,2907,187,0,00:00:00.000,2025-04-15 10:04:57.922
false,false,3251,3054,197,344,00:00:32.000,2025-04-15 10:08:30.128
false,true,3255,3057,198,0,00:00:00.000,2025-04-15 10:08:45.145
false,true,3255,3057,198,0,00:00:00.000,2025-04-15 10:08:46.146
false,false,3257,3059,198,62,00:00:31.000,2025-04-15 10:08:48.147
false,false,3264,3064,200,285,00:00:31.000,2025-04-15 10:08:55.154
false,false,3270,3069,201,476,00:00:32.000,2025-04-15 10:09:01.160
false,false,3292,3090,202,189,00:00:32.000,2025-04-15 10:09:29.187
false,false,3298,3096,202,378,00:00:30.000,2025-04-15 10:09:35.196
false,false,3310,3108,202,755,00:00:31.000,2025-04-15 10:09:47.206
false,false,3325,3122,203,1227,00:00:31.000,2025-04-15 10:10:02.222
false,false,3333,3129,204,1471,00:00:31.000,2025-04-15 10:10:10.233
false,true,3334,3129,205,0,00:00:00.000,2025-04-15 10:10:14.235
false,false,3358,3153,205,63,00:00:30.000,2025-04-15 10:11:05.290
false,false,3368,3163,205,382,00:00:31.000,2025-04-15 10:11:15.299
false,false,3369,3163,206,414,00:00:32.000,2025-04-15 10:11:16.299
false,false,3373,3167,206,542,00:00:30.000,2025-04-15 10:11:20.303
false,false,3511,3297,214,659,00:00:32.000,2025-04-15 10:14:44.524
false,true,3512,3298,214,0,00:00:00.000,2025-04-15 10:14:47.527
false,false,3514,3300,214,61,00:00:30.000,2025-04-15 10:14:53.531
false,false,3515,3301,214,93,00:00:32.000,2025-04-15 10:14:54.531
false,false,3522,3307,215,314,00:00:30.000,2025-04-15 10:15:01.537
false,false,3591,3371,220,155,00:00:32.000,2025-04-15 10:16:58.661
false,false,3592,3372,220,186,00:00:31.000,2025-04-15 10:16:59.663
false,false,3632,3409,223,1431,00:00:31.000,2025-04-15 10:17:39.701
false,false,3634,3411,223,1494,00:00:33.000,2025-04-15 10:17:41.703
false,false,3651,3426,225,2020,00:00:30.000,2025-04-15 10:17:58.718
false,false,3656,3431,225,2179,00:00:33.000,2025-04-15 10:18:03.723
false,false,3658,3433,225,2244,00:00:33.000,2025-04-15 10:18:05.725
false,true,3579,3359,220,0,00:00:00.000,2025-04-15 10:16:40.638
false,false,3677,3450,227,30,00:00:30.000,2025-04-15 10:18:36.757
false,false,3679,3452,227,93,00:00:32.000,2025-04-15 10:18:38.759
false,false,3705,3473,232,94,00:00:31.000,2025-04-15 10:19:16.803
false,false,3713,3480,233,351,00:00:31.000,2025-04-15 10:19:24.814
false,true,3721,3488,233,0,00:00:00.000,2025-04-15 10:19:36.826
false,true,3735,3502,233,0,00:00:00.000,2025-04-15 10:19:53.844
false,true,3735,3502,233,0,00:00:00.000,2025-04-15 10:19:57.846
false,true,3807,3569,238,0,00:00:00.000,2025-04-15 10:22:02.980
false,true,3807,3569,238,0,00:00:00.000,2025-04-15 10:22:03.981
false,true,3811,3573,238,0,00:00:00.000,2025-04-15 10:22:14.993
false,true,3831,3592,239,0,00:00:00.000,2025-04-15 10:22:39.015
false,false,3835,3596,239,125,00:00:30.000,2025-04-15 10:22:45.020
false,false,3857,3613,244,809,00:00:30.000,2025-04-15 10:23:07.042
false,false,3864,3620,244,125,00:00:31.000,2025-04-15 10:23:20.055
false,false,3746,3512,234,350,00:00:32.000,2025-04-15 10:20:09.857
false,false,3777,3542,235,125,00:00:30.000,2025-04-15 10:20:46.902
false,true,3781,3544,237,0,00:00:00.000,2025-04-15 10:20:55.913
false,false,3389,3181,208,94,00:00:32.000,2025-04-15 10:11:48.331
false,true,3398,3190,208,0,00:00:00.000,2025-04-15 10:11:59.339
false,false,3400,3192,208,64,00:00:33.000,2025-04-15 10:12:05.345
false,false,3401,3193,208,97,00:00:33.000,2025-04-15 10:12:06.346
false,false,3408,3200,208,320,00:00:33.000,2025-04-15 10:12:13.356
false,true,3421,3212,209,0,00:00:00.000,2025-04-15 10:12:38.386
false,false,3434,3225,209,410,00:00:30.000,2025-04-15 10:12:51.397
false,true,3436,3227,209,0,00:00:00.000,2025-04-15 10:12:54.401
false,true,3436,3227,209,0,00:00:00.000,2025-04-15 10:12:55.402
false,true,3436,3227,209,0,00:00:00.000,2025-04-15 10:12:56.403
false,false,3886,3641,245,818,00:00:31.000,2025-04-15 10:23:42.077
false,false,3890,3645,245,948,00:00:32.000,2025-04-15 10:23:46.081
false,true,3917,3672,245,0,00:00:00.000,2025-04-15 10:24:32.133
false,true,3928,3682,246,0,00:00:00.000,2025-04-15 10:24:49.152
false,true,3928,3682,246,0,00:00:00.000,2025-04-15 10:24:53.154
false,false,3930,3684,246,62,00:00:30.000,2025-04-15 10:24:56.158
false,false,4032,3780,252,405,00:00:30.000,2025-04-15 10:27:08.290
false,false,4035,3783,252,499,00:00:32.000,2025-04-15 10:27:11.291
false,true,4037,3785,252,0,00:00:00.000,2025-04-15 10:27:14.294
false,true,4045,3793,252,0,00:00:00.000,2025-04-15 10:27:32.317
false,false,4065,3813,252,126,00:00:32.000,2025-04-15 10:28:05.350
false,false,4079,3826,253,569,00:00:30.000,2025-04-15 10:28:19.362
false,true,4311,4048,263,0,00:00:00.000,2025-04-15 10:33:30.710
false,true,4311,4048,263,0,00:00:00.000,2025-04-15 10:33:33.711
false,true,4312,4049,263,0,00:00:00.000,2025-04-15 10:33:37.715
false,false,4316,4053,263,128,00:00:31.000,2025-04-15 10:33:46.724
false,false,4321,4057,264,30,00:00:30.000,2025-04-15 10:33:57.736
false,true,4329,4065,264,0,00:00:00.000,2025-04-15 10:34:10.755
false,true,4333,4068,265,0,00:00:00.000,2025-04-15 10:34:23.767
false,true,4333,4068,265,0,00:00:00.000,2025-04-15 10:34:25.769
false,true,4351,4086,265,0,00:00:00.000,2025-04-15 10:34:56.797
false,false,4356,4090,266,158,00:00:31.000,2025-04-15 10:35:02.805
false,false,4358,4092,266,222,00:00:32.000,2025-04-15 10:35:04.807
false,false,4238,3977,261,31,00:00:31.000,2025-04-15 10:31:58.602
false,true,4251,3988,263,0,00:00:00.000,2025-04-15 10:32:15.626
false,false,4264,4001,263,409,00:00:33.000,2025-04-15 10:32:30.640
false,false,4298,4035,263,346,00:00:30.000,2025-04-15 10:33:10.688
false,false,3960,3713,247,567,00:00:32.000,2025-04-15 10:25:32.191
false,true,3965,3717,248,0,00:00:00.000,2025-04-15 10:25:46.207
false,true,3973,3724,249,0,00:00:00.000,2025-04-15 10:26:02.227
false,false,3986,3737,249,409,00:00:30.000,2025-04-15 10:26:16.241
false,false,3989,3740,249,507,00:00:33.000,2025-04-15 10:26:19.243
false,false,4098,3845,253,1162,00:00:33.000,2025-04-15 10:28:38.386
false,false,4100,3847,253,1223,00:00:30.000,2025-04-15 10:28:40.389
false,false,4126,3873,253,256,00:00:31.000,2025-04-15 10:29:12.425
false,false,4138,3884,254,638,00:00:33.000,2025-04-15 10:29:24.436
false,false,4158,3903,255,496,00:00:30.000,2025-04-15 10:29:50.459
false,false,4184,3928,256,155,00:00:32.000,2025-04-15 10:30:34.508
false,false,4186,3930,256,216,00:00:31.000,2025-04-15 10:30:36.509
false,false,4201,3944,257,222,00:00:31.000,2025-04-15 10:31:03.535
false,true,4201,3944,257,0,00:00:00.000,2025-04-15 10:31:08.542
false,true,4201,3944,257,0,00:00:00.000,2025-04-15 10:31:09.544
false,false,4205,3948,257,128,00:00:33.000,2025-04-15 10:31:13.548
false,false,4227,3968,259,310,00:00:33.000,2025-04-15 10:31:41.582
false,false,4362,4095,267,348,00:00:32.000,2025-04-15 10:35:08.810
false,false,4364,4097,267,413,00:00:33.000,2025-04-15 10:35:10.812
false,false,4385,4116,269,1072,00:00:32.000,2025-04-15 10:35:31.833
false,false,4402,4131,271,1604,00:00:30.000,2025-04-15 10:35:48.851
false,false,4415,4144,271,381,00:00:30.000,2025-04-15 10:36:07.871
false,false,4416,4145,271,414,00:00:33.000,2025-04-15 10:36:08.872
false,true,4416,4145,271,0,00:00:00.000,2025-04-15 10:36:09.873
false,false,4432,4160,272,154,00:00:32.000,2025-04-15 10:36:36.896
false,false,4433,4161,272,185,00:00:31.000,2025-04-15 10:36:37.897
false,true,4616,4333,283,0,00:00:00.000,2025-04-15 10:40:20.120
false,true,4616,4333,283,0,00:00:00.000,2025-04-15 10:40:21.122
false,false,4622,4339,283,96,00:00:33.000,2025-04-15 10:40:41.141
false,true,4623,4340,283,0,00:00:00.000,2025-04-15 10:40:46.147
false,false,4628,4345,283,160,00:00:30.000,2025-04-15 10:40:53.155
false,true,4645,4360,285,0,00:00:00.000,2025-04-15 10:41:25.187
false,true,4648,4363,285,0,00:00:00.000,2025-04-15 10:41:35.196
false,false,4651,4366,285,96,00:00:33.000,2025-04-15 10:41:40.203
false,false,4444,4171,273,530,00:00:31.000,2025-04-15 10:36:48.909
false,false,4451,4177,274,746,00:00:30.000,2025-04-15 10:36:55.917
false,true,4451,4177,274,0,00:00:00.000,2025-04-15 10:36:59.921
false,false,4452,4178,274,30,00:00:30.000,2025-04-15 10:37:02.924
false,false,4458,4184,274,220,00:00:33.000,2025-04-15 10:37:08.931
false,false,4461,4187,274,315,00:00:30.000,2025-04-15 10:37:11.932
false,false,4464,4190,274,409,00:00:33.000,2025-04-15 10:37:14.936
false,true,4469,4195,274,0,00:00:00.000,2025-04-15 10:37:22.943
false,false,4474,4199,275,160,00:00:33.000,2025-04-15 10:37:30.949
false,false,4493,4217,276,587,00:00:33.000,2025-04-15 10:37:55.978
false,false,4530,4251,279,1758,00:00:31.000,2025-04-15 10:38:33.016
false,false,4556,4277,279,505,00:00:33.000,2025-04-15 10:39:11.046
false,false,4582,4302,280,1331,00:00:31.000,2025-04-15 10:39:37.072
false,true,4590,4310,280,0,00:00:00.000,2025-04-15 10:39:49.085
false,true,4590,4310,280,0,00:00:00.000,2025-04-15 10:39:51.088
false,false,4594,4314,280,126,00:00:31.000,2025-04-15 10:39:55.093
false,false,4657,4371,286,284,00:00:33.000,2025-04-15 10:41:46.209
false,false,4660,4374,286,380,00:00:33.000,2025-04-15 10:41:49.211
false,false,4666,4380,286,30,00:00:30.000,2025-04-15 10:42:01.225
false,false,4671,4385,286,184,00:00:31.000,2025-04-15 10:42:06.227
false,false,4717,4425,292,499,00:00:30.000,2025-04-15 10:43:10.291
false,true,4732,4440,292,0,00:00:00.000,2025-04-15 10:43:32.312
false,false,4768,4474,294,159,00:00:31.000,2025-04-15 10:44:19.367
false,false,4792,4498,294,508,00:00:33.000,2025-04-15 10:44:55.404
false,false,4793,4499,294,539,00:00:31.000,2025-04-15 10:44:56.406
false,true,4806,4511,295,0,00:00:00.000,2025-04-15 10:45:14.419
false,true,4814,4519,295,0,00:00:00.000,2025-04-15 10:45:29.431
false,true,4826,4531,295,0,00:00:00.000,2025-04-15 10:45:53.453
false,true,4837,4541,296,0,00:00:00.000,2025-04-15 10:46:09.471
false,true,4839,4543,296,0,00:00:00.000,2025-04-15 10:46:15.477
false,true,4851,4553,298,0,00:00:00.000,2025-04-15 10:46:31.498
false,true,4851,4553,298,0,00:00:00.000,2025-04-15 10:46:32.499
false,false,4857,4559,298,188,00:00:32.000,2025-04-15 10:46:42.511
false,false,4871,4572,299,624,00:00:31.000,2025-04-15 10:46:56.526
false,false,4877,4578,299,188,00:00:33.000,2025-04-15 10:47:08.540
false,false,4883,4584,299,381,00:00:33.000,2025-04-15 10:47:14.547
false,false,4884,4584,300,413,00:00:32.000,2025-04-15 10:47:15.550
false,false,4899,4599,300,884,00:00:31.000,2025-04-15 10:47:30.566
false,false,4912,4612,300,33,00:00:33.000,2025-04-15 10:47:49.586
false,false,4920,4619,301,277,00:00:30.000,2025-04-15 10:47:57.595
false,false,4925,4623,302,439,00:00:31.000,2025-04-15 10:48:02.601
false,false,4935,4631,304,762,00:00:32.000,2025-04-15 10:48:12.612
false,false,5325,4990,335,693,00:00:33.000,2025-04-15 10:56:49.130
false,false,5326,4991,335,724,00:00:31.000,2025-04-15 10:56:50.131
false,false,5377,5039,338,419,00:00:33.000,2025-04-15 10:57:59.197
false,false,5108,4790,318,789,00:00:32.000,2025-04-15 10:52:05.859
false,false,5121,4803,318,154,00:00:30.000,2025-04-15 10:52:36.886
false,false,5122,4804,318,184,00:00:30.000,2025-04-15 10:52:37.885
false,false,5134,4814,320,564,00:00:33.000,2025-04-15 10:52:49.903
false,false,5143,4823,320,847,00:00:32.000,2025-04-15 10:52:58.909
false,true,1975,1856,119,0,00:00:00.000,2025-04-15 09:39:06.354
false,true,1988,1866,122,0,00:00:00.000,2025-04-15 09:39:29.371
false,true,1996,1874,122,0,00:00:00.000,2025-04-15 09:39:48.388
false,true,1996,1874,122,0,00:00:00.000,2025-04-15 09:39:49.390
false,false,2006,1884,122,315,00:00:30.000,2025-04-15 09:40:01.402
false,false,2014,1892,122,570,00:00:31.000,2025-04-15 09:40:09.412
false,false,2023,1899,124,855,00:00:32.000,2025-04-15 09:40:18.422
false,false,2024,1900,124,885,00:00:30.000,2025-04-15 09:40:19.423
false,false,2038,1912,126,92,00:00:32.000,2025-04-15 09:40:39.443
false,false,2039,1913,126,124,00:00:32.000,2025-04-15 09:40:40.444
false,true,2330,2183,147,0,00:00:00.000,2025-04-15 09:47:26.862
false,false,2333,2186,147,94,00:00:30.000,2025-04-15 09:47:34.868
false,false,2354,2205,149,762,00:00:30.000,2025-04-15 09:47:55.896
false,false,2356,2207,149,825,00:00:31.000,2025-04-15 09:47:57.898
false,false,2361,2212,149,153,00:00:30.000,2025-04-15 09:48:08.909
false,true,2387,2236,151,0,00:00:00.000,2025-04-15 09:48:41.946
false,false,2398,2247,151,339,00:00:30.000,2025-04-15 09:48:57.962
false,true,2291,2146,145,0,00:00:00.000,2025-04-15 09:46:10.784
false,true,2294,2148,146,0,00:00:00.000,2025-04-15 09:46:14.788
false,true,2294,2148,146,0,00:00:00.000,2025-04-15 09:46:18.790
false,false,2297,2151,146,92,00:00:31.000,2025-04-15 09:46:22.792
false,false,2303,2156,147,161,00:00:32.000,2025-04-15 09:46:34.805
false,false,2309,2162,147,349,00:00:33.000,2025-04-15 09:46:40.808
false,true,2310,2163,147,0,00:00:00.000,2025-04-15 09:46:42.812
false,true,2310,2163,147,0,00:00:00.000,2025-04-15 09:46:47.817
false,false,2317,2170,147,155,00:00:30.000,2025-04-15 09:47:06.833
false,true,2326,2179,147,0,00:00:00.000,2025-04-15 09:47:18.850
false,false,2233,2093,140,4490,00:00:33.000,2025-04-15 09:44:06.662
false,true,2245,2105,140,0,00:00:00.000,2025-04-15 09:44:26.684
false,true,2250,2109,141,0,00:00:00.000,2025-04-15 09:44:47.700
false,false,2251,2110,141,30,00:00:30.000,2025-04-15 09:44:48.701
false,true,2251,2110,141,0,00:00:00.000,2025-04-15 09:44:52.704
false,true,2257,2116,141,0,00:00:00.000,2025-04-15 09:45:01.713
false,false,2258,2117,141,33,00:00:33.000,2025-04-15 09:45:07.718
false,false,2259,2118,141,65,00:00:32.000,2025-04-15 09:45:08.719
false,false,2264,2122,142,223,00:00:33.000,2025-04-15 09:45:13.726
false,false,2281,2137,144,541,00:00:31.000,2025-04-15 09:45:36.749
false,false,2400,2249,151,30,00:00:30.000,2025-04-15 09:49:05.971
false,false,2406,2255,151,219,00:00:32.000,2025-04-15 09:49:11.976
false,false,2420,2268,152,654,00:00:30.000,2025-04-15 09:49:25.990
false,false,2444,2289,155,1412,00:00:30.000,2025-04-15 09:49:50.013
false,false,2450,2295,155,1603,00:00:33.000,2025-04-15 09:49:56.017
false,false,2461,2306,155,1950,00:00:32.000,2025-04-15 09:50:07.025
false,false,2478,2321,157,246,00:00:30.000,2025-04-15 09:50:54.074
false,true,2479,2322,157,0,00:00:00.000,2025-04-15 09:51:00.079
false,true,2505,2348,157,0,00:00:00.000,2025-04-15 09:51:29.106
false,true,2505,2348,157,0,00:00:00.000,2025-04-15 09:51:31.108
false,false,2509,2352,157,120,00:00:30.000,2025-04-15 09:51:37.115
false,false,2510,2352,158,151,00:00:31.000,2025-04-15 09:51:38.117
false,false,2516,2358,158,63,00:00:32.000,2025-04-15 09:51:50.132
false,false,2526,2368,158,378,00:00:31.000,2025-04-15 09:52:00.141
false,false,2539,2380,159,790,00:00:33.000,2025-04-15 09:52:13.153
false,true,2539,2380,159,0,00:00:00.000,2025-04-15 09:52:14.153
false,false,2614,2453,161,413,00:00:30.000,2025-04-15 09:54:04.267
false,false,2636,2472,164,446,00:00:33.000,2025-04-15 09:54:32.292
false,false,2648,2484,164,198,00:00:33.000,2025-04-15 09:54:50.308
false,false,2650,2485,165,261,00:00:31.000,2025-04-15 09:54:52.309
false,false,2659,2492,167,548,00:00:30.000,2025-04-15 09:55:01.318
false,false,2671,2504,167,933,00:00:31.000,2025-04-15 09:55:13.328
false,true,2672,2505,167,0,00:00:00.000,2025-04-15 09:55:31.343
false,false,2570,2411,159,789,00:00:32.000,2025-04-15 09:52:56.196
false,false,2573,2413,160,883,00:00:31.000,2025-04-15 09:52:59.199
false,false,2580,2420,160,1102,00:00:33.000,2025-04-15 09:53:06.208
false,false,2595,2435,160,440,00:00:30.000,2025-04-15 09:53:27.230
false,true,2601,2441,160,0,00:00:00.000,2025-04-15 09:53:42.246
false,false,2726,2559,167,631,00:00:31.000,2025-04-15 09:56:44.409
false,false,2729,2562,167,726,00:00:31.000,2025-04-15 09:56:47.412
false,false,2733,2566,167,848,00:00:30.000,2025-04-15 09:56:51.418
false,false,2734,2567,167,881,00:00:33.000,2025-04-15 09:56:52.419
false,true,2738,2570,168,0,00:00:00.000,2025-04-15 09:57:00.429
false,true,2740,2572,168,0,00:00:00.000,2025-04-15 09:57:07.439
false,false,2747,2578,169,223,00:00:32.000,2025-04-15 09:57:17.449
false,false,2772,2601,171,438,00:00:30.000,2025-04-15 09:57:54.490
false,true,2786,2613,173,0,00:00:00.000,2025-04-15 09:58:12.505
false,false,2707,2540,167,33,00:00:33.000,2025-04-15 09:56:25.392
false,false,2712,2545,167,191,00:00:33.000,2025-04-15 09:56:30.395
false,false,2719,2552,167,412,00:00:32.000,2025-04-15 09:56:37.400
false,false,2827,2653,174,537,00:00:31.000,2025-04-15 09:59:07.555
false,false,2847,2673,174,257,00:00:33.000,2025-04-15 09:59:33.585
false,false,2853,2679,174,447,00:00:31.000,2025-04-15 09:59:39.592
false,true,2853,2679,174,0,00:00:00.000,2025-04-15 09:59:40.593
false,true,2853,2679,174,0,00:00:00.000,2025-04-15 09:59:42.596
false,false,2882,2706,176,224,00:00:33.000,2025-04-15 10:00:26.649
false,false,2886,2709,177,351,00:00:33.000,2025-04-15 10:00:30.654
false,false,2898,2720,178,94,00:00:31.000,2025-04-15 10:00:48.676
false,false,2915,2734,181,125,00:00:33.000,2025-04-15 10:01:17.707
false,false,2923,2742,181,186,00:00:32.000,2025-04-15 10:01:31.720
false,true,2927,2746,181,0,00:00:00.000,2025-04-15 10:01:36.725
false,false,3101,2914,187,214,00:00:30.000,2025-04-15 10:05:05.933
false,false,3134,2945,189,318,00:00:33.000,2025-04-15 10:05:44.971
false,false,3142,2952,190,571,00:00:30.000,2025-04-15 10:05:52.976
false,false,3151,2959,192,857,00:00:31.000,2025-04-15 10:06:01.985
false,false,3167,2975,192,285,00:00:30.000,2025-04-15 10:06:24.007
false,true,3177,2985,192,0,00:00:00.000,2025-04-15 10:06:36.017
false,true,3177,2985,192,0,00:00:00.000,2025-04-15 10:06:39.022
false,false,3194,3000,194,98,00:00:33.000,2025-04-15 10:07:03.041
false,false,3198,3004,194,223,00:00:31.000,2025-04-15 10:07:07.046
false,true,3204,3009,195,0,00:00:00.000,2025-04-15 10:07:15.053
false,true,3211,3016,195,0,00:00:00.000,2025-04-15 10:07:36.077
false,true,3211,3016,195,0,00:00:00.000,2025-04-15 10:07:37.079
false,false,3219,3024,195,158,00:00:31.000,2025-04-15 10:07:52.091
false,false,3226,3031,195,380,00:00:33.000,2025-04-15 10:07:59.096
false,false,3237,3041,196,730,00:00:30.000,2025-04-15 10:08:10.109
false,false,3240,3044,196,823,00:00:32.000,2025-04-15 10:08:13.111
false,false,2946,2763,183,602,00:00:33.000,2025-04-15 10:02:00.746
false,false,2949,2766,183,695,00:00:30.000,2025-04-15 10:02:03.751
false,false,2952,2769,183,786,00:00:31.000,2025-04-15 10:02:06.754
false,false,2971,2787,184,1395,00:00:32.000,2025-04-15 10:02:25.774
false,false,2982,2797,185,1740,00:00:33.000,2025-04-15 10:02:36.783
false,false,3006,2821,185,2496,00:00:30.000,2025-04-15 10:03:00.813
false,true,3015,2830,185,0,00:00:00.000,2025-04-15 10:03:10.823
false,true,3035,2849,186,0,00:00:00.000,2025-04-15 10:03:38.846
false,false,3097,2910,187,93,00:00:30.000,2025-04-15 10:05:01.927
false,true,3251,3054,197,0,00:00:00.000,2025-04-15 10:08:31.129
false,false,3258,3060,198,95,00:00:33.000,2025-04-15 10:08:49.148
false,false,3273,3072,201,572,00:00:33.000,2025-04-15 10:09:04.164
false,false,3280,3079,201,796,00:00:30.000,2025-04-15 10:09:11.171
false,false,3282,3081,201,856,00:00:30.000,2025-04-15 10:09:13.173
false,false,3302,3100,202,503,00:00:31.000,2025-04-15 10:09:39.198
false,true,3334,3129,205,0,00:00:00.000,2025-04-15 10:10:17.241
false,false,3347,3142,205,94,00:00:32.000,2025-04-15 10:10:48.274
false,false,3361,3156,205,161,00:00:33.000,2025-04-15 10:11:08.291
false,false,3376,3170,206,635,00:00:30.000,2025-04-15 10:11:23.307
false,true,3455,3245,210,0,00:00:00.000,2025-04-15 10:13:28.438
false,true,3467,3257,210,0,00:00:00.000,2025-04-15 10:13:50.461
false,false,3482,3270,212,471,00:00:30.000,2025-04-15 10:14:09.485
false,false,3495,3282,213,158,00:00:32.000,2025-04-15 10:14:28.505
false,false,3518,3303,215,188,00:00:33.000,2025-04-15 10:14:57.534
false,false,3585,3365,220,187,00:00:32.000,2025-04-15 10:16:46.647
false,false,3586,3366,220,220,00:00:33.000,2025-04-15 10:16:47.648
false,true,3586,3366,220,0,00:00:00.000,2025-04-15 10:16:53.654
false,false,3587,3367,220,30,00:00:30.000,2025-04-15 10:16:54.655
false,false,3589,3369,220,92,00:00:31.000,2025-04-15 10:16:56.658
false,false,3593,3373,220,219,00:00:33.000,2025-04-15 10:17:00.664
false,false,3599,3379,220,407,00:00:32.000,2025-04-15 10:17:06.672
false,false,3609,3388,221,710,00:00:31.000,2025-04-15 10:17:16.678
false,false,3633,3410,223,1461,00:00:30.000,2025-04-15 10:17:40.702
false,false,3653,3428,225,2083,00:00:32.000,2025-04-15 10:18:00.719
false,true,3659,3434,225,0,00:00:00.000,2025-04-15 10:18:07.727
false,false,3530,3315,215,561,00:00:30.000,2025-04-15 10:15:09.545
false,true,3541,3324,217,0,00:00:00.000,2025-04-15 10:15:33.568
false,true,3547,3330,217,0,00:00:00.000,2025-04-15 10:15:50.585
false,false,3553,3336,217,191,00:00:31.000,2025-04-15 10:15:56.591
false,true,3558,3341,217,0,00:00:00.000,2025-04-15 10:16:07.605
false,false,3559,3342,217,30,00:00:30.000,2025-04-15 10:16:08.605
false,false,3569,3350,219,350,00:00:32.000,2025-04-15 10:16:18.617
false,true,3579,3359,220,0,00:00:00.000,2025-04-15 10:16:37.635
false,false,3707,3475,232,159,00:00:32.000,2025-04-15 10:19:18.806
false,true,3735,3502,233,0,00:00:00.000,2025-04-15 10:19:58.846
false,true,3802,3564,238,0,00:00:00.000,2025-04-15 10:21:53.970
false,true,3807,3569,238,0,00:00:00.000,2025-04-15 10:21:59.977
false,false,3809,3571,238,61,00:00:30.000,2025-04-15 10:22:06.984
false,true,3811,3573,238,0,00:00:00.000,2025-04-15 10:22:09.988
false,true,3811,3573,238,0,00:00:00.000,2025-04-15 10:22:12.991
false,false,3829,3591,238,576,00:00:32.000,2025-04-15 10:22:33.010
false,false,3841,3601,240,314,00:00:30.000,2025-04-15 10:22:51.026
false,false,3847,3604,243,500,00:00:32.000,2025-04-15 10:22:57.033
false,false,3853,3609,244,688,00:00:31.000,2025-04-15 10:23:03.038
false,false,3771,3537,234,1139,00:00:31.000,2025-04-15 10:20:34.888
false,false,3778,3542,236,158,00:00:33.000,2025-04-15 10:20:47.904
false,false,3782,3545,237,31,00:00:31.000,2025-04-15 10:20:57.914
false,true,3786,3549,237,0,00:00:00.000,2025-04-15 10:21:08.926
false,true,3786,3549,237,0,00:00:00.000,2025-04-15 10:21:11.931
false,true,3791,3554,237,0,00:00:00.000,2025-04-15 10:21:22.941
false,false,3394,3186,208,255,00:00:30.000,2025-04-15 10:11:53.335
false,false,3402,3194,208,129,00:00:32.000,2025-04-15 10:12:07.347
false,false,3410,3202,208,385,00:00:32.000,2025-04-15 10:12:15.358
false,false,3428,3219,209,218,00:00:30.000,2025-04-15 10:12:45.393
false,false,3449,3240,209,378,00:00:32.000,2025-04-15 10:13:18.424
false,false,3454,3244,210,532,00:00:32.000,2025-04-15 10:13:23.429
false,true,3905,3660,245,0,00:00:00.000,2025-04-15 10:24:12.116
false,false,3925,3679,246,251,00:00:31.000,2025-04-15 10:24:45.147
false,false,4021,3771,250,62,00:00:31.000,2025-04-15 10:26:57.282
false,false,4045,3793,252,251,00:00:31.000,2025-04-15 10:27:27.312
false,false,4047,3795,252,63,00:00:32.000,2025-04-15 10:27:35.319
false,false,4048,3796,252,94,00:00:31.000,2025-04-15 10:27:36.320
false,false,4053,3801,252,250,00:00:30.000,2025-04-15 10:27:41.324
false,true,4055,3803,252,0,00:00:00.000,2025-04-15 10:27:45.327
false,true,4055,3803,252,0,00:00:00.000,2025-04-15 10:27:46.327
false,false,4059,3807,252,125,00:00:32.000,2025-04-15 10:27:53.337
false,false,4063,3811,252,61,00:00:31.000,2025-04-15 10:28:03.347
false,true,4311,4048,263,0,00:00:00.000,2025-04-15 10:33:31.711
false,true,4320,4057,263,0,00:00:00.000,2025-04-15 10:33:51.731
false,false,4324,4060,264,122,00:00:30.000,2025-04-15 10:34:00.741
false,false,4332,4067,265,92,00:00:31.000,2025-04-15 10:34:14.759
false,true,4333,4068,265,0,00:00:00.000,2025-04-15 10:34:18.762
false,true,4344,4079,265,0,00:00:00.000,2025-04-15 10:34:39.781
false,true,4351,4086,265,0,00:00:00.000,2025-04-15 10:34:55.796
false,false,4355,4089,266,127,00:00:32.000,2025-04-15 10:35:01.803
false,false,4237,3977,260,626,00:00:30.000,2025-04-15 10:31:51.592
false,false,4252,3989,263,30,00:00:30.000,2025-04-15 10:32:18.630
false,false,4254,3991,263,96,00:00:33.000,2025-04-15 10:32:20.631
false,false,4260,3997,263,284,00:00:30.000,2025-04-15 10:32:26.638
false,false,4262,3999,263,345,00:00:31.000,2025-04-15 10:32:28.639
false,false,4278,4015,263,859,00:00:33.000,2025-04-15 10:32:44.658
false,false,4281,4018,263,953,00:00:30.000,2025-04-15 10:32:47.662
false,true,4287,4024,263,0,00:00:00.000,2025-04-15 10:32:54.669
false,true,4287,4024,263,0,00:00:00.000,2025-04-15 10:32:57.673
false,true,4302,4039,263,0,00:00:00.000,2025-04-15 10:33:19.699
false,false,4306,4043,263,120,00:00:30.000,2025-04-15 10:33:24.705
false,true,3942,3696,246,0,00:00:00.000,2025-04-15 10:25:13.174
false,false,3949,3703,246,225,00:00:32.000,2025-04-15 10:25:21.182
false,false,3975,3726,249,64,00:00:32.000,2025-04-15 10:26:05.231
false,false,3994,3744,250,665,00:00:32.000,2025-04-15 10:26:24.251
false,false,4007,3757,250,1073,00:00:30.000,2025-04-15 10:26:37.264
false,false,4090,3837,253,910,00:00:30.000,2025-04-15 10:28:30.376
false,false,4102,3849,253,1284,00:00:31.000,2025-04-15 10:28:42.391
false,false,4113,3860,253,1631,00:00:33.000,2025-04-15 10:28:53.401
false,true,4118,3865,253,0,00:00:00.000,2025-04-15 10:29:00.410
false,true,4118,3865,253,0,00:00:00.000,2025-04-15 10:29:03.413
false,false,4135,3881,254,543,00:00:33.000,2025-04-15 10:29:21.433
false,true,4142,3888,254,0,00:00:00.000,2025-04-15 10:29:31.439
false,true,4164,3909,255,0,00:00:00.000,2025-04-15 10:29:57.464
false,false,4169,3914,255,156,00:00:33.000,2025-04-15 10:30:07.473
false,false,4188,3932,256,278,00:00:32.000,2025-04-15 10:30:38.511
false,false,4213,3955,258,379,00:00:33.000,2025-04-15 10:31:21.557
false,false,4224,3965,259,214,00:00:30.000,2025-04-15 10:31:38.578
false,false,4372,4104,268,662,00:00:32.000,2025-04-15 10:35:18.820
false,false,4375,4107,268,757,00:00:33.000,2025-04-15 10:35:21.824
false,true,4403,4132,271,0,00:00:00.000,2025-04-15 10:35:55.860
false,true,4416,4145,271,0,00:00:00.000,2025-04-15 10:36:14.876
false,false,4425,4153,272,281,00:00:31.000,2025-04-15 10:36:23.884
false,true,4427,4155,272,0,00:00:00.000,2025-04-15 10:36:31.892
false,true,4616,4333,283,0,00:00:00.000,2025-04-15 10:40:23.124
false,true,4623,4340,283,0,00:00:00.000,2025-04-15 10:40:45.146
false,false,4634,4350,284,350,00:00:33.000,2025-04-15 10:40:59.159
false,false,4645,4360,285,256,00:00:32.000,2025-04-15 10:41:16.179
false,false,4471,4197,274,63,00:00:30.000,2025-04-15 10:37:27.947
false,false,4537,4258,279,1980,00:00:33.000,2025-04-15 10:38:40.020
false,true,4537,4258,279,0,00:00:00.000,2025-04-15 10:38:46.026
false,false,4574,4294,280,1078,00:00:31.000,2025-04-15 10:39:29.065
false,false,4599,4319,280,285,00:00:31.000,2025-04-15 10:40:00.097
false,false,4601,4321,280,349,00:00:32.000,2025-04-15 10:40:02.099
false,false,4658,4372,286,316,00:00:32.000,2025-04-15 10:41:47.210
false,false,4677,4391,286,372,00:00:30.000,2025-04-15 10:42:12.232
false,true,4679,4393,286,0,00:00:00.000,2025-04-15 10:42:16.234
false,false,4680,4394,286,33,00:00:33.000,2025-04-15 10:42:21.239
false,false,4685,4397,288,189,00:00:31.000,2025-04-15 10:42:26.244
false,false,4713,4422,291,377,00:00:31.000,2025-04-15 10:43:06.286
false,false,4722,4430,292,657,00:00:33.000,2025-04-15 10:43:15.295
false,true,4770,4476,294,0,00:00:00.000,2025-04-15 10:44:26.374
false,true,4806,4511,295,0,00:00:00.000,2025-04-15 10:45:11.418
false,false,4812,4517,295,188,00:00:32.000,2025-04-15 10:45:21.425
false,false,4827,4532,295,32,00:00:32.000,2025-04-15 10:45:54.453
false,false,4885,4585,300,445,00:00:32.000,2025-04-15 10:47:16.551
false,false,4924,4622,302,408,00:00:33.000,2025-04-15 10:48:01.600
false,false,4938,4634,304,98,00:00:33.000,2025-04-15 10:48:21.619
false,true,4938,4634,304,0,00:00:00.000,2025-04-15 10:48:24.622
false,true,5334,4999,335,0,00:00:00.000,2025-04-15 10:57:04.146
false,false,5355,5019,336,287,00:00:33.000,2025-04-15 10:57:31.171
false,false,5389,5051,338,798,00:00:33.000,2025-04-15 10:58:11.207
false,false,5103,4785,318,631,00:00:30.000,2025-04-15 10:52:00.855
false,true,5116,4798,318,0,00:00:00.000,2025-04-15 10:52:27.880
false,true,5116,4798,318,0,00:00:00.000,2025-04-15 10:52:31.882
false,false,5144,4824,320,880,00:00:33.000,2025-04-15 10:52:59.910
false,true,1975,1856,119,0,00:00:00.000,2025-04-15 09:39:03.351
false,false,2008,1886,122,377,00:00:30.000,2025-04-15 09:40:03.405
false,false,2368,2219,149,194,00:00:33.000,2025-04-15 09:48:21.923
false,false,2385,2234,151,731,00:00:33.000,2025-04-15 09:48:38.942
false,false,2389,2238,151,63,00:00:32.000,2025-04-15 09:48:48.953
false,false,2399,2248,151,370,00:00:31.000,2025-04-15 09:48:58.962
false,true,2282,2137,145,0,00:00:00.000,2025-04-15 09:45:49.758
false,false,2292,2147,145,32,00:00:32.000,2025-04-15 09:46:11.786
false,false,2302,2155,147,129,00:00:32.000,2025-04-15 09:46:33.804
false,false,2305,2158,147,223,00:00:32.000,2025-04-15 09:46:36.807
false,true,2246,2106,140,0,00:00:00.000,2025-04-15 09:44:34.687
false,true,2246,2106,140,0,00:00:00.000,2025-04-15 09:44:35.688
false,false,2248,2108,140,63,00:00:30.000,2025-04-15 09:44:39.691
false,true,2251,2110,141,0,00:00:00.000,2025-04-15 09:44:54.705
false,true,2257,2116,141,0,00:00:00.000,2025-04-15 09:45:04.714
false,true,2264,2122,142,0,00:00:00.000,2025-04-15 09:45:16.729
false,false,2265,2123,142,33,00:00:33.000,2025-04-15 09:45:20.733
false,false,2279,2135,144,480,00:00:33.000,2025-04-15 09:45:34.748
false,false,2412,2260,152,405,00:00:31.000,2025-04-15 09:49:17.984
false,false,2421,2269,152,686,00:00:32.000,2025-04-15 09:49:26.991
false,true,2468,2313,155,0,00:00:00.000,2025-04-15 09:50:23.038
false,false,2474,2318,156,123,00:00:30.000,2025-04-15 09:50:50.069
false,false,2488,2331,157,284,00:00:32.000,2025-04-15 09:51:10.088
false,false,2490,2333,157,348,00:00:32.000,2025-04-15 09:51:12.090
false,true,2514,2356,158,0,00:00:00.000,2025-04-15 09:51:47.127
false,false,2518,2360,158,123,00:00:30.000,2025-04-15 09:51:52.134
false,false,2622,2460,162,667,00:00:32.000,2025-04-15 09:54:12.274
false,false,2629,2466,163,222,00:00:30.000,2025-04-15 09:54:25.286
false,false,2654,2488,166,386,00:00:32.000,2025-04-15 09:54:56.313
false,true,2672,2505,167,0,00:00:00.000,2025-04-15 09:55:32.344
false,true,2545,2386,159,0,00:00:00.000,2025-04-15 09:52:29.168
false,false,2601,2441,160,31,00:00:31.000,2025-04-15 09:53:39.244
false,false,2737,2570,167,977,00:00:30.000,2025-04-15 09:56:55.424
false,true,2738,2570,168,0,00:00:00.000,2025-04-15 09:57:01.431
false,false,2743,2575,168,97,00:00:32.000,2025-04-15 09:57:13.446
false,true,2758,2587,171,0,00:00:00.000,2025-04-15 09:57:37.470
false,true,2786,2613,173,0,00:00:00.000,2025-04-15 09:58:11.505
false,true,2786,2613,173,0,00:00:00.000,2025-04-15 09:58:13.506
false,false,2717,2550,167,348,00:00:31.000,2025-04-15 09:56:35.398
false,false,2824,2650,174,444,00:00:31.000,2025-04-15 09:59:04.553
false,true,2839,2665,174,0,00:00:00.000,2025-04-15 09:59:24.577
false,true,2853,2679,174,0,00:00:00.000,2025-04-15 09:59:44.599
false,false,2860,2685,175,31,00:00:31.000,2025-04-15 09:59:58.614
false,false,2902,2724,178,92,00:00:32.000,2025-04-15 10:00:58.684
false,true,2927,2746,181,0,00:00:00.000,2025-04-15 10:01:40.729
false,false,3104,2917,187,309,00:00:33.000,2025-04-15 10:05:08.936
false,false,3154,2962,192,950,00:00:31.000,2025-04-15 10:06:04.987
false,false,3176,2984,192,569,00:00:33.000,2025-04-15 10:06:33.013
false,false,3179,2986,193,65,00:00:33.000,2025-04-15 10:06:42.024
false,false,3182,2989,193,157,00:00:30.000,2025-04-15 10:06:45.026
false,true,3191,2997,194,0,00:00:00.000,2025-04-15 10:06:59.038
false,false,3196,3002,194,162,00:00:32.000,2025-04-15 10:07:05.043
false,false,3225,3030,195,347,00:00:33.000,2025-04-15 10:07:58.097
false,true,3240,3044,196,0,00:00:00.000,2025-04-15 10:08:19.116
false,false,2931,2750,181,128,00:00:32.000,2025-04-15 10:01:45.731
false,false,2941,2758,183,439,00:00:33.000,2025-04-15 10:01:55.741
false,false,2973,2788,185,1457,00:00:31.000,2025-04-15 10:02:27.774
false,false,2979,2794,185,1646,00:00:31.000,2025-04-15 10:02:33.779
false,false,3001,2816,185,2340,00:00:33.000,2025-04-15 10:02:55.806
false,false,3009,2824,185,2591,00:00:32.000,2025-04-15 10:03:03.816
false,false,3013,2828,185,2720,00:00:31.000,2025-04-15 10:03:07.819
false,true,3015,2830,185,0,00:00:00.000,2025-04-15 10:03:11.824
false,true,3015,2830,185,0,00:00:00.000,2025-04-15 10:03:12.824
false,false,3021,2836,185,186,00:00:32.000,2025-04-15 10:03:21.836
false,false,3026,2841,185,344,00:00:32.000,2025-04-15 10:03:26.840
false,false,3049,2863,186,191,00:00:31.000,2025-04-15 10:04:01.863
false,false,3060,2874,186,541,00:00:33.000,2025-04-15 10:04:12.873
false,false,3076,2890,186,502,00:00:30.000,2025-04-15 10:04:34.896
false,false,3089,2903,186,914,00:00:32.000,2025-04-15 10:04:47.907
false,true,3094,2907,187,0,00:00:00.000,2025-04-15 10:04:58.922
false,false,3268,3068,200,412,00:00:31.000,2025-04-15 10:08:59.158
false,false,3274,3073,201,603,00:00:31.000,2025-04-15 10:09:05.165
false,true,3286,3085,201,0,00:00:00.000,2025-04-15 10:09:20.179
false,false,3287,3086,201,33,00:00:33.000,2025-04-15 10:09:24.183
false,false,3290,3089,201,127,00:00:30.000,2025-04-15 10:09:27.186
false,false,3291,3090,201,157,00:00:30.000,2025-04-15 10:09:28.186
false,false,3305,3103,202,598,00:00:32.000,2025-04-15 10:09:42.201
false,false,3332,3128,204,1440,00:00:30.000,2025-04-15 10:10:09.231
false,true,3334,3129,205,0,00:00:00.000,2025-04-15 10:10:16.239
false,false,3365,3160,205,286,00:00:32.000,2025-04-15 10:11:12.296
false,false,3379,3173,206,64,00:00:32.000,2025-04-15 10:11:32.314
false,false,3457,3247,210,62,00:00:31.000,2025-04-15 10:13:38.448
false,false,3483,3271,212,502,00:00:31.000,2025-04-15 10:14:10.487
false,true,3490,3278,212,0,00:00:00.000,2025-04-15 10:14:19.497
false,false,3507,3293,214,535,00:00:30.000,2025-04-15 10:14:40.521
false,true,3512,3298,214,0,00:00:00.000,2025-04-15 10:14:46.526
false,false,3513,3299,214,31,00:00:31.000,2025-04-15 10:14:52.530
false,false,3517,3302,215,155,00:00:32.000,2025-04-15 10:14:56.533
false,false,3617,3395,222,959,00:00:31.000,2025-04-15 10:17:24.687
false,true,3659,3434,225,0,00:00:00.000,2025-04-15 10:18:09.729
false,false,3667,3441,226,247,00:00:33.000,2025-04-15 10:18:20.741
false,false,3532,3317,215,33,00:00:33.000,2025-04-15 10:15:17.552
false,false,3534,3318,216,96,00:00:32.000,2025-04-15 10:15:19.556
false,true,3541,3324,217,0,00:00:00.000,2025-04-15 10:15:34.569
false,false,3544,3327,217,97,00:00:33.000,2025-04-15 10:15:41.577
false,true,3547,3330,217,0,00:00:00.000,2025-04-15 10:15:48.584
false,false,3548,3331,217,32,00:00:32.000,2025-04-15 10:15:51.587
false,false,3560,3343,217,63,00:00:33.000,2025-04-15 10:16:09.606
false,true,3575,3355,220,0,00:00:00.000,2025-04-15 10:16:27.627
false,false,3578,3358,220,91,00:00:31.000,2025-04-15 10:16:33.632
false,false,3698,3468,230,250,00:00:32.000,2025-04-15 10:19:03.788
false,false,3805,3567,238,96,00:00:32.000,2025-04-15 10:21:56.974
false,true,3807,3569,238,0,00:00:00.000,2025-04-15 10:22:04.982
false,false,3814,3576,238,91,00:00:30.000,2025-04-15 10:22:17.997
false,true,3831,3592,239,0,00:00:00.000,2025-04-15 10:22:38.015
false,false,3837,3597,240,189,00:00:33.000,2025-04-15 10:22:47.021
false,false,3845,3603,242,438,00:00:32.000,2025-04-15 10:22:55.031
false,false,3851,3607,244,627,00:00:31.000,2025-04-15 10:23:01.035
false,false,3742,3508,234,224,00:00:32.000,2025-04-15 10:20:05.853
false,false,3751,3517,234,507,00:00:33.000,2025-04-15 10:20:14.860
false,false,3757,3523,234,696,00:00:31.000,2025-04-15 10:20:20.869
false,false,3768,3534,234,1045,00:00:33.000,2025-04-15 10:20:31.883
false,false,3770,3536,234,1108,00:00:30.000,2025-04-15 10:20:33.886
false,true,3781,3544,237,0,00:00:00.000,2025-04-15 10:20:52.909
false,true,3785,3548,237,0,00:00:00.000,2025-04-15 10:21:02.921
false,true,3791,3554,237,0,00:00:00.000,2025-04-15 10:21:23.941
false,false,3393,3185,208,225,00:00:33.000,2025-04-15 10:11:52.334
false,false,3397,3189,208,347,00:00:30.000,2025-04-15 10:11:56.338
false,true,3421,3212,209,0,00:00:00.000,2025-04-15 10:12:34.383
false,true,3436,3227,209,0,00:00:00.000,2025-04-15 10:12:57.405
false,true,3437,3228,209,0,00:00:00.000,2025-04-15 10:13:04.411
false,false,3444,3235,209,220,00:00:32.000,2025-04-15 10:13:13.421
false,false,3448,3239,209,346,00:00:33.000,2025-04-15 10:13:17.423
false,false,3894,3649,245,124,00:00:31.000,2025-04-15 10:23:56.096
false,true,3905,3660,245,0,00:00:00.000,2025-04-15 10:24:08.110
false,false,3927,3681,246,312,00:00:31.000,2025-04-15 10:24:47.150
false,false,3937,3691,246,288,00:00:33.000,2025-04-15 10:25:03.165
false,false,4015,3765,250,1326,00:00:31.000,2025-04-15 10:26:45.270
false,true,4037,3785,252,0,00:00:00.000,2025-04-15 10:27:15.296
false,true,4061,3809,252,0,00:00:00.000,2025-04-15 10:27:58.340
false,false,4068,3816,252,222,00:00:33.000,2025-04-15 10:28:08.352
false,false,4078,3825,253,539,00:00:31.000,2025-04-15 10:28:18.361
false,false,4080,3827,253,600,00:00:31.000,2025-04-15 10:28:20.363
false,false,4081,3828,253,632,00:00:32.000,2025-04-15 10:28:21.364
false,true,4312,4049,263,0,00:00:00.000,2025-04-15 10:33:41.719
false,false,4323,4059,264,92,00:00:30.000,2025-04-15 10:33:59.739
false,false,4329,4065,264,284,00:00:32.000,2025-04-15 10:34:05.747
false,true,4329,4065,264,0,00:00:00.000,2025-04-15 10:34:08.751
false,false,4344,4079,265,347,00:00:33.000,2025-04-15 10:34:38.781
false,true,4237,3977,260,0,00:00:00.000,2025-04-15 10:31:57.601
false,false,4239,3977,262,64,00:00:33.000,2025-04-15 10:31:59.603
false,false,4242,3980,262,160,00:00:33.000,2025-04-15 10:32:02.607
false,false,4245,3983,262,253,00:00:32.000,2025-04-15 10:32:05.610
false,false,4277,4014,263,826,00:00:30.000,2025-04-15 10:32:43.657
false,false,4282,4019,263,986,00:00:33.000,2025-04-15 10:32:48.663
false,true,4287,4024,263,0,00:00:00.000,2025-04-15 10:32:59.675
false,true,4302,4039,263,0,00:00:00.000,2025-04-15 10:33:16.696
false,false,3941,3695,246,412,00:00:30.000,2025-04-15 10:25:07.170
false,false,3961,3714,247,600,00:00:33.000,2025-04-15 10:25:33.192
false,false,3966,3718,248,33,00:00:33.000,2025-04-15 10:25:50.212
false,false,3973,3724,249,249,00:00:31.000,2025-04-15 10:25:57.221
false,false,3977,3728,249,128,00:00:33.000,2025-04-15 10:26:07.234
false,false,3980,3731,249,223,00:00:33.000,2025-04-15 10:26:10.237
false,false,3981,3732,249,255,00:00:32.000,2025-04-15 10:26:11.238
false,false,4005,3755,250,1013,00:00:32.000,2025-04-15 10:26:35.262
false,false,4121,3868,253,98,00:00:33.000,2025-04-15 10:29:07.417
false,false,4136,3882,254,574,00:00:31.000,2025-04-15 10:29:22.433
false,false,4157,3902,255,466,00:00:30.000,2025-04-15 10:29:49.458
false,false,4162,3907,255,622,00:00:31.000,2025-04-15 10:29:54.462
false,true,4174,3919,255,0,00:00:00.000,2025-04-15 10:30:14.483
false,true,4179,3924,255,0,00:00:00.000,2025-04-15 10:30:24.497
false,false,4180,3925,255,30,00:00:30.000,2025-04-15 10:30:30.505
false,false,4192,3935,257,400,00:00:30.000,2025-04-15 10:30:42.515
false,true,4201,3944,257,0,00:00:00.000,2025-04-15 10:31:05.538
false,false,4209,3951,258,254,00:00:33.000,2025-04-15 10:31:17.551
false,false,4218,3960,258,30,00:00:30.000,2025-04-15 10:31:32.571
false,false,4382,4113,269,976,00:00:30.000,2025-04-15 10:35:28.830
false,false,4424,4152,272,250,00:00:33.000,2025-04-15 10:36:22.884
false,false,4431,4159,272,122,00:00:32.000,2025-04-15 10:36:35.895
false,true,4637,4353,284,0,00:00:00.000,2025-04-15 10:41:04.165
false,true,4637,4353,284,0,00:00:00.000,2025-04-15 10:41:05.166
false,true,4645,4360,285,0,00:00:00.000,2025-04-15 10:41:21.184
false,true,4645,4360,285,0,00:00:00.000,2025-04-15 10:41:24.186
false,false,4647,4362,285,65,00:00:33.000,2025-04-15 10:41:30.190
false,false,4459,4185,274,252,00:00:32.000,2025-04-15 10:37:09.931
false,true,4474,4199,275,0,00:00:00.000,2025-04-15 10:37:35.954
false,false,4489,4213,276,464,00:00:31.000,2025-04-15 10:37:51.976
false,true,4537,4258,279,0,00:00:00.000,2025-04-15 10:38:44.025
false,false,4569,4290,279,919,00:00:30.000,2025-04-15 10:39:24.060
false,false,4602,4322,280,381,00:00:32.000,2025-04-15 10:40:03.101
false,true,4679,4393,286,0,00:00:00.000,2025-04-15 10:42:20.237
false,false,4683,4396,287,128,00:00:31.000,2025-04-15 10:42:24.241
false,false,4691,4402,289,382,00:00:33.000,2025-04-15 10:42:32.247
false,false,4704,4415,289,93,00:00:31.000,2025-04-15 10:42:57.275
false,false,4719,4427,292,563,00:00:33.000,2025-04-15 10:43:12.292
false,true,4724,4432,292,0,00:00:00.000,2025-04-15 10:43:19.297
false,false,4730,4438,292,194,00:00:32.000,2025-04-15 10:43:29.307
false,true,4732,4440,292,0,00:00:00.000,2025-04-15 10:43:37.317
false,false,4736,4444,292,128,00:00:33.000,2025-04-15 10:43:41.320
false,false,4739,4446,293,221,00:00:33.000,2025-04-15 10:43:44.323
false,false,4758,4464,294,814,00:00:31.000,2025-04-15 10:44:03.345
false,false,4765,4471,294,65,00:00:33.000,2025-04-15 10:44:16.362
false,true,4770,4476,294,0,00:00:00.000,2025-04-15 10:44:23.370
false,true,4776,4482,294,0,00:00:00.000,2025-04-15 10:44:38.388
false,false,4789,4495,294,411,00:00:33.000,2025-04-15 10:44:52.400
false,false,4790,4496,294,443,00:00:32.000,2025-04-15 10:44:53.401
false,false,4801,4506,295,788,00:00:30.000,2025-04-15 10:45:04.412
false,false,4819,4524,295,160,00:00:32.000,2025-04-15 10:45:34.438
false,false,4822,4527,295,255,00:00:33.000,2025-04-15 10:45:37.440
false,false,4832,4537,295,190,00:00:30.000,2025-04-15 10:45:59.461
false,false,4835,4540,295,286,00:00:33.000,2025-04-15 10:46:02.465
false,true,4837,4541,296,0,00:00:00.000,2025-04-15 10:46:06.469
false,true,4839,4543,296,0,00:00:00.000,2025-04-15 10:46:13.473
false,true,4839,4543,296,0,00:00:00.000,2025-04-15 10:46:17.478
false,false,4858,4560,298,218,00:00:30.000,2025-04-15 10:46:43.512
false,true,4871,4572,299,0,00:00:00.000,2025-04-15 10:47:01.531
false,false,4880,4581,299,286,00:00:33.000,2025-04-15 10:47:11.543
false,false,4892,4592,300,667,00:00:32.000,2025-04-15 10:47:23.558
false,false,4898,4598,300,853,00:00:32.000,2025-04-15 10:47:29.564
false,false,4900,4600,300,914,00:00:30.000,2025-04-15 10:47:31.566
false,false,4902,4602,300,977,00:00:30.000,2025-04-15 10:47:33.571
false,false,4909,4609,300,1195,00:00:32.000,2025-04-15 10:47:40.578
false,false,4916,4615,301,153,00:00:30.000,2025-04-15 10:47:53.591
false,false,5324,4989,335,660,00:00:30.000,2025-04-15 10:56:48.129
false,false,5331,4996,335,883,00:00:30.000,2025-04-15 10:56:55.138
false,false,5335,5000,335,33,00:00:33.000,2025-04-15 10:57:05.146
false,false,5336,5001,335,64,00:00:31.000,2025-04-15 10:57:06.148
false,false,5350,5015,335,126,00:00:30.000,2025-04-15 10:57:26.166
false,false,5352,5017,335,189,00:00:33.000,2025-04-15 10:57:28.169
false,false,5354,5019,335,254,00:00:32.000,2025-04-15 10:57:30.170
false,false,5379,5041,338,484,00:00:33.000,2025-04-15 10:58:01.199
false,false,5097,4781,316,442,00:00:33.000,2025-04-15 10:51:54.850
false,false,5106,4788,318,724,00:00:32.000,2025-04-15 10:52:03.857
false,false,5109,4791,318,819,00:00:30.000,2025-04-15 10:52:06.860
false,true,5115,4797,318,0,00:00:00.000,2025-04-15 10:52:24.878
false,false,5117,4799,318,30,00:00:30.000,2025-04-15 10:52:32.882
false,false,5119,4801,318,94,00:00:31.000,2025-04-15 10:52:34.883
false,false,5120,4802,318,124,00:00:30.000,2025-04-15 10:52:35.885
false,false,5133,4813,320,531,00:00:32.000,2025-04-15 10:52:48.902
false,true,1978,1857,121,0,00:00:00.000,2025-04-15 09:39:14.361
false,true,1989,1867,122,0,00:00:00.000,2025-04-15 09:39:38.379
false,false,1998,1876,122,63,00:00:30.000,2025-04-15 09:39:53.394
false,false,2011,1889,122,473,00:00:31.000,2025-04-15 09:40:06.408
false,false,2027,1902,125,980,00:00:31.000,2025-04-15 09:40:22.426
false,true,2330,2183,147,0,00:00:00.000,2025-04-15 09:47:28.863
false,false,2378,2228,150,506,00:00:30.000,2025-04-15 09:48:31.932
false,false,2394,2243,151,218,00:00:30.000,2025-04-15 09:48:53.958
false,false,2287,2142,145,159,00:00:33.000,2025-04-15 09:45:54.764
false,false,2288,2143,145,191,00:00:32.000,2025-04-15 09:45:55.766
false,true,2291,2146,145,0,00:00:00.000,2025-04-15 09:46:07.781
false,true,2310,2163,147,0,00:00:00.000,2025-04-15 09:46:43.812
false,true,2312,2165,147,0,00:00:00.000,2025-04-15 09:46:51.821
false,true,2312,2165,147,0,00:00:00.000,2025-04-15 09:46:54.823
false,false,2234,2094,140,4520,00:00:30.000,2025-04-15 09:44:07.664
false,false,2237,2097,140,4615,00:00:32.000,2025-04-15 09:44:10.666
false,false,2244,2104,140,63,00:00:33.000,2025-04-15 09:44:23.681
false,true,2246,2106,140,0,00:00:00.000,2025-04-15 09:44:37.690
false,false,2257,2116,141,191,00:00:31.000,2025-04-15 09:45:00.711
false,true,2257,2116,141,0,00:00:00.000,2025-04-15 09:45:03.714
false,false,2275,2132,143,352,00:00:32.000,2025-04-15 09:45:30.744
false,false,2282,2137,145,573,00:00:32.000,2025-04-15 09:45:37.750
false,false,2409,2257,152,312,00:00:31.000,2025-04-15 09:49:14.980
false,false,2423,2271,152,749,00:00:30.000,2025-04-15 09:49:28.993
false,false,2443,2288,155,1382,00:00:33.000,2025-04-15 09:49:49.011
false,false,2462,2307,155,1982,00:00:32.000,2025-04-15 09:50:08.027
false,true,2465,2310,155,0,00:00:00.000,2025-04-15 09:50:14.031
false,true,2465,2310,155,0,00:00:00.000,2025-04-15 09:50:17.032
false,true,2468,2313,155,0,00:00:00.000,2025-04-15 09:50:24.038
false,false,2500,2343,157,661,00:00:33.000,2025-04-15 09:51:22.097
false,false,2502,2345,157,722,00:00:31.000,2025-04-15 09:51:24.099
false,true,2505,2348,157,0,00:00:00.000,2025-04-15 09:51:32.109
false,false,2512,2354,158,213,00:00:32.000,2025-04-15 09:51:40.118
false,true,2514,2356,158,0,00:00:00.000,2025-04-15 09:51:48.128
false,false,2529,2371,158,474,00:00:32.000,2025-04-15 09:52:03.146
false,false,2533,2375,158,600,00:00:31.000,2025-04-15 09:52:07.149
false,false,2618,2456,162,540,00:00:30.000,2025-04-15 09:54:08.270
false,true,2622,2460,162,0,00:00:00.000,2025-04-15 09:54:15.278
false,false,2624,2462,162,64,00:00:31.000,2025-04-15 09:54:20.282
false,false,2643,2479,164,33,00:00:33.000,2025-04-15 09:54:45.302
false,false,2645,2481,164,99,00:00:33.000,2025-04-15 09:54:47.305
false,false,2661,2494,167,612,00:00:33.000,2025-04-15 09:55:03.317
false,false,2668,2501,167,837,00:00:32.000,2025-04-15 09:55:10.324
false,true,2672,2505,167,0,00:00:00.000,2025-04-15 09:55:27.338
false,true,2672,2505,167,0,00:00:00.000,2025-04-15 09:55:29.341
false,true,2545,2386,159,0,00:00:00.000,2025-04-15 09:52:26.166
false,true,2545,2386,159,0,00:00:00.000,2025-04-15 09:52:31.170
false,false,2554,2395,159,288,00:00:30.000,2025-04-15 09:52:40.180
false,false,2589,2429,160,254,00:00:33.000,2025-04-15 09:53:21.225
false,true,2600,2440,160,0,00:00:00.000,2025-04-15 09:53:38.243
false,true,2601,2441,160,0,00:00:00.000,2025-04-15 09:53:50.253
false,false,2740,2572,168,62,00:00:31.000,2025-04-15 09:57:04.436
false,false,2744,2575,169,127,00:00:30.000,2025-04-15 09:57:14.446
false,false,2767,2596,171,286,00:00:33.000,2025-04-15 09:57:49.483
false,false,2773,2602,171,471,00:00:33.000,2025-04-15 09:57:55.490
false,true,2786,2613,173,0,00:00:00.000,2025-04-15 09:58:10.505
false,false,2723,2556,167,536,00:00:33.000,2025-04-15 09:56:41.408
false,false,2798,2625,173,370,00:00:30.000,2025-04-15 09:58:26.518
false,false,2834,2660,174,760,00:00:33.000,2025-04-15 09:59:14.563
false,false,2856,2682,174,96,00:00:32.000,2025-04-15 09:59:48.603
false,false,2866,2691,175,220,00:00:33.000,2025-04-15 10:00:04.621
false,false,2868,2693,175,284,00:00:32.000,2025-04-15 10:00:06.623
false,false,2889,2712,177,441,00:00:30.000,2025-04-15 10:00:33.658
false,false,2893,2716,177,564,00:00:33.000,2025-04-15 10:00:37.665
false,true,2899,2721,178,0,00:00:00.000,2025-04-15 10:00:55.682
false,false,2916,2735,181,157,00:00:32.000,2025-04-15 10:01:18.707
false,true,2917,2736,181,0,00:00:00.000,2025-04-15 10:01:20.708
false,false,2918,2737,181,30,00:00:30.000,2025-04-15 10:01:26.714
false,true,2927,2746,181,0,00:00:00.000,2025-04-15 10:01:38.727
false,false,3111,2923,188,527,00:00:32.000,2025-04-15 10:05:15.942
false,false,3138,2948,190,445,00:00:31.000,2025-04-15 10:05:48.972
false,false,3150,2958,192,826,00:00:32.000,2025-04-15 10:06:00.984
false,false,3163,2971,192,160,00:00:30.000,2025-04-15 10:06:20.002
false,false,3165,2973,192,225,00:00:32.000,2025-04-15 10:06:22.005
false,false,3168,2976,192,317,00:00:32.000,2025-04-15 10:06:25.008
false,false,3189,2995,194,375,00:00:30.000,2025-04-15 10:06:52.033
false,false,3203,3008,195,377,00:00:32.000,2025-04-15 10:07:12.049
false,false,3209,3014,195,153,00:00:30.000,2025-04-15 10:07:24.064
false,true,3209,3014,195,0,00:00:00.000,2025-04-15 10:07:27.069
false,false,3213,3018,195,63,00:00:30.000,2025-04-15 10:07:40.084
false,false,3234,3039,195,637,00:00:32.000,2025-04-15 10:08:07.105
false,true,3240,3044,196,0,00:00:00.000,2025-04-15 10:08:16.114
false,false,2933,2752,181,191,00:00:32.000,2025-04-15 10:01:47.731
false,false,2972,2787,185,1426,00:00:31.000,2025-04-15 10:02:26.774
false,false,2994,2809,185,2121,00:00:30.000,2025-04-15 10:02:48.797
false,false,2995,2810,185,2152,00:00:31.000,2025-04-15 10:02:49.799
false,false,3003,2818,185,2402,00:00:32.000,2025-04-15 10:02:57.809
false,false,3022,2837,185,216,00:00:30.000,2025-04-15 10:03:22.836
false,true,3060,2874,186,0,00:00:00.000,2025-04-15 10:04:15.876
false,true,3060,2874,186,0,00:00:00.000,2025-04-15 10:04:17.879
false,false,3062,2876,186,64,00:00:32.000,2025-04-15 10:04:20.882
false,false,3088,2902,186,882,00:00:32.000,2025-04-15 10:04:46.906
false,false,3092,2905,187,1008,00:00:32.000,2025-04-15 10:04:50.912
false,true,3255,3057,198,0,00:00:00.000,2025-04-15 10:08:41.140
false,true,3255,3057,198,0,00:00:00.000,2025-04-15 10:08:43.143
false,false,3265,3065,200,316,00:00:31.000,2025-04-15 10:08:56.155
false,false,3300,3098,202,439,00:00:31.000,2025-04-15 10:09:37.197
false,false,3304,3102,202,566,00:00:33.000,2025-04-15 10:09:41.200
false,false,3311,3109,202,788,00:00:33.000,2025-04-15 10:09:48.208
false,false,3350,3145,205,189,00:00:31.000,2025-04-15 10:10:51.277
false,false,3364,3159,205,254,00:00:30.000,2025-04-15 10:11:11.295
false,false,3378,3172,206,32,00:00:32.000,2025-04-15 10:11:31.313
false,false,3384,3177,207,219,00:00:30.000,2025-04-15 10:11:37.321
false,false,3455,3245,210,563,00:00:31.000,2025-04-15 10:13:24.431
false,false,3462,3252,210,221,00:00:33.000,2025-04-15 10:13:43.454
false,false,3466,3256,210,349,00:00:33.000,2025-04-15 10:13:47.458
false,false,3470,3259,211,95,00:00:31.000,2025-04-15 10:13:57.471
false,false,3494,3282,212,126,00:00:33.000,2025-04-15 10:14:27.504
false,false,3594,3374,220,252,00:00:33.000,2025-04-15 10:17:01.665
false,false,3596,3376,220,314,00:00:31.000,2025-04-15 10:17:03.668
false,false,3597,3377,220,344,00:00:30.000,2025-04-15 10:17:04.669
false,false,3611,3390,221,770,00:00:30.000,2025-04-15 10:17:18.682
false,false,3629,3406,223,1337,00:00:33.000,2025-04-15 10:17:36.699
false,false,3630,3407,223,1368,00:00:31.000,2025-04-15 10:17:37.699
false,true,3659,3434,225,0,00:00:00.000,2025-04-15 10:18:10.730
false,true,3659,3434,225,0,00:00:00.000,2025-04-15 10:18:11.730
false,false,3662,3437,225,90,00:00:30.000,2025-04-15 10:18:15.735
false,true,3531,3316,215,0,00:00:00.000,2025-04-15 10:15:16.552
false,false,3547,3330,217,195,00:00:32.000,2025-04-15 10:15:44.579
false,false,3554,3337,217,224,00:00:33.000,2025-04-15 10:15:57.592
false,false,3571,3352,219,413,00:00:30.000,2025-04-15 10:16:20.619
false,true,3579,3359,220,0,00:00:00.000,2025-04-15 10:16:35.632
false,false,3675,3449,226,498,00:00:30.000,2025-04-15 10:18:28.749
false,true,3676,3450,226,0,00:00:00.000,2025-04-15 10:18:35.755
false,true,3690,3462,228,0,00:00:00.000,2025-04-15 10:18:51.773
false,false,3691,3462,229,33,00:00:33.000,2025-04-15 10:18:56.779
false,false,3693,3464,229,93,00:00:30.000,2025-04-15 10:18:58.781
false,true,3702,3471,231,0,00:00:00.000,2025-04-15 10:19:09.797
false,false,3703,3472,231,31,00:00:31.000,2025-04-15 10:19:14.802
false,true,3735,3502,233,0,00:00:00.000,2025-04-15 10:19:55.844
false,false,3817,3579,238,187,00:00:31.000,2025-04-15 10:22:20.999
false,true,3860,3616,244,0,00:00:00.000,2025-04-15 10:23:14.049
false,true,3860,3616,244,0,00:00:00.000,2025-04-15 10:23:15.051
false,false,3863,3619,244,94,00:00:31.000,2025-04-15 10:23:19.054
false,false,3756,3522,234,665,00:00:31.000,2025-04-15 10:20:19.866
false,false,3769,3535,234,1078,00:00:33.000,2025-04-15 10:20:32.885
false,false,3779,3542,237,188,00:00:30.000,2025-04-15 10:20:48.905
false,true,3786,3549,237,0,00:00:00.000,2025-04-15 10:21:09.928
false,true,3791,3554,237,0,00:00:00.000,2025-04-15 10:21:19.937
false,true,3798,3561,237,0,00:00:00.000,2025-04-15 10:21:41.959
false,true,3798,3561,237,0,00:00:00.000,2025-04-15 10:21:42.961
false,false,3391,3183,208,159,00:00:32.000,2025-04-15 10:11:50.334
false,false,3412,3204,208,446,00:00:30.000,2025-04-15 10:12:17.361
false,true,3415,3207,208,0,00:00:00.000,2025-04-15 10:12:24.368
false,false,3424,3215,209,95,00:00:30.000,2025-04-15 10:12:41.390
false,false,3430,3221,209,284,00:00:33.000,2025-04-15 10:12:47.394
false,true,3436,3227,209,0,00:00:00.000,2025-04-15 10:12:58.406
false,false,3871,3627,244,345,00:00:30.000,2025-04-15 10:23:27.062
false,false,3892,3647,245,62,00:00:30.000,2025-04-15 10:23:54.093
false,true,3917,3672,245,0,00:00:00.000,2025-04-15 10:24:37.140
false,false,3934,3688,246,190,00:00:30.000,2025-04-15 10:25:00.162
false,false,4030,3778,252,342,00:00:31.000,2025-04-15 10:27:06.288
false,false,4040,3788,252,97,00:00:33.000,2025-04-15 10:27:22.304
false,true,4045,3793,252,0,00:00:00.000,2025-04-15 10:27:31.315
false,false,4071,3819,252,318,00:00:33.000,2025-04-15 10:28:11.354
false,false,4084,3831,253,725,00:00:32.000,2025-04-15 10:28:24.369
false,true,4311,4048,263,0,00:00:00.000,2025-04-15 10:33:34.713
false,true,4329,4065,264,0,00:00:00.000,2025-04-15 10:34:09.754
false,true,4344,4079,265,0,00:00:00.000,2025-04-15 10:34:41.785
false,false,4357,4091,266,190,00:00:32.000,2025-04-15 10:35:03.805
false,false,4234,3974,260,531,00:00:31.000,2025-04-15 10:31:48.589
false,true,4237,3977,260,0,00:00:00.000,2025-04-15 10:31:55.598
false,false,4266,4003,263,474,00:00:33.000,2025-04-15 10:32:32.644
false,false,4268,4005,263,538,00:00:33.000,2025-04-15 10:32:34.647
false,false,4271,4008,263,632,00:00:32.000,2025-04-15 10:32:37.650
false,false,4283,4020,263,1017,00:00:31.000,2025-04-15 10:32:49.663
false,true,4287,4024,263,0,00:00:00.000,2025-04-15 10:32:55.671
false,false,4301,4038,263,439,00:00:31.000,2025-04-15 10:33:13.692
false,false,3942,3696,246,443,00:00:31.000,2025-04-15 10:25:08.171
false,false,3950,3704,246,255,00:00:30.000,2025-04-15 10:25:22.183
false,false,3957,3710,247,474,00:00:33.000,2025-04-15 10:25:29.189
false,true,3964,3717,247,0,00:00:00.000,2025-04-15 10:25:38.198
false,true,3965,3717,248,0,00:00:00.000,2025-04-15 10:25:49.211
false,false,3990,3741,249,538,00:00:31.000,2025-04-15 10:26:20.244
false,false,4011,3761,250,1198,00:00:30.000,2025-04-15 10:26:41.267
false,false,4155,3900,255,404,00:00:30.000,2025-04-15 10:29:47.454
false,false,4156,3901,255,436,00:00:32.000,2025-04-15 10:29:48.456
false,true,4174,3919,255,0,00:00:00.000,2025-04-15 10:30:13.482
false,false,4187,3931,256,246,00:00:30.000,2025-04-15 10:30:37.510
false,false,4191,3935,256,370,00:00:30.000,2025-04-15 10:30:41.514
false,true,4192,3935,257,0,00:00:00.000,2025-04-15 10:30:44.517
false,true,4201,3944,257,0,00:00:00.000,2025-04-15 10:31:06.539
false,false,4216,3958,258,470,00:00:30.000,2025-04-15 10:31:24.561
false,true,4217,3959,258,0,00:00:00.000,2025-04-15 10:31:28.565
false,false,4228,3969,259,342,00:00:32.000,2025-04-15 10:31:42.583
false,false,4368,4101,267,539,00:00:32.000,2025-04-15 10:35:14.814
false,false,4379,4110,269,882,00:00:30.000,2025-04-15 10:35:25.827
false,false,4380,4111,269,914,00:00:32.000,2025-04-15 10:35:26.829
false,false,4384,4115,269,1040,00:00:32.000,2025-04-15 10:35:30.832
false,false,4391,4122,269,1266,00:00:32.000,2025-04-15 10:35:37.840
false,false,4423,4151,272,217,00:00:31.000,2025-04-15 10:36:21.883
false,true,4619,4336,283,0,00:00:00.000,2025-04-15 10:40:35.133
false,false,4625,4342,283,66,00:00:33.000,2025-04-15 10:40:50.152
false,true,4637,4353,284,0,00:00:00.000,2025-04-15 10:41:07.168
false,false,4638,4354,284,31,00:00:31.000,2025-04-15 10:41:09.170
false,true,4645,4360,285,0,00:00:00.000,2025-04-15 10:41:22.185
false,false,4650,4365,285,63,00:00:32.000,2025-04-15 10:41:39.201
false,true,4469,4195,274,0,00:00:00.000,2025-04-15 10:37:21.942
false,false,4470,4196,274,33,00:00:33.000,2025-04-15 10:37:26.945
false,true,4474,4199,275,0,00:00:00.000,2025-04-15 10:37:33.952
false,true,4474,4199,275,0,00:00:00.000,2025-04-15 10:37:36.955
false,false,4497,4221,276,715,00:00:32.000,2025-04-15 10:37:59.983
false,false,4520,4242,278,1446,00:00:33.000,2025-04-15 10:38:23.006
false,false,4529,4250,279,1727,00:00:33.000,2025-04-15 10:38:32.015
false,true,4537,4258,279,0,00:00:00.000,2025-04-15 10:38:42.023
false,true,4540,4261,279,0,00:00:00.000,2025-04-15 10:38:54.034
false,false,4543,4264,279,94,00:00:31.000,2025-04-15 10:38:58.037
false,false,4560,4281,279,633,00:00:32.000,2025-04-15 10:39:15.052
false,false,4575,4295,280,1110,00:00:32.000,2025-04-15 10:39:30.066
false,false,4686,4398,288,219,00:00:30.000,2025-04-15 10:42:27.245
false,true,4694,4405,289,0,00:00:00.000,2025-04-15 10:42:37.253
false,true,4701,4412,289,0,00:00:00.000,2025-04-15 10:42:49.265
false,true,4701,4412,289,0,00:00:00.000,2025-04-15 10:42:51.268
false,false,4705,4416,289,125,00:00:32.000,2025-04-15 10:42:58.276
false,false,4716,4424,292,469,00:00:31.000,2025-04-15 10:43:09.290
false,false,4727,4435,292,97,00:00:33.000,2025-04-15 10:43:26.303
false,false,4749,4456,293,536,00:00:32.000,2025-04-15 10:43:54.336
false,true,4776,4482,294,0,00:00:00.000,2025-04-15 10:44:34.383
false,false,4783,4489,294,219,00:00:33.000,2025-04-15 10:44:46.394
false,false,4795,4500,295,600,00:00:31.000,2025-04-15 10:44:58.406
false,false,4804,4509,295,883,00:00:31.000,2025-04-15 10:45:07.416
false,true,4806,4511,295,0,00:00:00.000,2025-04-15 10:45:13.419
false,false,4816,4521,295,64,00:00:31.000,2025-04-15 10:45:31.433
false,false,4840,4543,297,32,00:00:32.000,2025-04-15 10:46:19.481
false,true,4851,4553,298,0,00:00:00.000,2025-04-15 10:46:33.500
false,false,4889,4589,300,573,00:00:32.000,2025-04-15 10:47:20.555
false,false,5368,5031,337,125,00:00:30.000,2025-04-15 10:57:50.188
false,false,5376,5038,338,386,00:00:32.000,2025-04-15 10:57:58.196
false,false,5381,5043,338,546,00:00:32.000,2025-04-15 10:58:03.201
false,false,5091,4775,316,253,00:00:33.000,2025-04-15 10:51:48.845
false,false,5094,4778,316,345,00:00:32.000,2025-04-15 10:51:51.848
false,true,5110,4792,318,0,00:00:00.000,2025-04-15 10:52:08.862
false,true,5115,4797,318,0,00:00:00.000,2025-04-15 10:52:22.875
false,false,5135,4815,320,595,00:00:31.000,2025-04-15 10:52:50.904
false,false,5137,4817,320,658,00:00:31.000,2025-04-15 10:52:52.906
false,true,1989,1867,122,0,00:00:00.000,2025-04-15 09:39:35.376
false,true,1989,1867,122,0,00:00:00.000,2025-04-15 09:39:36.377
false,false,1994,1872,122,162,00:00:33.000,2025-04-15 09:39:43.384
false,true,1996,1874,122,0,00:00:00.000,2025-04-15 09:39:46.386
false,false,2003,1881,122,223,00:00:33.000,2025-04-15 09:39:58.398
false,false,2010,1888,122,442,00:00:33.000,2025-04-15 09:40:05.407
false,false,2022,1898,124,823,00:00:33.000,2025-04-15 09:40:17.421
false,false,2339,2191,148,283,00:00:31.000,2025-04-15 09:47:40.877
false,false,2357,2208,149,31,00:00:31.000,2025-04-15 09:48:04.906
false,false,2375,2225,150,413,00:00:30.000,2025-04-15 09:48:28.929
false,false,2386,2235,151,761,00:00:30.000,2025-04-15 09:48:39.943
false,false,2291,2146,145,287,00:00:30.000,2025-04-15 09:45:58.769
false,true,2291,2146,145,0,00:00:00.000,2025-04-15 09:46:08.783
false,true,2245,2105,140,0,00:00:00.000,2025-04-15 09:44:25.683
false,true,2245,2105,140,0,00:00:00.000,2025-04-15 09:44:29.685
false,true,2250,2109,141,0,00:00:00.000,2025-04-15 09:44:43.695
false,true,2251,2110,141,0,00:00:00.000,2025-04-15 09:44:53.705
false,false,2403,2252,151,126,00:00:30.000,2025-04-15 09:49:08.975
false,false,2407,2256,151,250,00:00:31.000,2025-04-15 09:49:12.978
false,false,2414,2262,152,468,00:00:30.000,2025-04-15 09:49:19.985
false,false,2416,2264,152,530,00:00:32.000,2025-04-15 09:49:21.986
false,false,2422,2270,152,719,00:00:33.000,2025-04-15 09:49:27.992
false,false,2463,2308,155,2012,00:00:30.000,2025-04-15 09:50:09.027
false,true,2468,2313,155,0,00:00:00.000,2025-04-15 09:50:32.049
false,true,2470,2315,155,0,00:00:00.000,2025-04-15 09:50:42.059
false,false,2491,2334,157,379,00:00:31.000,2025-04-15 09:51:13.091
false,false,2498,2341,157,598,00:00:32.000,2025-04-15 09:51:20.096
false,false,2521,2363,158,216,00:00:32.000,2025-04-15 09:51:55.136
false,false,2522,2364,158,249,00:00:33.000,2025-04-15 09:51:56.138
false,false,2531,2373,158,539,00:00:33.000,2025-04-15 09:52:05.148
false,true,2622,2460,162,0,00:00:00.000,2025-04-15 09:54:18.281
false,true,2642,2478,164,0,00:00:00.000,2025-04-15 09:54:43.301
false,false,2669,2502,167,869,00:00:32.000,2025-04-15 09:55:11.325
false,true,2671,2504,167,0,00:00:00.000,2025-04-15 09:55:19.333
false,true,2672,2505,167,0,00:00:00.000,2025-04-15 09:55:26.338
false,true,2672,2505,167,0,00:00:00.000,2025-04-15 09:55:30.341
false,true,2676,2509,167,0,00:00:00.000,2025-04-15 09:55:40.352
false,false,2547,2388,159,64,00:00:31.000,2025-04-15 09:52:33.173
false,false,2575,2415,160,944,00:00:31.000,2025-04-15 09:53:01.200
false,false,2584,2424,160,93,00:00:32.000,2025-04-15 09:53:16.219
false,false,2585,2425,160,125,00:00:32.000,2025-04-15 09:53:17.221
false,false,2588,2428,160,221,00:00:33.000,2025-04-15 09:53:20.224
false,true,2601,2441,160,0,00:00:00.000,2025-04-15 09:53:41.244
false,false,2602,2442,160,31,00:00:31.000,2025-04-15 09:53:52.256
false,false,2731,2564,167,788,00:00:32.000,2025-04-15 09:56:49.415
false,true,2740,2572,168,0,00:00:00.000,2025-04-15 09:57:09.442
false,true,2749,2579,170,0,00:00:00.000,2025-04-15 09:57:24.457
false,false,2750,2580,170,30,00:00:30.000,2025-04-15 09:57:26.459
false,false,2806,2633,173,621,00:00:31.000,2025-04-15 09:58:34.525
false,true,2810,2636,174,0,00:00:00.000,2025-04-15 09:58:47.538
false,false,2811,2637,174,32,00:00:32.000,2025-04-15 09:58:51.542
false,false,2813,2639,174,98,00:00:33.000,2025-04-15 09:58:53.543
false,false,2822,2648,174,383,00:00:31.000,2025-04-15 09:59:02.551
false,true,2839,2665,174,0,00:00:00.000,2025-04-15 09:59:20.572
false,true,2853,2679,174,0,00:00:00.000,2025-04-15 09:59:45.599
false,false,2858,2684,174,158,00:00:31.000,2025-04-15 09:59:50.606
false,true,2895,2717,178,0,00:00:00.000,2025-04-15 10:00:43.670
false,true,2911,2731,180,0,00:00:00.000,2025-04-15 10:01:09.696
false,false,2913,2732,181,61,00:00:30.000,2025-04-15 10:01:15.704
false,false,3136,2947,189,382,00:00:33.000,2025-04-15 10:05:46.971
false,false,3157,2965,192,1046,00:00:30.000,2025-04-15 10:06:07.990
false,true,3177,2985,192,0,00:00:00.000,2025-04-15 10:06:40.023
false,false,3187,2993,194,313,00:00:30.000,2025-04-15 10:06:50.030
false,false,3188,2994,194,345,00:00:32.000,2025-04-15 10:06:51.032
false,false,3192,2998,194,32,00:00:32.000,2025-04-15 10:07:01.041
false,true,3209,3014,195,0,00:00:00.000,2025-04-15 10:07:26.067
false,true,3214,3019,195,0,00:00:00.000,2025-04-15 10:07:42.086
false,false,3215,3020,195,33,00:00:33.000,2025-04-15 10:07:48.087
false,false,3221,3026,195,219,00:00:31.000,2025-04-15 10:07:54.093
false,false,2942,2759,183,472,00:00:33.000,2025-04-15 10:01:56.741
false,false,2955,2771,184,882,00:00:33.000,2025-04-15 10:02:09.757
false,false,2968,2784,184,1297,00:00:33.000,2025-04-15 10:02:22.771
false,false,2975,2790,185,1519,00:00:30.000,2025-04-15 10:02:29.775
false,false,2984,2799,185,1805,00:00:32.000,2025-04-15 10:02:38.786
false,false,3023,2838,185,248,00:00:32.000,2025-04-15 10:03:23.837
false,false,3028,2842,186,407,00:00:30.000,2025-04-15 10:03:28.841
false,true,3035,2849,186,0,00:00:00.000,2025-04-15 10:03:40.848
false,false,3041,2855,186,190,00:00:31.000,2025-04-15 10:03:47.855
false,true,3043,2857,186,0,00:00:00.000,2025-04-15 10:03:52.859
false,false,3047,2861,186,127,00:00:32.000,2025-04-15 10:03:59.861
false,false,3058,2872,186,476,00:00:31.000,2025-04-15 10:04:10.872
false,false,3078,2892,186,567,00:00:33.000,2025-04-15 10:04:36.899
false,false,3266,3066,200,349,00:00:33.000,2025-04-15 10:08:57.156
false,false,3295,3093,202,287,00:00:33.000,2025-04-15 10:09:32.193
false,false,3307,3105,202,661,00:00:32.000,2025-04-15 10:09:44.204
false,false,3308,3106,202,692,00:00:31.000,2025-04-15 10:09:45.205
false,false,3319,3116,203,1039,00:00:32.000,2025-04-15 10:09:56.215
false,false,3340,3135,205,65,00:00:32.000,2025-04-15 10:10:29.254
false,false,3346,3141,205,62,00:00:31.000,2025-04-15 10:10:47.273
false,false,3362,3157,205,192,00:00:31.000,2025-04-15 10:11:09.293
false,false,3471,3260,211,128,00:00:33.000,2025-04-15 10:13:58.473
false,false,3479,3267,212,379,00:00:31.000,2025-04-15 10:14:06.483
false,false,3659,3434,225,2276,00:00:32.000,2025-04-15 10:18:06.726
false,true,3536,3320,216,0,00:00:00.000,2025-04-15 10:15:23.557
false,true,3547,3330,217,0,00:00:00.000,2025-04-15 10:15:49.585
false,false,3562,3344,218,127,00:00:32.000,2025-04-15 10:16:11.609
false,false,3563,3345,218,160,00:00:33.000,2025-04-15 10:16:12.610
false,false,3564,3346,218,190,00:00:30.000,2025-04-15 10:16:13.611
false,false,3565,3347,218,221,00:00:31.000,2025-04-15 10:16:14.612
false,true,3575,3355,220,0,00:00:00.000,2025-04-15 10:16:28.628
false,true,3575,3355,220,0,00:00:00.000,2025-04-15 10:16:29.628
false,false,3672,3446,226,406,00:00:30.000,2025-04-15 10:18:25.746
false,false,3690,3462,228,441,00:00:33.000,2025-04-15 10:18:49.772
false,false,3694,3465,229,126,00:00:33.000,2025-04-15 10:18:59.783
false,false,3706,3474,232,127,00:00:33.000,2025-04-15 10:19:17.804
false,true,3802,3564,238,0,00:00:00.000,2025-04-15 10:21:49.967
false,true,3811,3573,238,0,00:00:00.000,2025-04-15 10:22:11.990
false,false,3821,3583,238,316,00:00:33.000,2025-04-15 10:22:25.003
false,false,3833,3594,239,63,00:00:31.000,2025-04-15 10:22:43.019
false,true,3773,3538,235,0,00:00:00.000,2025-04-15 10:20:41.897
false,true,3785,3548,237,0,00:00:00.000,2025-04-15 10:21:01.920
false,false,3796,3559,237,160,00:00:33.000,2025-04-15 10:21:29.945
false,false,3387,3179,208,30,00:00:30.000,2025-04-15 10:11:46.330
false,false,3395,3187,208,285,00:00:30.000,2025-04-15 10:11:54.336
false,false,3414,3206,208,508,00:00:32.000,2025-04-15 10:12:19.363
false,false,3870,3626,244,315,00:00:31.000,2025-04-15 10:23:26.061
false,false,3888,3643,245,884,00:00:33.000,2025-04-15 10:23:44.079
false,true,3890,3645,245,0,00:00:00.000,2025-04-15 10:23:48.083
false,false,3901,3656,245,346,00:00:31.000,2025-04-15 10:24:03.105
false,true,3905,3660,245,0,00:00:00.000,2025-04-15 10:24:09.111
false,false,3906,3661,245,33,00:00:33.000,2025-04-15 10:24:14.118
false,false,3912,3667,245,225,00:00:31.000,2025-04-15 10:24:20.123
false,false,3915,3670,245,32,00:00:32.000,2025-04-15 10:24:29.130
false,true,4019,3769,250,0,00:00:00.000,2025-04-15 10:26:52.277
false,false,4029,3777,252,311,00:00:32.000,2025-04-15 10:27:05.287
false,false,4033,3781,252,437,00:00:32.000,2025-04-15 10:27:09.290
false,false,4037,3785,252,559,00:00:30.000,2025-04-15 10:27:13.293
false,false,4044,3792,252,220,00:00:30.000,2025-04-15 10:27:26.310
false,false,4055,3803,252,313,00:00:31.000,2025-04-15 10:27:43.325
false,true,4055,3803,252,0,00:00:00.000,2025-04-15 10:27:48.330
false,true,4329,4065,264,0,00:00:00.000,2025-04-15 10:34:11.756
false,false,4337,4072,265,125,00:00:31.000,2025-04-15 10:34:31.773
false,false,4348,4083,265,123,00:00:30.000,2025-04-15 10:34:48.790
false,true,4237,3977,260,0,00:00:00.000,2025-04-15 10:31:53.595
false,false,4243,3981,262,191,00:00:31.000,2025-04-15 10:32:03.608
false,false,4247,3985,262,316,00:00:32.000,2025-04-15 10:32:07.613
false,false,4257,3994,263,192,00:00:31.000,2025-04-15 10:32:23.635
false,false,4263,4000,263,376,00:00:31.000,2025-04-15 10:32:29.640
false,false,4272,4009,263,665,00:00:33.000,2025-04-15 10:32:38.651
false,false,4285,4022,263,1077,00:00:30.000,2025-04-15 10:32:51.665
false,true,4302,4039,263,0,00:00:00.000,2025-04-15 10:33:20.701
false,false,4303,4040,263,30,00:00:30.000,2025-04-15 10:33:21.701
false,false,4305,4042,263,90,00:00:30.000,2025-04-15 10:33:23.704
false,false,3953,3707,246,346,00:00:30.000,2025-04-15 10:25:25.187
false,true,3964,3717,247,0,00:00:00.000,2025-04-15 10:25:39.199
false,true,3965,3717,248,0,00:00:00.000,2025-04-15 10:25:45.206
false,true,3965,3717,248,0,00:00:00.000,2025-04-15 10:25:48.210
false,false,3995,3745,250,696,00:00:31.000,2025-04-15 10:26:25.252
false,false,3999,3749,250,823,00:00:31.000,2025-04-15 10:26:29.255
false,false,4013,3763,250,1262,00:00:31.000,2025-04-15 10:26:43.268
false,false,4088,3835,253,850,00:00:33.000,2025-04-15 10:28:28.374
false,false,4111,3858,253,1565,00:00:33.000,2025-04-15 10:28:51.399
false,true,4142,3888,254,0,00:00:00.000,2025-04-15 10:29:32.440
false,false,4144,3890,254,65,00:00:33.000,2025-04-15 10:29:36.443
false,true,4164,3909,255,0,00:00:00.000,2025-04-15 10:29:59.467
false,true,4179,3924,255,0,00:00:00.000,2025-04-15 10:30:25.498
false,true,4192,3935,257,0,00:00:00.000,2025-04-15 10:30:43.515
false,true,4194,3937,257,0,00:00:00.000,2025-04-15 10:30:53.526
false,false,4207,3949,258,190,00:00:31.000,2025-04-15 10:31:15.550
false,false,4214,3956,258,410,00:00:31.000,2025-04-15 10:31:22.559
false,false,4220,3962,258,92,00:00:31.000,2025-04-15 10:31:34.573
false,false,4360,4093,267,284,00:00:32.000,2025-04-15 10:35:06.808
false,false,4378,4109,269,852,00:00:32.000,2025-04-15 10:35:24.827
false,false,4399,4129,270,1513,00:00:30.000,2025-04-15 10:35:45.848
false,false,4400,4130,270,1544,00:00:31.000,2025-04-15 10:35:46.849
false,false,4408,4137,271,161,00:00:33.000,2025-04-15 10:36:00.866
false,true,4416,4145,271,0,00:00:00.000,2025-04-15 10:36:13.876
false,false,4434,4162,272,215,00:00:30.000,2025-04-15 10:36:38.899
false,false,4644,4359,285,224,00:00:33.000,2025-04-15 10:41:15.178
false,false,4654,4369,285,191,00:00:33.000,2025-04-15 10:41:43.206
false,false,4446,4173,273,593,00:00:33.000,2025-04-15 10:36:50.911
false,false,4460,4186,274,285,00:00:33.000,2025-04-15 10:37:10.932
false,true,4469,4195,274,0,00:00:00.000,2025-04-15 10:37:20.940
false,true,4474,4199,275,0,00:00:00.000,2025-04-15 10:37:32.952
false,false,4475,4200,275,30,00:00:30.000,2025-04-15 10:37:37.956
false,false,4476,4201,275,60,00:00:30.000,2025-04-15 10:37:38.957
false,false,4480,4205,275,186,00:00:30.000,2025-04-15 10:37:42.964
false,false,4485,4210,275,340,00:00:31.000,2025-04-15 10:37:47.971
false,false,4499,4222,277,778,00:00:31.000,2025-04-15 10:38:01.984
false,false,4510,4232,278,1128,00:00:32.000,2025-04-15 10:38:12.995
false,false,4544,4265,279,125,00:00:31.000,2025-04-15 10:38:59.037
false,false,4546,4267,279,187,00:00:31.000,2025-04-15 10:39:01.038
false,false,4570,4291,279,950,00:00:31.000,2025-04-15 10:39:25.061
false,false,4571,4292,279,983,00:00:33.000,2025-04-15 10:39:26.062
false,false,4584,4304,280,1391,00:00:30.000,2025-04-15 10:39:39.073
false,false,4669,4383,286,123,00:00:30.000,2025-04-15 10:42:04.226
false,true,4679,4393,286,0,00:00:00.000,2025-04-15 10:42:18.235
false,false,4698,4409,289,126,00:00:32.000,2025-04-15 10:42:45.259
false,false,4710,4420,290,282,00:00:33.000,2025-04-15 10:43:03.282
false,true,4732,4440,292,0,00:00:00.000,2025-04-15 10:43:35.316
false,true,4732,4440,292,0,00:00:00.000,2025-04-15 10:43:36.317
false,false,4741,4448,293,284,00:00:33.000,2025-04-15 10:43:46.325
false,false,4767,4473,294,128,00:00:33.000,2025-04-15 10:44:18.366
false,false,4769,4475,294,192,00:00:33.000,2025-04-15 10:44:20.368
false,false,4776,4482,294,188,00:00:31.000,2025-04-15 10:44:33.382
false,false,4782,4488,294,186,00:00:30.000,2025-04-15 10:44:45.393
false,false,4784,4490,294,252,00:00:33.000,2025-04-15 10:44:47.396
false,false,4814,4519,295,250,00:00:31.000,2025-04-15 10:45:23.427
false,true,4814,4519,295,0,00:00:00.000,2025-04-15 10:45:24.427
false,false,4817,4522,295,95,00:00:31.000,2025-04-15 10:45:32.434
false,true,4826,4531,295,0,00:00:00.000,2025-04-15 10:45:48.450
false,false,4830,4535,295,127,00:00:32.000,2025-04-15 10:45:57.458
false,true,4839,4543,296,0,00:00:00.000,2025-04-15 10:46:16.478
false,true,4851,4553,298,0,00:00:00.000,2025-04-15 10:46:36.506
false,false,4859,4561,298,248,00:00:30.000,2025-04-15 10:46:44.512
false,false,4870,4571,299,593,00:00:32.000,2025-04-15 10:46:55.525
false,false,4876,4577,299,155,00:00:30.000,2025-04-15 10:47:07.539
false,false,4878,4579,299,221,00:00:33.000,2025-04-15 10:47:09.542
false,false,4882,4583,299,348,00:00:31.000,2025-04-15 10:47:13.547
false,false,4936,4632,304,32,00:00:32.000,2025-04-15 10:48:19.618
false,true,4938,4634,304,0,00:00:00.000,2025-04-15 10:48:23.621
false,true,5334,4999,335,0,00:00:00.000,2025-04-15 10:57:03.144
false,true,5346,5011,335,0,00:00:00.000,2025-04-15 10:57:21.159
false,true,5346,5011,335,0,00:00:00.000,2025-04-15 10:57:22.160
false,false,5360,5024,336,446,00:00:33.000,2025-04-15 10:57:36.176
false,false,5378,5040,338,451,00:00:32.000,2025-04-15 10:58:00.198
false,false,5102,4784,318,601,00:00:31.000,2025-04-15 10:51:59.855
false,false,5112,4794,318,64,00:00:33.000,2025-04-15 10:52:15.869
false,false,5139,4819,320,720,00:00:31.000,2025-04-15 10:52:54.907
false,false,1978,1857,121,98,00:00:32.000,2025-04-15 09:39:09.356
false,false,1980,1859,121,66,00:00:33.000,2025-04-15 09:39:17.362
false,false,1985,1863,122,223,00:00:33.000,2025-04-15 09:39:22.366
false,false,1986,1864,122,256,00:00:33.000,2025-04-15 09:39:23.367
false,true,1988,1866,122,0,00:00:00.000,2025-04-15 09:39:27.369
false,true,1996,1874,122,0,00:00:00.000,2025-04-15 09:39:51.392
false,false,2020,1897,123,759,00:00:32.000,2025-04-15 09:40:15.419
false,false,2035,1910,125,1233,00:00:33.000,2025-04-15 09:40:30.437
false,false,2330,2183,147,129,00:00:33.000,2025-04-15 09:47:25.861
false,false,2341,2193,148,347,00:00:32.000,2025-04-15 09:47:42.878
false,false,2342,2194,148,380,00:00:33.000,2025-04-15 09:47:43.880
false,false,2387,2236,151,791,00:00:30.000,2025-04-15 09:48:40.944
false,true,2291,2146,145,0,00:00:00.000,2025-04-15 09:46:01.771
false,true,2291,2146,145,0,00:00:00.000,2025-04-15 09:46:03.774
false,true,2298,2152,146,0,00:00:00.000,2025-04-15 09:46:26.797
false,true,2298,2152,146,0,00:00:00.000,2025-04-15 09:46:29.797
false,false,2304,2157,147,191,00:00:30.000,2025-04-15 09:46:35.806
false,true,2312,2165,147,0,00:00:00.000,2025-04-15 09:46:57.825
false,true,2246,2106,140,0,00:00:00.000,2025-04-15 09:44:32.687
false,true,2246,2106,140,0,00:00:00.000,2025-04-15 09:44:36.689
false,true,2250,2109,141,0,00:00:00.000,2025-04-15 09:44:44.696
false,true,2251,2110,141,0,00:00:00.000,2025-04-15 09:44:50.702
false,false,2256,2115,141,160,00:00:30.000,2025-04-15 09:44:59.711
false,true,2257,2116,141,0,00:00:00.000,2025-04-15 09:45:02.713
false,true,2257,2116,141,0,00:00:00.000,2025-04-15 09:45:06.716
false,false,2402,2251,151,96,00:00:33.000,2025-04-15 09:49:07.974
false,false,2448,2293,155,1539,00:00:31.000,2025-04-15 09:49:54.015
false,true,2468,2313,155,0,00:00:00.000,2025-04-15 09:50:31.047
false,false,2475,2319,156,154,00:00:31.000,2025-04-15 09:50:51.070
false,false,2495,2338,157,504,00:00:30.000,2025-04-15 09:51:17.095
false,true,2505,2348,157,0,00:00:00.000,2025-04-15 09:51:33.111
false,false,2535,2376,159,663,00:00:30.000,2025-04-15 09:52:09.150
false,true,2642,2478,164,0,00:00:00.000,2025-04-15 09:54:42.301
false,true,2671,2504,167,0,00:00:00.000,2025-04-15 09:55:17.331
false,true,2672,2505,167,0,00:00:00.000,2025-04-15 09:55:22.335
false,false,2673,2506,167,31,00:00:31.000,2025-04-15 09:55:33.345
false,false,2550,2391,159,163,00:00:33.000,2025-04-15 09:52:36.177
false,false,2551,2392,159,195,00:00:32.000,2025-04-15 09:52:37.177
false,false,2557,2398,159,383,00:00:30.000,2025-04-15 09:52:43.184
false,false,2558,2399,159,413,00:00:30.000,2025-04-15 09:52:44.185
false,false,2559,2400,159,445,00:00:32.000,2025-04-15 09:52:45.186
false,false,2574,2414,160,913,00:00:30.000,2025-04-15 09:53:00.199
false,false,2582,2422,160,31,00:00:31.000,2025-04-15 09:53:14.218
false,true,2600,2440,160,0,00:00:00.000,2025-04-15 09:53:33.235
false,true,2601,2441,160,0,00:00:00.000,2025-04-15 09:53:43.247
false,false,2613,2452,161,383,00:00:32.000,2025-04-15 09:54:03.266
false,true,2740,2572,168,0,00:00:00.000,2025-04-15 09:57:08.441
false,true,2740,2572,168,0,00:00:00.000,2025-04-15 09:57:10.443
false,false,2756,2585,171,220,00:00:33.000,2025-04-15 09:57:32.466
false,false,2775,2604,171,534,00:00:32.000,2025-04-15 09:57:57.492
false,false,2777,2605,172,596,00:00:31.000,2025-04-15 09:57:59.497
false,false,2788,2615,173,65,00:00:33.000,2025-04-15 09:58:16.509
false,true,2809,2635,174,0,00:00:00.000,2025-04-15 09:58:40.532
false,false,2846,2672,174,224,00:00:31.000,2025-04-15 09:59:32.583
false,false,2849,2675,174,323,00:00:33.000,2025-04-15 09:59:35.587
false,false,2855,2681,174,64,00:00:33.000,2025-04-15 09:59:47.602
false,false,2857,2683,174,127,00:00:31.000,2025-04-15 09:59:49.605
false,false,2864,2689,175,155,00:00:32.000,2025-04-15 10:00:02.618
false,false,2867,2692,175,252,00:00:32.000,2025-04-15 10:00:05.622
false,false,2873,2697,176,445,00:00:33.000,2025-04-15 10:00:11.629
false,true,2875,2699,176,0,00:00:00.000,2025-04-15 10:00:18.638
false,false,2878,2702,176,95,00:00:30.000,2025-04-15 10:00:22.645
false,false,2883,2707,176,255,00:00:31.000,2025-04-15 10:00:27.650
false,false,2897,2719,178,63,00:00:32.000,2025-04-15 10:00:47.675
false,true,2899,2721,178,0,00:00:00.000,2025-04-15 10:00:50.678
false,true,2899,2721,178,0,00:00:00.000,2025-04-15 10:00:52.680
false,true,2899,2721,178,0,00:00:00.000,2025-04-15 10:00:53.680
false,false,2927,2746,181,314,00:00:30.000,2025-04-15 10:01:35.726
false,false,2928,2747,181,33,00:00:33.000,2025-04-15 10:01:42.729
false,false,3105,2918,187,340,00:00:31.000,2025-04-15 10:05:09.936
false,false,3114,2926,188,623,00:00:33.000,2025-04-15 10:05:18.946
false,true,3158,2966,192,0,00:00:00.000,2025-04-15 10:06:10.994
false,false,3169,2977,192,347,00:00:30.000,2025-04-15 10:06:26.008
false,false,3177,2985,192,602,00:00:33.000,2025-04-15 10:06:34.015
false,true,3177,2985,192,0,00:00:00.000,2025-04-15 10:06:38.020
false,false,3184,2991,193,219,00:00:30.000,2025-04-15 10:06:47.026
false,false,3197,3003,194,192,00:00:30.000,2025-04-15 10:07:06.044
false,false,3200,3005,195,284,00:00:30.000,2025-04-15 10:07:09.048
false,true,3211,3016,195,0,00:00:00.000,2025-04-15 10:07:33.075
false,false,3222,3027,195,251,00:00:32.000,2025-04-15 10:07:55.094
false,false,3239,3043,196,791,00:00:30.000,2025-04-15 10:08:12.111
false,false,2934,2753,181,223,00:00:32.000,2025-04-15 10:01:48.732
false,false,2947,2764,183,635,00:00:33.000,2025-04-15 10:02:01.748
false,false,3000,2815,185,2307,00:00:31.000,2025-04-15 10:02:54.804
false,false,3034,2848,186,597,00:00:33.000,2025-04-15 10:03:34.843
false,true,3035,2849,186,0,00:00:00.000,2025-04-15 10:03:41.850
false,true,3043,2857,186,0,00:00:00.000,2025-04-15 10:03:55.860
false,false,3048,2862,186,160,00:00:33.000,2025-04-15 10:04:00.862
false,true,3060,2874,186,0,00:00:00.000,2025-04-15 10:04:16.877
false,false,3077,2891,186,534,00:00:32.000,2025-04-15 10:04:35.897
false,false,3079,2893,186,598,00:00:31.000,2025-04-15 10:04:37.900
false,false,3080,2894,186,631,00:00:33.000,2025-04-15 10:04:38.901
false,false,3093,2906,187,1039,00:00:31.000,2025-04-15 10:04:51.912
false,false,3272,3071,201,539,00:00:31.000,2025-04-15 10:09:03.162
false,false,3275,3074,201,636,00:00:33.000,2025-04-15 10:09:06.166
false,false,3284,3083,201,918,00:00:30.000,2025-04-15 10:09:15.175
false,false,3289,3088,201,97,00:00:32.000,2025-04-15 10:09:26.185
false,false,3296,3094,202,318,00:00:31.000,2025-04-15 10:09:33.194
false,false,3320,3117,203,1069,00:00:30.000,2025-04-15 10:09:57.217
false,true,3338,3133,205,0,00:00:00.000,2025-04-15 10:10:25.250
false,true,3340,3135,205,0,00:00:00.000,2025-04-15 10:10:32.257
false,true,3340,3135,205,0,00:00:00.000,2025-04-15 10:10:34.260
false,false,3352,3147,205,252,00:00:33.000,2025-04-15 10:10:53.278
false,false,3372,3166,206,512,00:00:32.000,2025-04-15 10:11:19.302
false,true,3455,3245,210,0,00:00:00.000,2025-04-15 10:13:31.440
false,false,3472,3261,211,158,00:00:30.000,2025-04-15 10:13:59.474
false,false,3484,3272,212,534,00:00:32.000,2025-04-15 10:14:11.488
false,true,3490,3278,212,0,00:00:00.000,2025-04-15 10:14:21.501
false,true,3490,3278,212,0,00:00:00.000,2025-04-15 10:14:23.500
false,false,3492,3280,212,62,00:00:31.000,2025-04-15 10:14:25.502
false,false,3496,3283,213,190,00:00:32.000,2025-04-15 10:14:29.506
false,false,3504,3290,214,445,00:00:32.000,2025-04-15 10:14:37.517
false,false,3508,3294,214,567,00:00:32.000,2025-04-15 10:14:41.522
false,true,3512,3298,214,0,00:00:00.000,2025-04-15 10:14:51.530
false,false,3598,3378,220,375,00:00:31.000,2025-04-15 10:17:05.671
false,false,3616,3394,222,928,00:00:32.000,2025-04-15 10:17:23.686
false,false,3620,3398,222,1056,00:00:32.000,2025-04-15 10:17:27.688
false,false,3623,3400,223,1150,00:00:31.000,2025-04-15 10:17:30.691
false,false,3639,3415,224,1649,00:00:30.000,2025-04-15 10:17:46.709
false,false,3646,3421,225,1867,00:00:30.000,2025-04-15 10:17:53.714
false,true,3531,3316,215,0,00:00:00.000,2025-04-15 10:15:11.546
false,true,3536,3320,216,0,00:00:00.000,2025-04-15 10:15:22.557
false,false,3558,3341,217,348,00:00:31.000,2025-04-15 10:16:01.597
false,false,3680,3453,227,125,00:00:32.000,2025-04-15 10:18:39.760
false,true,3690,3462,228,0,00:00:00.000,2025-04-15 10:18:53.775
false,false,3696,3467,229,188,00:00:31.000,2025-04-15 10:19:01.786
false,false,3701,3470,231,343,00:00:33.000,2025-04-15 10:19:06.793
false,true,3702,3471,231,0,00:00:00.000,2025-04-15 10:19:11.800
false,true,3702,3471,231,0,00:00:00.000,2025-04-15 10:19:12.801
false,false,3717,3484,233,475,00:00:31.000,2025-04-15 10:19:28.819
false,false,3721,3488,233,597,00:00:31.000,2025-04-15 10:19:32.822
false,false,3725,3492,233,129,00:00:32.000,2025-04-15 10:19:42.834
false,false,3727,3494,233,193,00:00:32.000,2025-04-15 10:19:44.836
false,true,3735,3502,233,0,00:00:00.000,2025-04-15 10:19:56.846
false,true,3802,3564,238,0,00:00:00.000,2025-04-15 10:21:50.968
false,false,3806,3568,238,126,00:00:30.000,2025-04-15 10:21:57.974
false,false,3827,3589,238,512,00:00:32.000,2025-04-15 10:22:31.009
false,false,3775,3540,235,64,00:00:33.000,2025-04-15 10:20:44.900
false,true,3791,3554,237,0,00:00:00.000,2025-04-15 10:21:21.941
false,true,3797,3560,237,0,00:00:00.000,2025-04-15 10:21:34.951
false,true,3798,3561,237,0,00:00:00.000,2025-04-15 10:21:39.957
false,false,3398,3190,208,379,00:00:32.000,2025-04-15 10:11:57.338
false,true,3415,3207,208,0,00:00:00.000,2025-04-15 10:12:21.365
false,true,3415,3207,208,0,00:00:00.000,2025-04-15 10:12:26.370
false,true,3437,3228,209,0,00:00:00.000,2025-04-15 10:13:03.410
false,true,3437,3228,209,0,00:00:00.000,2025-04-15 10:13:05.411
false,false,3453,3244,209,500,00:00:31.000,2025-04-15 10:13:22.429
false,false,3882,3637,245,691,00:00:32.000,2025-04-15 10:23:38.074
false,false,3883,3638,245,724,00:00:33.000,2025-04-15 10:23:39.076
false,false,3885,3640,245,787,00:00:33.000,2025-04-15 10:23:41.077
false,false,3889,3644,245,916,00:00:32.000,2025-04-15 10:23:45.080
false,false,3891,3646,245,32,00:00:32.000,2025-04-15 10:23:53.091
false,false,3900,3655,245,315,00:00:32.000,2025-04-15 10:24:02.103
false,true,3905,3660,245,0,00:00:00.000,2025-04-15 10:24:13.117
false,false,3907,3662,245,65,00:00:32.000,2025-04-15 10:24:15.119
false,false,3921,3676,245,127,00:00:33.000,2025-04-15 10:24:41.143
false,false,3926,3680,246,281,00:00:30.000,2025-04-15 10:24:46.148
false,false,3935,3689,246,222,00:00:32.000,2025-04-15 10:25:01.162
false,true,4037,3785,252,0,00:00:00.000,2025-04-15 10:27:18.300
false,false,4070,3818,252,285,00:00:30.000,2025-04-15 10:28:10.353
false,false,4308,4045,263,181,00:00:30.000,2025-04-15 10:33:26.708
false,false,4309,4046,263,213,00:00:32.000,2025-04-15 10:33:27.709
false,false,4315,4052,263,97,00:00:33.000,2025-04-15 10:33:45.723
false,true,4329,4065,264,0,00:00:00.000,2025-04-15 10:34:06.749
false,true,4333,4068,265,0,00:00:00.000,2025-04-15 10:34:17.762
false,true,4333,4068,265,0,00:00:00.000,2025-04-15 10:34:21.764
false,true,4333,4068,265,0,00:00:00.000,2025-04-15 10:34:22.766
false,false,4232,3973,259,467,00:00:31.000,2025-04-15 10:31:46.587
false,false,4233,3974,259,500,00:00:33.000,2025-04-15 10:31:47.588
false,false,4287,4024,263,1139,00:00:32.000,2025-04-15 10:32:53.668
false,false,4292,4029,263,159,00:00:30.000,2025-04-15 10:33:04.681
false,false,4304,4041,263,60,00:00:30.000,2025-04-15 10:33:22.702
false,false,3943,3697,246,32,00:00:32.000,2025-04-15 10:25:15.175
false,false,3951,3705,246,285,00:00:30.000,2025-04-15 10:25:23.186
false,false,3955,3709,246,410,00:00:33.000,2025-04-15 10:25:27.188
false,false,3978,3729,249,158,00:00:30.000,2025-04-15 10:26:08.235
false,false,3991,3742,249,571,00:00:33.000,2025-04-15 10:26:21.245
false,false,4092,3839,253,976,00:00:33.000,2025-04-15 10:28:32.379
false,false,4114,3861,253,1663,00:00:32.000,2025-04-15 10:28:54.403
false,true,4118,3865,253,0,00:00:00.000,2025-04-15 10:29:04.414
false,false,4131,3877,254,415,00:00:33.000,2025-04-15 10:29:17.429
false,false,4132,3878,254,446,00:00:31.000,2025-04-15 10:29:18.429
false,false,4161,3906,255,591,00:00:31.000,2025-04-15 10:29:53.461
false,false,4163,3908,255,653,00:00:31.000,2025-04-15 10:29:55.463
false,false,4170,3915,255,188,00:00:32.000,2025-04-15 10:30:08.475
false,true,4174,3919,255,0,00:00:00.000,2025-04-15 10:30:16.486
false,true,4179,3924,255,0,00:00:00.000,2025-04-15 10:30:28.502
false,false,4181,3926,255,62,00:00:32.000,2025-04-15 10:30:31.505
false,false,4183,3928,255,123,00:00:31.000,2025-04-15 10:30:33.508
false,false,4199,3942,257,158,00:00:33.000,2025-04-15 10:31:01.533
false,false,4226,3967,259,277,00:00:30.000,2025-04-15 10:31:40.581
false,false,4361,4094,267,316,00:00:32.000,2025-04-15 10:35:07.809
false,false,4376,4108,268,789,00:00:32.000,2025-04-15 10:35:22.826
false,false,4413,4142,271,318,00:00:31.000,2025-04-15 10:36:05.868
false,false,4609,4328,281,598,00:00:32.000,2025-04-15 10:40:10.110
false,false,4619,4336,283,33,00:00:33.000,2025-04-15 10:40:32.130
false,false,4631,4348,283,254,00:00:32.000,2025-04-15 10:40:56.156
false,false,4639,4355,284,62,00:00:31.000,2025-04-15 10:41:10.172
false,true,4645,4360,285,0,00:00:00.000,2025-04-15 10:41:23.186
false,false,4646,4361,285,32,00:00:32.000,2025-04-15 10:41:29.189
false,false,4469,4195,274,570,00:00:31.000,2025-04-15 10:37:19.941
false,false,4494,4218,276,617,00:00:30.000,2025-04-15 10:37:56.980
false,false,4503,4226,277,904,00:00:32.000,2025-04-15 10:38:05.986
false,false,4509,4232,277,1096,00:00:32.000,2025-04-15 10:38:11.994
false,false,4518,4240,278,1382,00:00:31.000,2025-04-15 10:38:21.004
false,false,4535,4256,279,1917,00:00:33.000,2025-04-15 10:38:38.019
false,false,4536,4257,279,1947,00:00:30.000,2025-04-15 10:38:39.020
false,true,4537,4258,279,0,00:00:00.000,2025-04-15 10:38:43.024
false,false,4540,4261,279,93,00:00:32.000,2025-04-15 10:38:49.029
false,false,4547,4268,279,219,00:00:32.000,2025-04-15 10:39:02.039
false,false,4552,4273,279,378,00:00:31.000,2025-04-15 10:39:07.042
false,false,4562,4283,279,699,00:00:33.000,2025-04-15 10:39:17.054
false,false,4578,4298,280,1204,00:00:30.000,2025-04-15 10:39:33.067
false,true,4590,4310,280,0,00:00:00.000,2025-04-15 10:39:47.082
false,true,4590,4310,280,0,00:00:00.000,2025-04-15 10:39:50.086
false,false,4604,4324,280,441,00:00:30.000,2025-04-15 10:40:05.104
false,false,4670,4384,286,153,00:00:30.000,2025-04-15 10:42:05.227
false,false,4689,4401,288,316,00:00:33.000,2025-04-15 10:42:30.246
false,false,4703,4414,289,62,00:00:31.000,2025-04-15 10:42:56.274
false,false,4709,4419,290,249,00:00:32.000,2025-04-15 10:43:02.280
false,false,4723,4431,292,689,00:00:32.000,2025-04-15 10:43:16.296
false,true,4732,4440,292,0,00:00:00.000,2025-04-15 10:43:33.313
false,false,4734,4442,292,62,00:00:30.000,2025-04-15 10:43:39.319
false,true,4763,4469,294,0,00:00:00.000,2025-04-15 10:44:12.357
false,false,4770,4476,294,224,00:00:32.000,2025-04-15 10:44:21.369
false,true,4770,4476,294,0,00:00:00.000,2025-04-15 10:44:22.369
false,false,4771,4477,294,32,00:00:32.000,2025-04-15 10:44:28.377
false,true,4776,4482,294,0,00:00:00.000,2025-04-15 10:44:39.389
false,false,4786,4492,294,315,00:00:30.000,2025-04-15 10:44:49.398
false,false,4798,4503,295,697,00:00:31.000,2025-04-15 10:45:01.409
false,true,4825,4530,295,0,00:00:00.000,2025-04-15 10:45:46.448
false,true,4826,4531,295,0,00:00:00.000,2025-04-15 10:45:51.452
false,false,4838,4542,296,32,00:00:32.000,2025-04-15 10:46:11.473
false,false,4839,4543,296,63,00:00:31.000,2025-04-15 10:46:12.473
false,false,4844,4547,297,155,00:00:30.000,2025-04-15 10:46:23.486
false,true,4851,4553,298,0,00:00:00.000,2025-04-15 10:46:35.503
false,false,4864,4566,298,406,00:00:31.000,2025-04-15 10:46:49.517
false,false,4875,4576,299,125,00:00:32.000,2025-04-15 10:47:06.539
false,false,4887,4587,300,510,00:00:33.000,2025-04-15 10:47:18.554
false,false,4895,4595,300,760,00:00:32.000,2025-04-15 10:47:26.561
false,false,4903,4603,300,1008,00:00:31.000,2025-04-15 10:47:34.572
false,true,4911,4611,300,0,00:00:00.000,2025-04-15 10:47:48.586
false,false,4937,4633,304,65,00:00:33.000,2025-04-15 10:48:20.619
false,true,4938,4634,304,0,00:00:00.000,2025-04-15 10:48:22.619
false,false,5323,4988,335,630,00:00:30.000,2025-04-15 10:56:47.128
false,false,5328,4993,335,789,00:00:33.000,2025-04-15 10:56:52.134
false,false,5329,4994,335,820,00:00:31.000,2025-04-15 10:56:53.135
false,true,5346,5011,335,0,00:00:00.000,2025-04-15 10:57:18.156
false,true,5346,5011,335,0,00:00:00.000,2025-04-15 10:57:20.158
false,false,5356,5020,336,319,00:00:32.000,2025-04-15 10:57:32.172
false,false,5364,5028,336,576,00:00:32.000,2025-04-15 10:57:40.181
false,false,5380,5042,338,514,00:00:30.000,2025-04-15 10:58:02.200
false,false,5392,5053,339,893,00:00:33.000,2025-04-15 10:58:14.209
false,false,5399,5059,340,1118,00:00:32.000,2025-04-15 10:58:21.214
false,false,5400,5060,340,1149,00:00:31.000,2025-04-15 10:58:22.215
false,false,5090,4774,316,220,00:00:30.000,2025-04-15 10:51:47.843
false,false,5092,4776,316,283,00:00:30.000,2025-04-15 10:51:49.846
false,true,5110,4792,318,0,00:00:00.000,2025-04-15 10:52:13.867
false,true,5115,4797,318,0,00:00:00.000,2025-04-15 10:52:23.877
false,false,5124,4806,318,247,00:00:31.000,2025-04-15 10:52:39.887
false,false,5128,4810,318,372,00:00:31.000,2025-04-15 10:52:43.893
false,false,5142,4822,320,815,00:00:31.000,2025-04-15 10:52:57.909
false,true,1978,1857,121,0,00:00:00.000,2025-04-15 09:39:10.357
false,true,1978,1857,121,0,00:00:00.000,2025-04-15 09:39:12.358
false,false,2005,1883,122,285,00:00:31.000,2025-04-15 09:40:00.401
false,true,2035,1910,125,0,00:00:00.000,2025-04-15 09:40:33.439
false,false,2344,2196,148,445,00:00:33.000,2025-04-15 09:47:45.882
false,false,2369,2220,149,227,00:00:33.000,2025-04-15 09:48:22.924
false,false,2376,2226,150,443,00:00:30.000,2025-04-15 09:48:29.930
false,false,2382,2231,151,633,00:00:32.000,2025-04-15 09:48:35.938
false,true,2387,2236,151,0,00:00:00.000,2025-04-15 09:48:44.950
false,false,2290,2145,145,257,00:00:33.000,2025-04-15 09:45:57.768
false,true,2294,2148,146,0,00:00:00.000,2025-04-15 09:46:15.788
false,true,2294,2148,146,0,00:00:00.000,2025-04-15 09:46:19.791
false,true,2310,2163,147,0,00:00:00.000,2025-04-15 09:46:46.815
false,true,2312,2165,147,0,00:00:00.000,2025-04-15 09:46:50.820
false,false,2315,2168,147,93,00:00:31.000,2025-04-15 09:47:04.831
false,false,2322,2175,147,315,00:00:32.000,2025-04-15 09:47:11.841
false,false,2245,2105,140,96,00:00:33.000,2025-04-15 09:44:24.682
false,false,2263,2121,142,190,00:00:30.000,2025-04-15 09:45:12.725
false,false,2405,2254,151,187,00:00:30.000,2025-04-15 09:49:10.975
false,false,2408,2256,152,281,00:00:31.000,2025-04-15 09:49:13.979
false,false,2447,2292,155,1508,00:00:33.000,2025-04-15 09:49:53.014
false,false,2454,2299,155,1732,00:00:32.000,2025-04-15 09:50:00.021
false,true,2470,2315,155,0,00:00:00.000,2025-04-15 09:50:39.056
false,true,2470,2315,155,0,00:00:00.000,2025-04-15 09:50:45.062
false,false,2472,2317,155,63,00:00:30.000,2025-04-15 09:50:48.067
false,true,2479,2322,157,0,00:00:00.000,2025-04-15 09:50:57.077
false,false,2486,2329,157,220,00:00:30.000,2025-04-15 09:51:08.087
false,false,2506,2349,157,30,00:00:30.000,2025-04-15 09:51:34.112
false,false,2511,2353,158,181,00:00:30.000,2025-04-15 09:51:39.118
false,false,2523,2365,158,282,00:00:33.000,2025-04-15 09:51:57.139
false,false,2616,2455,161,477,00:00:31.000,2025-04-15 09:54:06.268
false,false,2621,2459,162,635,00:00:31.000,2025-04-15 09:54:11.273
false,false,2628,2466,162,192,00:00:32.000,2025-04-15 09:54:24.285
false,false,2630,2467,163,252,00:00:30.000,2025-04-15 09:54:26.287
false,false,2633,2469,164,349,00:00:31.000,2025-04-15 09:54:29.289
false,false,2639,2475,164,544,00:00:33.000,2025-04-15 09:54:35.294
false,true,2642,2478,164,0,00:00:00.000,2025-04-15 09:54:39.298
false,false,2651,2486,165,291,00:00:30.000,2025-04-15 09:54:53.309
false,false,2565,2406,159,636,00:00:30.000,2025-04-15 09:52:51.191
false,false,2572,2412,160,852,00:00:31.000,2025-04-15 09:52:58.199
false,false,2594,2434,160,410,00:00:31.000,2025-04-15 09:53:26.229
false,false,2725,2558,167,600,00:00:31.000,2025-04-15 09:56:43.409
false,true,2758,2587,171,0,00:00:00.000,2025-04-15 09:57:35.468
false,true,2758,2587,171,0,00:00:00.000,2025-04-15 09:57:39.472
false,false,2760,2589,171,62,00:00:32.000,2025-04-15 09:57:42.475
false,false,2763,2592,171,155,00:00:31.000,2025-04-15 09:57:45.477
false,false,2774,2603,171,502,00:00:31.000,2025-04-15 09:57:56.492
false,false,2782,2610,172,756,00:00:32.000,2025-04-15 09:58:04.501
false,false,2791,2618,173,157,00:00:30.000,2025-04-15 09:58:19.511
false,false,2722,2555,167,503,00:00:31.000,2025-04-15 09:56:40.407
false,false,2795,2622,173,280,00:00:30.000,2025-04-15 09:58:23.515
false,false,2842,2668,174,96,00:00:31.000,2025-04-15 09:59:28.579
false,false,2843,2669,174,129,00:00:33.000,2025-04-15 09:59:29.579
false,false,2852,2678,174,416,00:00:30.000,2025-04-15 09:59:38.591
false,true,2853,2679,174,0,00:00:00.000,2025-04-15 09:59:43.597
false,true,2859,2685,174,0,00:00:00.000,2025-04-15 09:59:54.610
false,false,2862,2687,175,93,00:00:30.000,2025-04-15 10:00:00.616
false,false,2871,2695,176,381,00:00:33.000,2025-04-15 10:00:09.627
false,true,2875,2699,176,0,00:00:00.000,2025-04-15 10:00:17.637
false,false,2885,2708,177,318,00:00:31.000,2025-04-15 10:00:29.653
false,false,2900,2722,178,30,00:00:30.000,2025-04-15 10:00:56.682
false,false,2904,2725,179,154,00:00:32.000,2025-04-15 10:01:00.686
false,false,2907,2728,179,247,00:00:31.000,2025-04-15 10:01:03.690
false,false,2922,2741,181,154,00:00:31.000,2025-04-15 10:01:30.719
false,false,3103,2916,187,276,00:00:32.000,2025-04-15 10:05:07.935
false,true,3124,2936,188,0,00:00:00.000,2025-04-15 10:05:31.958
false,false,3171,2979,192,411,00:00:33.000,2025-04-15 10:06:28.009
false,false,3175,2983,192,536,00:00:31.000,2025-04-15 10:06:32.010
false,true,3191,2997,194,0,00:00:00.000,2025-04-15 10:06:57.037
false,true,3209,3014,195,0,00:00:00.000,2025-04-15 10:07:28.069
false,true,3240,3044,196,0,00:00:00.000,2025-04-15 10:08:14.111
false,false,2951,2768,183,755,00:00:30.000,2025-04-15 10:02:05.753
false,false,3017,2832,185,60,00:00:30.000,2025-04-15 10:03:17.830
false,false,3054,2868,186,350,00:00:33.000,2025-04-15 10:04:06.868
false,true,3060,2874,186,0,00:00:00.000,2025-04-15 10:04:18.880
false,false,3064,2878,186,128,00:00:33.000,2025-04-15 10:04:22.884
false,false,3072,2886,186,382,00:00:32.000,2025-04-15 10:04:30.891
false,false,3250,3053,197,312,00:00:31.000,2025-04-15 10:08:29.127
false,false,3252,3055,197,32,00:00:32.000,2025-04-15 10:08:37.135
false,false,3255,3057,198,124,00:00:31.000,2025-04-15 10:08:40.139
false,false,3285,3084,201,948,00:00:30.000,2025-04-15 10:09:16.175
false,false,3306,3104,202,629,00:00:31.000,2025-04-15 10:09:43.202
false,false,3328,3125,203,1318,00:00:30.000,2025-04-15 10:10:05.225
false,false,3330,3127,203,1380,00:00:30.000,2025-04-15 10:10:07.227
false,false,3344,3139,205,126,00:00:31.000,2025-04-15 10:10:39.266
false,true,3344,3139,205,0,00:00:00.000,2025-04-15 10:10:41.267
false,false,3345,3140,205,31,00:00:31.000,2025-04-15 10:10:46.272
false,true,3356,3151,205,0,00:00:00.000,2025-04-15 10:11:02.287
false,false,3360,3155,205,128,00:00:33.000,2025-04-15 10:11:07.291
false,false,3377,3171,206,666,00:00:31.000,2025-04-15 10:11:24.306
false,false,3475,3263,212,252,00:00:32.000,2025-04-15 10:14:02.477
false,false,3481,3269,212,441,00:00:30.000,2025-04-15 10:14:08.484
false,false,3493,3281,212,93,00:00:31.000,2025-04-15 10:14:26.503
false,false,3505,3291,214,475,00:00:30.000,2025-04-15 10:14:38.518
false,true,3586,3366,220,0,00:00:00.000,2025-04-15 10:16:50.652
false,false,3635,3412,223,1526,00:00:32.000,2025-04-15 10:17:42.705
false,false,3643,3418,225,1772,00:00:30.000,2025-04-15 10:17:50.712
false,false,3663,3438,225,121,00:00:31.000,2025-04-15 10:18:16.737
false,false,3664,3439,225,151,00:00:30.000,2025-04-15 10:18:17.738
false,true,3536,3320,216,0,00:00:00.000,2025-04-15 10:15:24.557
false,true,3536,3320,216,0,00:00:00.000,2025-04-15 10:15:26.559
false,false,3537,3321,216,30,00:00:30.000,2025-04-15 10:15:28.561
false,false,3540,3323,217,125,00:00:31.000,2025-04-15 10:15:31.566
false,false,3545,3328,217,130,00:00:33.000,2025-04-15 10:15:42.578
false,false,3555,3338,217,254,00:00:30.000,2025-04-15 10:15:58.593
false,false,3557,3340,217,317,00:00:30.000,2025-04-15 10:16:00.595
false,false,3673,3447,226,437,00:00:31.000,2025-04-15 10:18:26.747
false,false,3676,3450,226,529,00:00:31.000,2025-04-15 10:18:29.750
false,false,3678,3451,227,61,00:00:31.000,2025-04-15 10:18:37.758
false,false,3685,3457,228,285,00:00:31.000,2025-04-15 10:18:44.766
false,false,3699,3468,231,280,00:00:30.000,2025-04-15 10:19:04.790
false,false,3711,3478,233,288,00:00:33.000,2025-04-15 10:19:22.811
false,true,3831,3592,239,0,00:00:00.000,2025-04-15 10:22:40.017
false,false,3844,3602,242,406,00:00:30.000,2025-04-15 10:22:54.030
false,false,3854,3610,244,718,00:00:30.000,2025-04-15 10:23:04.039
false,false,3743,3509,234,256,00:00:32.000,2025-04-15 10:20:06.853
false,false,3759,3525,234,758,00:00:32.000,2025-04-15 10:20:22.871
false,false,3781,3544,237,249,00:00:31.000,2025-04-15 10:20:50.907
false,false,3786,3549,237,32,00:00:32.000,2025-04-15 10:21:07.926
false,true,3797,3560,237,0,00:00:00.000,2025-04-15 10:21:36.953
false,false,3392,3184,208,192,00:00:33.000,2025-04-15 10:11:51.334
false,false,3396,3188,208,317,00:00:32.000,2025-04-15 10:11:55.337
false,true,3398,3190,208,0,00:00:00.000,2025-04-15 10:11:58.339
false,false,3406,3198,208,254,00:00:33.000,2025-04-15 10:12:11.354
false,false,3418,3210,208,98,00:00:32.000,2025-04-15 10:12:29.373
false,false,3895,3650,245,155,00:00:31.000,2025-04-15 10:23:57.096
false,false,3902,3657,245,376,00:00:30.000,2025-04-15 10:24:04.107
false,false,3908,3663,245,98,00:00:33.000,2025-04-15 10:24:16.120
false,true,3914,3669,245,0,00:00:00.000,2025-04-15 10:24:23.125
false,false,3916,3671,245,64,00:00:32.000,2025-04-15 10:24:30.130
false,true,3917,3672,245,0,00:00:00.000,2025-04-15 10:24:35.138
false,true,3928,3682,246,0,00:00:00.000,2025-04-15 10:24:50.152
false,true,3928,3682,246,0,00:00:00.000,2025-04-15 10:24:51.153
false,false,4022,3772,250,93,00:00:31.000,2025-04-15 10:26:58.282
false,false,4046,3794,252,31,00:00:31.000,2025-04-15 10:27:34.318
false,false,4057,3805,252,61,00:00:30.000,2025-04-15 10:27:51.335
false,false,4066,3814,252,158,00:00:32.000,2025-04-15 10:28:06.351
false,false,4082,3829,253,662,00:00:30.000,2025-04-15 10:28:22.366
false,false,4310,4047,263,244,00:00:31.000,2025-04-15 10:33:28.710
false,true,4333,4068,265,0,00:00:00.000,2025-04-15 10:34:19.764
false,false,4342,4077,265,282,00:00:32.000,2025-04-15 10:34:36.778
false,true,4351,4086,265,0,00:00:00.000,2025-04-15 10:34:53.794
false,false,4352,4086,266,32,00:00:32.000,2025-04-15 10:34:58.799
false,false,4248,3986,262,348,00:00:32.000,2025-04-15 10:32:08.615
false,true,4251,3988,263,0,00:00:00.000,2025-04-15 10:32:12.621
false,true,4251,3988,263,0,00:00:00.000,2025-04-15 10:32:16.627
false,false,4253,3990,263,63,00:00:33.000,2025-04-15 10:32:19.631
false,false,4270,4007,263,600,00:00:32.000,2025-04-15 10:32:36.649
false,false,4280,4017,263,923,00:00:31.000,2025-04-15 10:32:46.660
false,false,4297,4034,263,316,00:00:33.000,2025-04-15 10:33:09.687
false,false,3958,3711,247,505,00:00:31.000,2025-04-15 10:25:30.190
false,false,3959,3712,247,535,00:00:30.000,2025-04-15 10:25:31.191
false,true,3964,3717,247,0,00:00:00.000,2025-04-15 10:25:40.200
false,true,3973,3724,249,0,00:00:00.000,2025-04-15 10:26:00.224
false,false,3988,3739,249,474,00:00:32.000,2025-04-15 10:26:18.242
false,false,4006,3756,250,1043,00:00:30.000,2025-04-15 10:26:36.263
false,false,4097,3844,253,1129,00:00:32.000,2025-04-15 10:28:37.385
false,false,4110,3857,253,1532,00:00:32.000,2025-04-15 10:28:50.399
false,false,4117,3864,253,1759,00:00:30.000,2025-04-15 10:28:57.406
false,false,4127,3873,254,287,00:00:31.000,2025-04-15 10:29:13.426
false,false,4150,3896,254,251,00:00:31.000,2025-04-15 10:29:42.451
false,false,4153,3898,255,344,00:00:30.000,2025-04-15 10:29:45.453
false,false,4174,3919,255,318,00:00:32.000,2025-04-15 10:30:12.480
false,true,4174,3919,255,0,00:00:00.000,2025-04-15 10:30:15.485
false,true,4179,3924,255,0,00:00:00.000,2025-04-15 10:30:27.501
false,false,4182,3927,255,92,00:00:30.000,2025-04-15 10:30:32.507
false,true,4192,3935,257,0,00:00:00.000,2025-04-15 10:30:45.517
false,true,4192,3935,257,0,00:00:00.000,2025-04-15 10:30:47.520
false,true,4217,3959,258,0,00:00:00.000,2025-04-15 10:31:27.565
false,true,4217,3959,258,0,00:00:00.000,2025-04-15 10:31:29.566
false,false,4365,4098,267,444,00:00:31.000,2025-04-15 10:35:11.813
false,false,4374,4106,268,724,00:00:31.000,2025-04-15 10:35:20.823
false,false,4386,4117,269,1104,00:00:32.000,2025-04-15 10:35:32.834
false,false,4414,4143,271,351,00:00:33.000,2025-04-15 10:36:06.870
false,false,4418,4147,271,61,00:00:30.000,2025-04-15 10:36:16.879
false,false,4430,4158,272,90,00:00:30.000,2025-04-15 10:36:34.893
false,false,4613,4330,283,724,00:00:31.000,2025-04-15 10:40:14.114
false,true,4618,4335,283,0,00:00:00.000,2025-04-15 10:40:29.129
false,true,4618,4335,283,0,00:00:00.000,2025-04-15 10:40:31.130
false,false,4445,4172,273,560,00:00:30.000,2025-04-15 10:36:49.910
false,false,4455,4181,274,123,00:00:30.000,2025-04-15 10:37:05.927
false,false,4456,4182,274,155,00:00:32.000,2025-04-15 10:37:06.929
false,false,4478,4203,275,125,00:00:33.000,2025-04-15 10:37:40.961
false,false,4490,4214,276,494,00:00:30.000,2025-04-15 10:37:52.977
false,false,4517,4239,278,1351,00:00:31.000,2025-04-15 10:38:20.003
false,false,4538,4259,279,31,00:00:31.000,2025-04-15 10:38:47.027
false,false,4548,4269,279,251,00:00:32.000,2025-04-15 10:39:03.039
false,false,4561,4282,279,666,00:00:33.000,2025-04-15 10:39:16.054
false,false,4586,4306,280,1452,00:00:30.000,2025-04-15 10:39:41.077
false,false,4593,4313,280,95,00:00:32.000,2025-04-15 10:39:54.092
false,true,4665,4379,286,0,00:00:00.000,2025-04-15 10:41:59.223
false,false,4675,4389,286,309,00:00:32.000,2025-04-15 10:42:10.231
false,true,4724,4432,292,0,00:00:00.000,2025-04-15 10:43:23.301
false,false,4731,4439,292,226,00:00:32.000,2025-04-15 10:43:30.308
false,false,4754,4460,294,692,00:00:31.000,2025-04-15 10:43:59.341
false,true,4763,4469,294,0,00:00:00.000,2025-04-15 10:44:10.354
false,false,4766,4472,294,95,00:00:30.000,2025-04-15 10:44:17.363
false,true,4770,4476,294,0,00:00:00.000,2025-04-15 10:44:24.372
false,false,4773,4479,294,94,00:00:31.000,2025-04-15 10:44:30.379
false,false,4794,4499,295,569,00:00:30.000,2025-04-15 10:44:57.406
false,false,4800,4505,295,758,00:00:30.000,2025-04-15 10:45:03.410
false,false,4803,4508,295,852,00:00:33.000,2025-04-15 10:45:06.414
false,false,4807,4512,295,30,00:00:30.000,2025-04-15 10:45:16.423
false,false,4824,4529,295,319,00:00:33.000,2025-04-15 10:45:39.441
false,false,4825,4530,295,351,00:00:32.000,2025-04-15 10:45:40.442
false,true,4825,4530,295,0,00:00:00.000,2025-04-15 10:45:45.446
false,false,4848,4551,297,278,00:00:30.000,2025-04-15 10:46:27.493
false,false,4849,4552,297,308,00:00:30.000,2025-04-15 10:46:28.494
false,false,4852,4554,298,32,00:00:32.000,2025-04-15 10:46:37.507
false,false,4866,4568,298,467,00:00:30.000,2025-04-15 10:46:51.519
false,false,4868,4569,299,530,00:00:31.000,2025-04-15 10:46:53.522
false,true,4911,4611,300,0,00:00:00.000,2025-04-15 10:47:47.585
false,false,4929,4627,302,569,00:00:33.000,2025-04-15 10:48:06.605
false,false,5341,5006,335,216,00:00:30.000,2025-04-15 10:57:11.152
false,false,5359,5023,336,413,00:00:31.000,2025-04-15 10:57:35.175
false,true,5364,5028,336,0,00:00:00.000,2025-04-15 10:57:41.181
false,false,5388,5050,338,765,00:00:30.000,2025-04-15 10:58:10.206
false,false,5100,4783,317,538,00:00:31.000,2025-04-15 10:51:57.853
false,true,5115,4797,318,0,00:00:00.000,2025-04-15 10:52:19.873
false,true,1988,1866,122,0,00:00:00.000,2025-04-15 09:39:30.372
false,true,1989,1867,122,0,00:00:00.000,2025-04-15 09:39:33.375
false,true,1996,1874,122,0,00:00:00.000,2025-04-15 09:39:50.391
false,false,2000,1878,122,126,00:00:30.000,2025-04-15 09:39:55.396
false,false,2007,1885,122,347,00:00:32.000,2025-04-15 09:40:02.403
false,false,2343,2195,148,412,00:00:32.000,2025-04-15 09:47:44.881
false,false,2349,2200,149,605,00:00:32.000,2025-04-15 09:47:50.890
false,false,2350,2201,149,638,00:00:33.000,2025-04-15 09:47:51.891
false,true,2356,2207,149,0,00:00:00.000,2025-04-15 09:48:01.901
false,false,2373,2223,150,353,00:00:33.000,2025-04-15 09:48:26.928
false,false,2381,2230,151,601,00:00:31.000,2025-04-15 09:48:34.936
false,false,2395,2244,151,249,00:00:31.000,2025-04-15 09:48:54.959
false,true,2282,2137,145,0,00:00:00.000,2025-04-15 09:45:46.757
false,true,2291,2146,145,0,00:00:00.000,2025-04-15 09:46:04.775
false,false,2295,2149,146,30,00:00:30.000,2025-04-15 09:46:20.791
false,true,2298,2152,146,0,00:00:00.000,2025-04-15 09:46:25.796
false,false,2308,2161,147,316,00:00:30.000,2025-04-15 09:46:39.808
false,false,2310,2163,147,381,00:00:32.000,2025-04-15 09:46:41.810
false,false,2236,2096,140,4583,00:00:33.000,2025-04-15 09:44:09.665
false,true,2245,2105,140,0,00:00:00.000,2025-04-15 09:44:27.684
false,true,2245,2105,140,0,00:00:00.000,2025-04-15 09:44:30.685
false,false,2255,2114,141,130,00:00:32.000,2025-04-15 09:44:58.709
false,true,2257,2116,141,0,00:00:00.000,2025-04-15 09:45:05.715
false,true,2264,2122,142,0,00:00:00.000,2025-04-15 09:45:15.727
false,false,2267,2125,142,96,00:00:33.000,2025-04-15 09:45:22.735
false,true,2282,2137,145,0,00:00:00.000,2025-04-15 09:45:41.754
false,false,2404,2253,151,157,00:00:31.000,2025-04-15 09:49:09.975
false,false,2457,2302,155,1828,00:00:32.000,2025-04-15 09:50:03.023
false,false,2460,2305,155,1918,00:00:30.000,2025-04-15 09:50:06.025
false,true,2468,2313,155,0,00:00:00.000,2025-04-15 09:50:28.043
false,true,2468,2313,155,0,00:00:00.000,2025-04-15 09:50:30.046
false,false,2483,2326,157,124,00:00:30.000,2025-04-15 09:51:05.084
false,false,2497,2340,157,566,00:00:31.000,2025-04-15 09:51:19.095
false,false,2503,2346,157,755,00:00:33.000,2025-04-15 09:51:25.100
false,true,2505,2348,157,0,00:00:00.000,2025-04-15 09:51:28.105
false,false,2517,2359,158,93,00:00:30.000,2025-04-15 09:51:51.133
false,false,2525,2367,158,347,00:00:33.000,2025-04-15 09:51:59.140
false,true,2539,2380,159,0,00:00:00.000,2025-04-15 09:52:17.157
false,false,2615,2454,161,446,00:00:33.000,2025-04-15 09:54:05.267
false,true,2622,2460,162,0,00:00:00.000,2025-04-15 09:54:16.279
false,false,2637,2473,164,479,00:00:33.000,2025-04-15 09:54:33.293
false,false,2638,2474,164,511,00:00:32.000,2025-04-15 09:54:34.294
false,true,2642,2478,164,0,00:00:00.000,2025-04-15 09:54:44.302
false,false,2653,2487,166,354,00:00:30.000,2025-04-15 09:54:55.311
false,false,2666,2499,167,773,00:00:32.000,2025-04-15 09:55:08.323
false,true,2545,2386,159,0,00:00:00.000,2025-04-15 09:52:27.167
false,false,2548,2389,159,97,00:00:33.000,2025-04-15 09:52:34.174
false,false,2566,2407,159,667,00:00:31.000,2025-04-15 09:52:52.192
false,false,2567,2408,159,697,00:00:30.000,2025-04-15 09:52:53.193
false,false,2568,2409,159,727,00:00:30.000,2025-04-15 09:52:54.194
false,false,2579,2419,160,1069,00:00:31.000,2025-04-15 09:53:05.208
false,true,2581,2421,160,0,00:00:00.000,2025-04-15 09:53:11.215
false,false,2596,2436,160,473,00:00:33.000,2025-04-15 09:53:28.231
false,false,2600,2440,160,597,00:00:31.000,2025-04-15 09:53:32.236
false,false,2607,2446,161,191,00:00:32.000,2025-04-15 09:53:57.260
false,false,2610,2449,161,287,00:00:33.000,2025-04-15 09:54:00.262
false,false,2612,2451,161,351,00:00:32.000,2025-04-15 09:54:02.265
false,false,2766,2595,171,253,00:00:33.000,2025-04-15 09:57:48.482
false,false,2776,2604,172,565,00:00:31.000,2025-04-15 09:57:58.494
false,false,2804,2631,173,557,00:00:33.000,2025-04-15 09:58:32.524
false,true,2809,2635,174,0,00:00:00.000,2025-04-15 09:58:38.531
false,true,2810,2636,174,0,00:00:00.000,2025-04-15 09:58:48.539
false,false,2816,2642,174,192,00:00:30.000,2025-04-15 09:58:56.546
false,false,2823,2649,174,413,00:00:30.000,2025-04-15 09:59:03.552
false,false,2828,2654,174,568,00:00:31.000,2025-04-15 09:59:08.557
false,false,2829,2655,174,599,00:00:31.000,2025-04-15 09:59:09.558
false,false,2845,2671,174,193,00:00:33.000,2025-04-15 09:59:31.583
false,false,2851,2677,174,386,00:00:32.000,2025-04-15 09:59:37.589
false,true,2875,2699,176,0,00:00:00.000,2025-04-15 10:00:15.635
false,false,2877,2701,176,65,00:00:33.000,2025-04-15 10:00:21.644
false,true,2899,2721,178,0,00:00:00.000,2025-04-15 10:00:51.679
false,true,2911,2731,180,0,00:00:00.000,2025-04-15 10:01:08.695
false,false,2912,2732,180,31,00:00:31.000,2025-04-15 10:01:14.702
false,false,2914,2733,181,92,00:00:31.000,2025-04-15 10:01:16.706
false,false,2925,2744,181,251,00:00:33.000,2025-04-15 10:01:33.723
false,true,2927,2746,181,0,00:00:00.000,2025-04-15 10:01:41.729
false,false,3145,2954,191,668,00:00:32.000,2025-04-15 10:05:55.981
false,true,3177,2985,192,0,00:00:00.000,2025-04-15 10:06:37.018
false,true,3191,2997,194,0,00:00:00.000,2025-04-15 10:06:58.038
false,false,3216,3021,195,66,00:00:33.000,2025-04-15 10:07:49.088
false,false,2935,2753,182,255,00:00:32.000,2025-04-15 10:01:49.732
false,false,2938,2756,182,346,00:00:30.000,2025-04-15 10:01:52.735
false,false,2944,2761,183,537,00:00:32.000,2025-04-15 10:01:58.744
false,false,2953,2770,183,819,00:00:33.000,2025-04-15 10:02:07.755
false,false,2966,2782,184,1231,00:00:33.000,2025-04-15 10:02:20.769
false,false,2997,2812,185,2213,00:00:30.000,2025-04-15 10:02:51.801
false,false,3018,2833,185,90,00:00:30.000,2025-04-15 10:03:18.833
false,false,3039,2853,186,128,00:00:32.000,2025-04-15 10:03:45.853
false,false,3057,2871,186,445,00:00:33.000,2025-04-15 10:04:09.872
false,true,3060,2874,186,0,00:00:00.000,2025-04-15 10:04:13.874
false,false,3066,2880,186,190,00:00:30.000,2025-04-15 10:04:24.887
false,false,3074,2888,186,442,00:00:30.000,2025-04-15 10:04:32.892
false,false,3075,2889,186,472,00:00:30.000,2025-04-15 10:04:33.894
false,false,3085,2899,186,788,00:00:30.000,2025-04-15 10:04:43.904
false,false,3094,2907,187,1071,00:00:32.000,2025-04-15 10:04:52.914
false,true,3251,3054,197,0,00:00:00.000,2025-04-15 10:08:34.132
false,true,3255,3057,198,0,00:00:00.000,2025-04-15 10:08:44.144
false,false,3260,3061,199,160,00:00:33.000,2025-04-15 10:08:51.150
false,false,3283,3082,201,888,00:00:32.000,2025-04-15 10:09:14.174
false,false,3313,3111,202,851,00:00:33.000,2025-04-15 10:09:50.209
false,false,3318,3115,203,1007,00:00:30.000,2025-04-15 10:09:55.214
false,false,3323,3120,203,1164,00:00:33.000,2025-04-15 10:10:00.220
false,false,3334,3129,205,1501,00:00:30.000,2025-04-15 10:10:11.234
false,true,3338,3133,205,0,00:00:00.000,2025-04-15 10:10:26.251
false,false,3342,3137,205,63,00:00:31.000,2025-04-15 10:10:37.263
false,false,3348,3143,205,127,00:00:33.000,2025-04-15 10:10:49.274
false,false,3355,3150,205,347,00:00:30.000,2025-04-15 10:10:56.281
false,false,3356,3151,205,378,00:00:31.000,2025-04-15 10:10:57.282
false,false,3357,3152,205,33,00:00:33.000,2025-04-15 10:11:04.290
false,false,3380,3174,206,94,00:00:30.000,2025-04-15 10:11:33.315
false,true,3455,3245,210,0,00:00:00.000,2025-04-15 10:13:26.433
false,false,3473,3262,211,189,00:00:31.000,2025-04-15 10:14:00.475
false,false,3501,3287,214,349,00:00:31.000,2025-04-15 10:14:34.513
false,false,3502,3288,214,381,00:00:32.000,2025-04-15 10:14:35.515
false,false,3524,3309,215,375,00:00:31.000,2025-04-15 10:15:03.538
false,true,3586,3366,220,0,00:00:00.000,2025-04-15 10:16:48.650
false,false,3590,3370,220,123,00:00:31.000,2025-04-15 10:16:57.660
false,false,3608,3388,220,679,00:00:30.000,2025-04-15 10:17:15.677
false,false,3648,3423,225,1930,00:00:30.000,2025-04-15 10:17:55.716
false,false,3670,3444,226,343,00:00:32.000,2025-04-15 10:18:23.743
false,false,3531,3316,215,593,00:00:32.000,2025-04-15 10:15:10.545
false,true,3531,3316,215,0,00:00:00.000,2025-04-15 10:15:12.546
false,false,3538,3322,216,63,00:00:33.000,2025-04-15 10:15:29.563
false,false,3572,3353,219,445,00:00:32.000,2025-04-15 10:16:21.620
false,false,3575,3355,220,536,00:00:31.000,2025-04-15 10:16:24.623
false,true,3702,3471,231,0,00:00:00.000,2025-04-15 10:19:08.795
false,false,3726,3493,233,161,00:00:32.000,2025-04-15 10:19:43.834
false,false,3734,3501,233,409,00:00:30.000,2025-04-15 10:19:51.841
false,false,3735,3502,233,439,00:00:30.000,2025-04-15 10:19:52.843
false,false,3740,3506,234,161,00:00:33.000,2025-04-15 10:20:03.852
false,true,3802,3564,238,0,00:00:00.000,2025-04-15 10:21:48.967
false,false,3834,3595,239,95,00:00:32.000,2025-04-15 10:22:44.019
false,false,3848,3605,243,533,00:00:33.000,2025-04-15 10:22:58.033
false,false,3855,3611,244,749,00:00:31.000,2025-04-15 10:23:05.040
false,false,3856,3612,244,779,00:00:30.000,2025-04-15 10:23:06.041
false,false,3868,3624,244,253,00:00:30.000,2025-04-15 10:23:24.059
false,false,3758,3524,234,726,00:00:30.000,2025-04-15 10:20:21.870
false,true,3773,3538,235,0,00:00:00.000,2025-04-15 10:20:42.899
false,false,3790,3553,237,128,00:00:33.000,2025-04-15 10:21:17.937
false,false,3794,3557,237,95,00:00:31.000,2025-04-15 10:21:27.945
false,false,3420,3212,208,160,00:00:30.000,2025-04-15 10:12:31.377
false,false,3423,3214,209,65,00:00:32.000,2025-04-15 10:12:40.389
false,false,3431,3222,209,317,00:00:33.000,2025-04-15 10:12:48.394
false,true,3437,3228,209,0,00:00:00.000,2025-04-15 10:13:01.408
false,false,3451,3242,209,439,00:00:31.000,2025-04-15 10:13:20.427
false,false,3873,3629,244,405,00:00:30.000,2025-04-15 10:23:29.064
false,true,3890,3645,245,0,00:00:00.000,2025-04-15 10:23:47.082
false,false,3903,3658,245,406,00:00:30.000,2025-04-15 10:24:05.108
false,true,3914,3669,245,0,00:00:00.000,2025-04-15 10:24:24.126
false,false,3928,3682,246,342,00:00:30.000,2025-04-15 10:24:48.151
false,false,3929,3683,246,32,00:00:32.000,2025-04-15 10:24:55.157
false,false,4036,3784,252,529,00:00:30.000,2025-04-15 10:27:12.292
false,true,4037,3785,252,0,00:00:00.000,2025-04-15 10:27:19.301
false,false,4039,3787,252,64,00:00:32.000,2025-04-15 10:27:21.303
false,false,4042,3790,252,159,00:00:30.000,2025-04-15 10:27:24.307
false,false,4050,3798,252,158,00:00:33.000,2025-04-15 10:27:38.322
false,true,4055,3803,252,0,00:00:00.000,2025-04-15 10:27:47.328
false,true,4061,3809,252,0,00:00:00.000,2025-04-15 10:27:56.339
false,true,4061,3809,252,0,00:00:00.000,2025-04-15 10:27:59.341
false,false,4077,3825,252,508,00:00:32.000,2025-04-15 10:28:17.359
false,true,4312,4049,263,0,00:00:00.000,2025-04-15 10:33:39.717
false,true,4312,4049,263,0,00:00:00.000,2025-04-15 10:33:40.719
false,true,4333,4068,265,0,00:00:00.000,2025-04-15 10:34:16.761
false,false,4240,3978,262,94,00:00:30.000,2025-04-15 10:32:00.604
false,false,4255,3992,263,128,00:00:32.000,2025-04-15 10:32:21.632
false,false,4302,4039,263,472,00:00:33.000,2025-04-15 10:33:14.694
false,true,4302,4039,263,0,00:00:00.000,2025-04-15 10:33:17.697
false,true,4302,4039,263,0,00:00:00.000,2025-04-15 10:33:18.699
false,true,3942,3696,246,0,00:00:00.000,2025-04-15 10:25:09.173
false,false,3944,3698,246,65,00:00:33.000,2025-04-15 10:25:16.177
false,true,3965,3717,248,0,00:00:00.000,2025-04-15 10:25:47.209
false,false,3968,3719,249,95,00:00:30.000,2025-04-15 10:25:52.214
false,false,3982,3733,249,288,00:00:33.000,2025-04-15 10:26:12.239
false,false,4085,3832,253,755,00:00:30.000,2025-04-15 10:28:25.371
false,false,4089,3836,253,880,00:00:30.000,2025-04-15 10:28:29.374
false,false,4093,3840,253,1007,00:00:31.000,2025-04-15 10:28:33.381
false,false,4101,3848,253,1253,00:00:30.000,2025-04-15 10:28:41.389
false,false,4103,3850,253,1314,00:00:30.000,2025-04-15 10:28:43.392
false,false,4109,3856,253,1500,00:00:30.000,2025-04-15 10:28:49.398
false,true,4118,3865,253,0,00:00:00.000,2025-04-15 10:29:01.411
false,false,4140,3886,254,700,00:00:31.000,2025-04-15 10:29:26.436
false,false,4145,3891,254,95,00:00:30.000,2025-04-15 10:29:37.445
false,false,4164,3909,255,683,00:00:30.000,2025-04-15 10:29:56.463
false,true,4164,3909,255,0,00:00:00.000,2025-04-15 10:30:01.470
false,false,4167,3912,255,93,00:00:32.000,2025-04-15 10:30:05.473
false,false,4176,3921,255,62,00:00:31.000,2025-04-15 10:30:20.491
false,false,4177,3922,255,92,00:00:30.000,2025-04-15 10:30:21.493
false,false,4222,3963,259,153,00:00:30.000,2025-04-15 10:31:36.575
false,false,4371,4103,268,630,00:00:30.000,2025-04-15 10:35:17.817
false,false,4381,4112,269,946,00:00:32.000,2025-04-15 10:35:27.829
false,false,4383,4114,269,1008,00:00:32.000,2025-04-15 10:35:29.831
false,false,4388,4119,269,1170,00:00:33.000,2025-04-15 10:35:34.836
false,false,4410,4139,271,223,00:00:30.000,2025-04-15 10:36:02.867
false,false,4427,4155,272,345,00:00:32.000,2025-04-15 10:36:25.887
false,false,4614,4331,283,757,00:00:33.000,2025-04-15 10:40:15.114
false,true,4616,4333,283,0,00:00:00.000,2025-04-15 10:40:18.116
false,true,4618,4335,283,0,00:00:00.000,2025-04-15 10:40:30.129
false,true,4637,4353,284,0,00:00:00.000,2025-04-15 10:41:03.164
false,true,4637,4353,284,0,00:00:00.000,2025-04-15 10:41:06.167
false,false,4441,4168,273,434,00:00:31.000,2025-04-15 10:36:45.906
false,false,4491,4215,276,524,00:00:30.000,2025-04-15 10:37:53.978
false,false,4495,4219,276,650,00:00:33.000,2025-04-15 10:37:57.982
false,false,4507,4230,277,1032,00:00:31.000,2025-04-15 10:38:09.992
false,false,4523,4244,279,1540,00:00:31.000,2025-04-15 10:38:26.009
false,false,4587,4307,280,1485,00:00:33.000,2025-04-15 10:39:42.078
false,true,4590,4310,280,0,00:00:00.000,2025-04-15 10:39:46.081
false,false,4591,4311,280,32,00:00:32.000,2025-04-15 10:39:52.090
false,false,4663,4377,286,475,00:00:33.000,2025-04-15 10:41:52.213
false,false,4672,4386,286,214,00:00:30.000,2025-04-15 10:42:07.227
false,false,4678,4392,286,404,00:00:32.000,2025-04-15 10:42:13.232
false,false,4693,4404,289,444,00:00:32.000,2025-04-15 10:42:34.249
false,false,4708,4418,290,217,00:00:31.000,2025-04-15 10:43:01.280
false,false,4711,4420,291,314,00:00:32.000,2025-04-15 10:43:04.283
false,false,4743,4450,293,347,00:00:33.000,2025-04-15 10:43:48.329
false,false,4748,4455,293,504,00:00:32.000,2025-04-15 10:43:53.335
false,true,4770,4476,294,0,00:00:00.000,2025-04-15 10:44:27.376
false,false,4797,4502,295,666,00:00:33.000,2025-04-15 10:45:00.408
false,false,4815,4520,295,33,00:00:33.000,2025-04-15 10:45:30.432
false,false,4818,4523,295,128,00:00:33.000,2025-04-15 10:45:33.436
false,false,4829,4534,295,95,00:00:33.000,2025-04-15 10:45:56.456
false,true,4837,4541,296,0,00:00:00.000,2025-04-15 10:46:10.472
false,false,4847,4550,297,248,00:00:32.000,2025-04-15 10:46:26.491
false,false,4856,4558,298,156,00:00:32.000,2025-04-15 10:46:41.510
false,false,4881,4582,299,317,00:00:31.000,2025-04-15 10:47:12.544
false,false,4922,4621,301,343,00:00:33.000,2025-04-15 10:47:59.598
false,false,4934,4631,303,730,00:00:33.000,2025-04-15 10:48:11.610
false,true,4935,4631,304,0,00:00:00.000,2025-04-15 10:48:18.617
false,true,5334,4999,335,0,00:00:00.000,2025-04-15 10:57:02.144
false,false,5357,5021,336,352,00:00:33.000,2025-04-15 10:57:33.172
false,false,5362,5026,336,512,00:00:33.000,2025-04-15 10:57:38.179
false,false,5369,5032,337,158,00:00:33.000,2025-04-15 10:57:51.188
false,false,5374,5036,338,321,00:00:33.000,2025-04-15 10:57:56.194
false,false,5104,4786,318,661,00:00:30.000,2025-04-15 10:52:01.856
false,true,5110,4792,318,0,00:00:00.000,2025-04-15 10:52:11.864
false,false,5113,4795,318,96,00:00:32.000,2025-04-15 10:52:16.870
false,true,1975,1856,119,0,00:00:00.000,2025-04-15 09:39:04.353
false,true,1978,1857,121,0,00:00:00.000,2025-04-15 09:39:11.358
false,false,1993,1871,122,129,00:00:32.000,2025-04-15 09:39:42.383
false,false,2001,1879,122,159,00:00:33.000,2025-04-15 09:39:56.397
false,false,2017,1894,123,665,00:00:32.000,2025-04-15 09:40:12.416
false,false,2040,1914,126,155,00:00:31.000,2025-04-15 09:40:41.446
false,false,2336,2189,147,190,00:00:30.000,2025-04-15 09:47:37.873
false,false,2340,2192,148,315,00:00:32.000,2025-04-15 09:47:41.878
false,false,2351,2202,149,669,00:00:31.000,2025-04-15 09:47:52.892
false,true,2362,2213,149,0,00:00:00.000,2025-04-15 09:48:10.911
false,true,2362,2213,149,0,00:00:00.000,2025-04-15 09:48:13.914
false,true,2362,2213,149,0,00:00:00.000,2025-04-15 09:48:14.915
false,false,2364,2215,149,63,00:00:32.000,2025-04-15 09:48:17.918
false,false,2390,2239,151,96,00:00:33.000,2025-04-15 09:48:49.954
false,true,2291,2146,145,0,00:00:00.000,2025-04-15 09:46:02.772
false,false,2299,2153,146,32,00:00:32.000,2025-04-15 09:46:30.799
false,true,2310,2163,147,0,00:00:00.000,2025-04-15 09:46:45.814
false,false,2316,2169,147,125,00:00:32.000,2025-04-15 09:47:05.832
false,false,2318,2171,147,187,00:00:32.000,2025-04-15 09:47:07.834
false,false,2238,2098,140,4645,00:00:30.000,2025-04-15 09:44:11.667
false,false,2239,2099,140,4675,00:00:30.000,2025-04-15 09:44:12.668
false,false,2261,2119,142,129,00:00:33.000,2025-04-15 09:45:10.722
false,false,2272,2129,143,256,00:00:33.000,2025-04-15 09:45:27.741
false,false,2413,2261,152,438,00:00:33.000,2025-04-15 09:49:18.984
false,false,2432,2279,153,1030,00:00:31.000,2025-04-15 09:49:37.999
false,false,2477,2321,156,216,00:00:30.000,2025-04-15 09:50:53.073
false,false,2494,2337,157,474,00:00:33.000,2025-04-15 09:51:16.093
false,false,2501,2344,157,691,00:00:30.000,2025-04-15 09:51:23.098
false,true,2514,2356,158,0,00:00:00.000,2025-04-15 09:51:44.124
false,true,2514,2356,158,0,00:00:00.000,2025-04-15 09:51:46.125
false,false,2537,2378,159,726,00:00:30.000,2025-04-15 09:52:11.153
false,false,2626,2464,162,127,00:00:31.000,2025-04-15 09:54:22.282
false,false,2634,2470,164,380,00:00:31.000,2025-04-15 09:54:30.290
false,false,2646,2482,164,132,00:00:33.000,2025-04-15 09:54:48.306
false,false,2652,2487,165,324,00:00:33.000,2025-04-15 09:54:54.310
false,false,2656,2490,166,452,00:00:33.000,2025-04-15 09:54:58.315
false,true,2671,2504,167,0,00:00:00.000,2025-04-15 09:55:15.330
false,true,2672,2505,167,0,00:00:00.000,2025-04-15 09:55:25.338
false,false,2674,2507,167,61,00:00:30.000,2025-04-15 09:55:34.347
false,false,2556,2397,159,353,00:00:32.000,2025-04-15 09:52:42.183
false,false,2560,2401,159,477,00:00:32.000,2025-04-15 09:52:46.187
false,false,2576,2416,160,976,00:00:32.000,2025-04-15 09:53:02.203
false,true,2581,2421,160,0,00:00:00.000,2025-04-15 09:53:08.210
false,false,2587,2427,160,188,00:00:30.000,2025-04-15 09:53:19.223
false,true,2601,2441,160,0,00:00:00.000,2025-04-15 09:53:45.250
false,true,2601,2441,160,0,00:00:00.000,2025-04-15 09:53:47.251
false,false,2728,2561,167,695,00:00:31.000,2025-04-15 09:56:46.411
false,true,2749,2579,170,0,00:00:00.000,2025-04-15 09:57:20.453
false,true,2749,2579,170,0,00:00:00.000,2025-04-15 09:57:21.455
false,true,2749,2579,170,0,00:00:00.000,2025-04-15 09:57:22.456
false,false,2753,2583,170,125,00:00:33.000,2025-04-15 09:57:29.463
false,false,2778,2606,172,626,00:00:30.000,2025-04-15 09:58:00.496
false,false,2779,2607,172,659,00:00:33.000,2025-04-15 09:58:01.497
false,false,2793,2620,173,220,00:00:33.000,2025-04-15 09:58:21.513
false,false,2805,2632,173,590,00:00:33.000,2025-04-15 09:58:33.525
false,true,2810,2636,174,0,00:00:00.000,2025-04-15 09:58:45.535
false,false,2817,2643,174,224,00:00:32.000,2025-04-15 09:58:57.546
false,false,2830,2656,174,629,00:00:30.000,2025-04-15 09:59:10.559
false,true,2853,2679,174,0,00:00:00.000,2025-04-15 09:59:41.594
false,false,2859,2685,174,191,00:00:33.000,2025-04-15 09:59:51.606
false,true,2859,2685,174,0,00:00:00.000,2025-04-15 09:59:57.613
false,false,2869,2693,176,315,00:00:31.000,2025-04-15 10:00:07.624
false,true,2875,2699,176,0,00:00:00.000,2025-04-15 10:00:14.631
false,false,2884,2708,176,287,00:00:32.000,2025-04-15 10:00:28.652
false,false,2901,2723,178,60,00:00:30.000,2025-04-15 10:00:57.683
false,false,2903,2725,178,122,00:00:30.000,2025-04-15 10:00:59.685
false,true,2911,2731,180,0,00:00:00.000,2025-04-15 10:01:11.698
false,false,3125,2937,188,32,00:00:32.000,2025-04-15 10:05:35.962
false,true,3158,2966,192,0,00:00:00.000,2025-04-15 10:06:14.997
false,false,3166,2974,192,255,00:00:30.000,2025-04-15 10:06:23.006
false,false,3185,2991,194,250,00:00:31.000,2025-04-15 10:06:48.027
false,false,3190,2996,194,405,00:00:30.000,2025-04-15 10:06:53.034
false,false,3191,2997,194,436,00:00:31.000,2025-04-15 10:06:54.034
false,true,3211,3016,195,0,00:00:00.000,2025-04-15 10:07:34.076
false,false,3230,3035,195,510,00:00:33.000,2025-04-15 10:08:03.101
false,false,3232,3037,195,573,00:00:30.000,2025-04-15 10:08:05.103
false,false,3236,3040,196,700,00:00:32.000,2025-04-15 10:08:09.108
false,false,2930,2749,181,96,00:00:31.000,2025-04-15 10:01:44.731
false,false,2986,2801,185,1870,00:00:32.000,2025-04-15 10:02:40.789
false,false,3020,2835,185,154,00:00:33.000,2025-04-15 10:03:20.835
false,false,3025,2840,185,312,00:00:32.000,2025-04-15 10:03:25.839
false,false,3032,2846,186,531,00:00:31.000,2025-04-15 10:03:32.843
false,false,3042,2856,186,220,00:00:30.000,2025-04-15 10:03:48.856
false,false,3043,2857,186,252,00:00:32.000,2025-04-15 10:03:49.856
false,true,3043,2857,186,0,00:00:00.000,2025-04-15 10:03:54.860
false,false,3065,2879,186,160,00:00:32.000,2025-04-15 10:04:23.885
false,false,3081,2895,186,664,00:00:33.000,2025-04-15 10:04:39.902
false,false,3082,2896,186,696,00:00:32.000,2025-04-15 10:04:40.903
false,false,3254,3056,198,93,00:00:30.000,2025-04-15 10:08:39.137
false,false,3267,3067,200,381,00:00:32.000,2025-04-15 10:08:58.157
false,true,3286,3085,201,0,00:00:00.000,2025-04-15 10:09:19.178
false,true,3286,3085,201,0,00:00:00.000,2025-04-15 10:09:22.181
false,true,3286,3085,201,0,00:00:00.000,2025-04-15 10:09:23.182
false,true,3338,3133,205,0,00:00:00.000,2025-04-15 10:10:24.249
false,true,3340,3135,205,0,00:00:00.000,2025-04-15 10:10:30.256
false,true,3344,3139,205,0,00:00:00.000,2025-04-15 10:10:42.269
false,true,3356,3151,205,0,00:00:00.000,2025-04-15 10:11:03.289
false,false,3374,3168,206,573,00:00:31.000,2025-04-15 10:11:21.304
false,true,3386,3178,208,0,00:00:00.000,2025-04-15 10:11:42.325
false,true,3455,3245,210,0,00:00:00.000,2025-04-15 10:13:33.443
false,false,3476,3264,212,283,00:00:31.000,2025-04-15 10:14:03.479
false,false,3485,3273,212,564,00:00:30.000,2025-04-15 10:14:12.491
false,false,3490,3278,212,726,00:00:33.000,2025-04-15 10:14:17.495
false,true,3490,3278,212,0,00:00:00.000,2025-04-15 10:14:18.496
false,false,3499,3285,214,286,00:00:30.000,2025-04-15 10:14:32.511
false,false,3512,3298,214,691,00:00:32.000,2025-04-15 10:14:45.525
false,false,3600,3380,220,437,00:00:30.000,2025-04-15 10:17:07.673
false,false,3606,3386,220,618,00:00:31.000,2025-04-15 10:17:13.677
false,false,3625,3402,223,1212,00:00:32.000,2025-04-15 10:17:32.694
false,false,3627,3404,223,1274,00:00:31.000,2025-04-15 10:17:34.696
false,false,3669,3443,226,311,00:00:31.000,2025-04-15 10:18:22.743
false,false,3526,3311,215,435,00:00:30.000,2025-04-15 10:15:05.540
false,false,3529,3314,215,531,00:00:33.000,2025-04-15 10:15:08.543
false,false,3551,3334,217,127,00:00:32.000,2025-04-15 10:15:54.589
false,true,3558,3341,217,0,00:00:00.000,2025-04-15 10:16:05.601
false,false,3682,3454,228,189,00:00:31.000,2025-04-15 10:18:41.763
false,false,3683,3455,228,221,00:00:32.000,2025-04-15 10:18:42.764
false,true,3690,3462,228,0,00:00:00.000,2025-04-15 10:18:52.774
false,false,3695,3466,229,157,00:00:31.000,2025-04-15 10:19:00.784
false,false,3714,3481,233,381,00:00:30.000,2025-04-15 10:19:25.815
false,true,3721,3488,233,0,00:00:00.000,2025-04-15 10:19:35.825
false,true,3721,3488,233,0,00:00:00.000,2025-04-15 10:19:37.827
false,false,3732,3499,233,348,00:00:32.000,2025-04-15 10:19:49.839
false,false,3736,3503,233,33,00:00:33.000,2025-04-15 10:19:59.847
false,true,3802,3564,238,0,00:00:00.000,2025-04-15 10:21:51.968
false,false,3818,3580,238,220,00:00:33.000,2025-04-15 10:22:22.000
false,false,3825,3587,238,448,00:00:33.000,2025-04-15 10:22:29.006
false,false,3838,3598,240,221,00:00:32.000,2025-04-15 10:22:48.022
false,false,3849,3605,244,565,00:00:32.000,2025-04-15 10:22:59.034
false,true,3786,3549,237,0,00:00:00.000,2025-04-15 10:21:13.933
false,false,3787,3550,237,30,00:00:30.000,2025-04-15 10:21:14.934
false,false,3791,3554,237,160,00:00:32.000,2025-04-15 10:21:18.937
false,true,3797,3560,237,0,00:00:00.000,2025-04-15 10:21:31.947
false,true,3797,3560,237,0,00:00:00.000,2025-04-15 10:21:35.952
false,true,3398,3190,208,0,00:00:00.000,2025-04-15 10:12:03.342
false,true,3415,3207,208,0,00:00:00.000,2025-04-15 10:12:22.366
false,false,3419,3211,208,130,00:00:32.000,2025-04-15 10:12:30.375
false,true,3436,3227,209,0,00:00:00.000,2025-04-15 10:12:59.408
false,true,3437,3228,209,0,00:00:00.000,2025-04-15 10:13:06.411
false,false,3438,3229,209,31,00:00:31.000,2025-04-15 10:13:07.413
false,false,3452,3243,209,469,00:00:30.000,2025-04-15 10:13:21.428
false,false,3884,3639,245,754,00:00:30.000,2025-04-15 10:23:40.077
false,true,3890,3645,245,0,00:00:00.000,2025-04-15 10:23:50.087
false,true,3890,3645,245,0,00:00:00.000,2025-04-15 10:23:51.087
false,false,3899,3654,245,283,00:00:32.000,2025-04-15 10:24:01.102
false,true,3905,3660,245,0,00:00:00.000,2025-04-15 10:24:10.112
false,true,3914,3669,245,0,00:00:00.000,2025-04-15 10:24:25.127
false,false,3922,3676,246,157,00:00:30.000,2025-04-15 10:24:42.144
false,false,4017,3767,250,1388,00:00:32.000,2025-04-15 10:26:47.272
false,true,4019,3769,250,0,00:00:00.000,2025-04-15 10:26:54.279
false,false,4026,3775,251,217,00:00:31.000,2025-04-15 10:27:02.285
false,false,4028,3777,251,279,00:00:30.000,2025-04-15 10:27:04.286
false,true,4055,3803,252,0,00:00:00.000,2025-04-15 10:27:49.332
false,false,4076,3824,252,476,00:00:30.000,2025-04-15 10:28:16.359
false,true,4311,4048,263,0,00:00:00.000,2025-04-15 10:33:32.711
false,false,4317,4054,263,160,00:00:32.000,2025-04-15 10:33:47.726
false,false,4318,4055,263,190,00:00:30.000,2025-04-15 10:33:48.727
false,false,4322,4058,264,62,00:00:32.000,2025-04-15 10:33:58.738
false,false,4327,4063,264,219,00:00:32.000,2025-04-15 10:34:03.744
false,false,4330,4066,264,30,00:00:30.000,2025-04-15 10:34:12.757
false,true,4333,4068,265,0,00:00:00.000,2025-04-15 10:34:24.768
false,true,4351,4086,265,0,00:00:00.000,2025-04-15 10:34:52.793
false,false,4353,4087,266,64,00:00:32.000,2025-04-15 10:34:59.801
false,false,4354,4088,266,95,00:00:31.000,2025-04-15 10:35:00.802
false,true,4251,3988,263,0,00:00:00.000,2025-04-15 10:32:14.623
false,false,3945,3699,246,98,00:00:33.000,2025-04-15 10:25:17.178
false,false,3969,3720,249,126,00:00:31.000,2025-04-15 10:25:53.216
false,false,3974,3725,249,32,00:00:32.000,2025-04-15 10:26:04.229
false,false,3979,3730,249,190,00:00:32.000,2025-04-15 10:26:09.236
false,false,3993,3744,249,633,00:00:30.000,2025-04-15 10:26:23.248
false,false,4014,3764,250,1295,00:00:33.000,2025-04-15 10:26:44.269
false,false,4086,3833,253,785,00:00:30.000,2025-04-15 10:28:26.372
false,false,4107,3854,253,1439,00:00:31.000,2025-04-15 10:28:47.395
false,false,4148,3894,254,188,00:00:32.000,2025-04-15 10:29:40.449
false,false,4149,3895,254,220,00:00:32.000,2025-04-15 10:29:41.450
false,false,4160,3905,255,560,00:00:31.000,2025-04-15 10:29:52.460
false,false,4166,3911,255,61,00:00:31.000,2025-04-15 10:30:04.472
false,false,4168,3913,255,123,00:00:30.000,2025-04-15 10:30:06.473
false,false,4171,3916,255,220,00:00:32.000,2025-04-15 10:30:09.477
false,true,4179,3924,255,0,00:00:00.000,2025-04-15 10:30:26.500
false,true,4194,3937,257,0,00:00:00.000,2025-04-15 10:30:52.524
false,true,4194,3937,257,0,00:00:00.000,2025-04-15 10:30:55.528
false,false,4210,3952,258,284,00:00:30.000,2025-04-15 10:31:18.554
false,false,4369,4101,268,570,00:00:31.000,2025-04-15 10:35:15.816
false,true,4403,4132,271,0,00:00:00.000,2025-04-15 10:35:52.857
false,true,4416,4145,271,0,00:00:00.000,2025-04-15 10:36:11.875
false,false,4439,4166,273,372,00:00:32.000,2025-04-15 10:36:43.905
false,false,4616,4333,283,823,00:00:33.000,2025-04-15 10:40:17.115
false,false,4624,4341,283,33,00:00:33.000,2025-04-15 10:40:49.149
false,false,4655,4370,285,221,00:00:30.000,2025-04-15 10:41:44.206
false,false,4465,4191,274,440,00:00:31.000,2025-04-15 10:37:15.936
false,false,4468,4194,274,539,00:00:33.000,2025-04-15 10:37:18.940
false,false,4492,4216,276,554,00:00:30.000,2025-04-15 10:37:54.978
false,false,4502,4225,277,872,00:00:31.000,2025-04-15 10:38:04.985
false,false,4557,4278,279,538,00:00:33.000,2025-04-15 10:39:12.047
false,false,4566,4287,279,828,00:00:33.000,2025-04-15 10:39:21.059
false,false,4600,4320,280,317,00:00:32.000,2025-04-15 10:40:01.098
false,false,4665,4379,286,537,00:00:31.000,2025-04-15 10:41:54.217
false,true,4665,4379,286,0,00:00:00.000,2025-04-15 10:41:56.220
false,false,4676,4390,286,342,00:00:33.000,2025-04-15 10:42:11.231
false,false,4684,4396,288,158,00:00:30.000,2025-04-15 10:42:25.242
false,false,4690,4402,288,349,00:00:33.000,2025-04-15 10:42:31.247
false,false,4700,4411,289,186,00:00:30.000,2025-04-15 10:42:47.262
false,true,4701,4412,289,0,00:00:00.000,2025-04-15 10:42:52.270
false,false,4715,4424,291,438,00:00:30.000,2025-04-15 10:43:08.289
false,false,4718,4426,292,530,00:00:31.000,2025-04-15 10:43:11.291
false,true,4724,4432,292,0,00:00:00.000,2025-04-15 10:43:22.299
false,false,4728,4436,292,129,00:00:32.000,2025-04-15 10:43:27.306
false,true,4732,4440,292,0,00:00:00.000,2025-04-15 10:43:34.314
false,false,4744,4451,293,377,00:00:30.000,2025-04-15 10:43:49.330
false,false,4755,4461,294,723,00:00:31.000,2025-04-15 10:44:00.341
false,false,4757,4463,294,783,00:00:30.000,2025-04-15 10:44:02.344
false,false,4772,4478,294,63,00:00:31.000,2025-04-15 10:44:29.378
false,false,4781,4487,294,156,00:00:30.000,2025-04-15 10:44:44.392
false,false,4811,4516,295,156,00:00:33.000,2025-04-15 10:45:20.425
false,true,4814,4519,295,0,00:00:00.000,2025-04-15 10:45:25.428
false,false,4834,4539,295,253,00:00:30.000,2025-04-15 10:46:01.462
false,true,4837,4541,296,0,00:00:00.000,2025-04-15 10:46:08.470
false,false,4842,4545,297,95,00:00:32.000,2025-04-15 10:46:21.484
false,false,4861,4563,298,311,00:00:31.000,2025-04-15 10:46:46.514
false,true,4871,4572,299,0,00:00:00.000,2025-04-15 10:47:00.530
false,false,4872,4573,299,31,00:00:31.000,2025-04-15 10:47:03.534
false,false,4890,4590,300,604,00:00:31.000,2025-04-15 10:47:21.555
false,false,4891,4591,300,635,00:00:31.000,2025-04-15 10:47:22.556
false,false,4905,4605,300,1070,00:00:32.000,2025-04-15 10:47:36.574
false,false,4908,4608,300,1163,00:00:32.000,2025-04-15 10:47:39.577
false,false,4911,4611,300,1256,00:00:30.000,2025-04-15 10:47:42.580
false,false,4928,4626,302,536,00:00:33.000,2025-04-15 10:48:05.604
false,false,4932,4629,303,664,00:00:30.000,2025-04-15 10:48:09.608
false,false,5333,4998,335,945,00:00:30.000,2025-04-15 10:56:57.139
false,false,5334,4999,335,977,00:00:32.000,2025-04-15 10:56:58.139
false,true,5334,4999,335,0,00:00:00.000,2025-04-15 10:57:00.142
false,false,5339,5004,335,155,00:00:30.000,2025-04-15 10:57:09.150
false,false,5365,5028,337,32,00:00:32.000,2025-04-15 10:57:47.185
false,false,5386,5048,338,702,00:00:32.000,2025-04-15 10:58:08.205
false,false,5397,5057,340,1055,00:00:31.000,2025-04-15 10:58:19.212
false,false,5098,4781,317,474,00:00:32.000,2025-04-15 10:51:55.851
false,true,5110,4792,318,0,00:00:00.000,2025-04-15 10:52:12.866
false,false,5115,4797,318,158,00:00:30.000,2025-04-15 10:52:18.872
false,false,5129,4810,319,404,00:00:32.000,2025-04-15 10:52:44.895
false,false,5131,4811,320,467,00:00:33.000,2025-04-15 10:52:46.898
false,true,1978,1857,121,0,00:00:00.000,2025-04-15 09:39:15.362
false,false,2018,1895,123,697,00:00:32.000,2025-04-15 09:40:13.417
false,false,2028,1903,125,1012,00:00:32.000,2025-04-15 09:40:23.428
false,false,2041,1915,126,185,00:00:30.000,2025-04-15 09:40:42.448
false,true,2356,2207,149,0,00:00:00.000,2025-04-15 09:47:59.899
false,true,2362,2213,149,0,00:00:00.000,2025-04-15 09:48:15.915
false,false,2383,2232,151,666,00:00:33.000,2025-04-15 09:48:36.939
false,true,2399,2248,151,0,00:00:00.000,2025-04-15 09:49:01.968
false,false,2286,2141,145,126,00:00:30.000,2025-04-15 09:45:53.763
false,true,2291,2146,145,0,00:00:00.000,2025-04-15 09:46:06.780
false,false,2320,2173,147,251,00:00:31.000,2025-04-15 09:47:09.837
false,false,2247,2107,140,33,00:00:33.000,2025-04-15 09:44:38.691
false,false,2249,2109,140,96,00:00:33.000,2025-04-15 09:44:40.692
false,false,2250,2109,141,126,00:00:30.000,2025-04-15 09:44:41.693
false,false,2260,2119,141,96,00:00:31.000,2025-04-15 09:45:09.721
false,false,2277,2134,143,416,00:00:31.000,2025-04-15 09:45:32.746
false,false,2424,2271,153,781,00:00:32.000,2025-04-15 09:49:29.994
false,false,2436,2282,154,1156,00:00:31.000,2025-04-15 09:49:42.004
false,false,2440,2286,154,1284,00:00:30.000,2025-04-15 09:49:46.007
false,false,2451,2296,155,1635,00:00:32.000,2025-04-15 09:49:57.018
false,false,2465,2310,155,2076,00:00:33.000,2025-04-15 09:50:11.029
false,true,2468,2313,155,0,00:00:00.000,2025-04-15 09:50:21.036
false,true,2468,2313,155,0,00:00:00.000,2025-04-15 09:50:22.036
false,true,2468,2313,155,0,00:00:00.000,2025-04-15 09:50:27.041
false,false,2469,2314,155,30,00:00:30.000,2025-04-15 09:50:33.050
false,false,2470,2315,155,60,00:00:30.000,2025-04-15 09:50:34.051
false,true,2470,2315,155,0,00:00:00.000,2025-04-15 09:50:37.054
false,false,2480,2323,157,31,00:00:31.000,2025-04-15 09:51:02.083
false,false,2515,2357,158,31,00:00:31.000,2025-04-15 09:51:49.129
false,false,2623,2461,162,33,00:00:33.000,2025-04-15 09:54:19.282
false,true,2642,2478,164,0,00:00:00.000,2025-04-15 09:54:40.300
false,true,2642,2478,164,0,00:00:00.000,2025-04-15 09:54:41.301
false,false,2655,2489,166,419,00:00:33.000,2025-04-15 09:54:57.314
false,false,2672,2505,167,32,00:00:32.000,2025-04-15 09:55:20.333
false,true,2676,2509,167,0,00:00:00.000,2025-04-15 09:55:37.348
false,true,2545,2386,159,0,00:00:00.000,2025-04-15 09:52:30.169
false,false,2549,2390,159,130,00:00:33.000,2025-04-15 09:52:35.175
false,false,2564,2405,159,606,00:00:33.000,2025-04-15 09:52:50.191
false,false,2598,2438,160,536,00:00:30.000,2025-04-15 09:53:30.233
false,true,2601,2441,160,0,00:00:00.000,2025-04-15 09:53:51.255
false,false,2605,2445,160,126,00:00:33.000,2025-04-15 09:53:55.258
false,false,2611,2450,161,319,00:00:32.000,2025-04-15 09:54:01.264
false,false,2739,2571,168,31,00:00:31.000,2025-04-15 09:57:03.434
false,false,2741,2573,168,33,00:00:33.000,2025-04-15 09:57:11.445
false,false,2745,2576,169,158,00:00:31.000,2025-04-15 09:57:15.448
false,false,2746,2577,169,191,00:00:33.000,2025-04-15 09:57:16.449
false,false,2751,2581,170,62,00:00:32.000,2025-04-15 09:57:27.460
false,true,2758,2587,171,0,00:00:00.000,2025-04-15 09:57:36.469
false,false,2783,2611,172,789,00:00:33.000,2025-04-15 09:58:05.503
false,false,2785,2612,173,853,00:00:31.000,2025-04-15 09:58:07.504
false,false,2789,2616,173,96,00:00:31.000,2025-04-15 09:58:17.509
false,false,2710,2543,167,127,00:00:30.000,2025-04-15 09:56:28.393
false,false,2720,2553,167,442,00:00:30.000,2025-04-15 09:56:38.403
false,false,2724,2557,167,569,00:00:33.000,2025-04-15 09:56:42.409
false,true,2809,2635,174,0,00:00:00.000,2025-04-15 09:58:43.534
false,false,2810,2636,174,32,00:00:32.000,2025-04-15 09:58:44.534
false,false,2814,2640,174,130,00:00:32.000,2025-04-15 09:58:54.545
false,false,2820,2646,174,320,00:00:31.000,2025-04-15 09:59:00.549
false,false,2865,2690,175,187,00:00:32.000,2025-04-15 10:00:03.619
false,false,2870,2694,176,348,00:00:33.000,2025-04-15 10:00:08.625
false,false,2880,2704,176,158,00:00:33.000,2025-04-15 10:00:24.647
false,false,2891,2714,177,501,00:00:30.000,2025-04-15 10:00:35.662
false,true,2917,2736,181,0,00:00:00.000,2025-04-15 10:01:25.713
false,false,2921,2740,181,123,00:00:30.000,2025-04-15 10:01:29.717
false,false,3102,2915,187,244,00:00:30.000,2025-04-15 10:05:06.933
false,false,3124,2936,188,935,00:00:31.000,2025-04-15 10:05:28.954
false,true,3124,2936,188,0,00:00:00.000,2025-04-15 10:05:33.961
false,false,3139,2949,190,477,00:00:32.000,2025-04-15 10:05:49.973
false,true,3158,2966,192,0,00:00:00.000,2025-04-15 10:06:11.996
false,true,3204,3009,195,0,00:00:00.000,2025-04-15 10:07:14.051
false,true,3204,3009,195,0,00:00:00.000,2025-04-15 10:07:16.054
false,true,3204,3009,195,0,00:00:00.000,2025-04-15 10:07:17.055
false,true,3209,3014,195,0,00:00:00.000,2025-04-15 10:07:29.071
false,false,2936,2754,182,286,00:00:31.000,2025-04-15 10:01:50.733
false,false,2976,2791,185,1549,00:00:30.000,2025-04-15 10:02:30.777
false,false,2985,2800,185,1838,00:00:33.000,2025-04-15 10:02:39.787
false,false,2998,2813,185,2244,00:00:31.000,2025-04-15 10:02:52.802
false,false,3031,2845,186,500,00:00:30.000,2025-04-15 10:03:31.843
false,false,3033,2847,186,564,00:00:33.000,2025-04-15 10:03:33.844
false,false,3037,2851,186,63,00:00:31.000,2025-04-15 10:03:43.851
false,false,3051,2865,186,253,00:00:31.000,2025-04-15 10:04:03.864
false,false,3053,2867,186,317,00:00:31.000,2025-04-15 10:04:05.867
false,true,3094,2907,187,0,00:00:00.000,2025-04-15 10:04:54.917
false,false,3246,3050,196,188,00:00:30.000,2025-04-15 10:08:25.122
false,false,3278,3077,201,733,00:00:33.000,2025-04-15 10:09:09.169
false,false,3279,3078,201,766,00:00:33.000,2025-04-15 10:09:10.169
false,false,3315,3113,202,912,00:00:30.000,2025-04-15 10:09:52.211
false,false,3329,3126,203,1350,00:00:32.000,2025-04-15 10:10:06.226
false,false,3331,3128,203,1410,00:00:30.000,2025-04-15 10:10:08.229
false,true,3344,3139,205,0,00:00:00.000,2025-04-15 10:10:40.266
false,false,3353,3148,205,285,00:00:33.000,2025-04-15 10:10:54.278
false,true,3356,3151,205,0,00:00:00.000,2025-04-15 10:11:00.284
false,false,3367,3162,205,351,00:00:32.000,2025-04-15 10:11:14.297
false,false,3370,3164,206,447,00:00:33.000,2025-04-15 10:11:17.301
false,false,3381,3175,206,127,00:00:33.000,2025-04-15 10:11:34.318
false,false,3383,3176,207,189,00:00:31.000,2025-04-15 10:11:36.320
false,true,3455,3245,210,0,00:00:00.000,2025-04-15 10:13:27.435
false,true,3455,3245,210,0,00:00:00.000,2025-04-15 10:13:36.445
false,false,3461,3251,210,188,00:00:30.000,2025-04-15 10:13:42.453
false,true,3467,3257,210,0,00:00:00.000,2025-04-15 10:13:54.468
false,false,3506,3292,214,505,00:00:30.000,2025-04-15 10:14:39.519
false,false,3523,3308,215,344,00:00:30.000,2025-04-15 10:15:02.538
false,false,3618,3396,222,992,00:00:33.000,2025-04-15 10:17:25.688
false,false,3622,3399,223,1119,00:00:33.000,2025-04-15 10:17:29.689
false,false,3624,3401,223,1180,00:00:30.000,2025-04-15 10:17:31.693
false,false,3641,3416,225,1710,00:00:30.000,2025-04-15 10:17:48.711
false,true,3659,3434,225,0,00:00:00.000,2025-04-15 10:18:08.728
false,true,3531,3316,215,0,00:00:00.000,2025-04-15 10:15:15.549
false,true,3541,3324,217,0,00:00:00.000,2025-04-15 10:15:35.571
false,true,3541,3324,217,0,00:00:00.000,2025-04-15 10:15:37.572
false,true,3558,3341,217,0,00:00:00.000,2025-04-15 10:16:02.597
false,true,3579,3359,220,0,00:00:00.000,2025-04-15 10:16:39.638
false,false,3582,3362,220,93,00:00:32.000,2025-04-15 10:16:43.643
false,true,3676,3450,226,0,00:00:00.000,2025-04-15 10:18:31.752
false,true,3676,3450,226,0,00:00:00.000,2025-04-15 10:18:34.753
false,false,3687,3459,228,345,00:00:30.000,2025-04-15 10:18:46.769
false,true,3702,3471,231,0,00:00:00.000,2025-04-15 10:19:10.799
false,false,3704,3473,231,63,00:00:32.000,2025-04-15 10:19:15.802
false,false,3712,3479,233,320,00:00:32.000,2025-04-15 10:19:23.813
false,false,3715,3482,233,412,00:00:31.000,2025-04-15 10:19:26.816
false,false,3720,3487,233,566,00:00:30.000,2025-04-15 10:19:31.821
false,false,3729,3496,233,255,00:00:32.000,2025-04-15 10:19:46.838
false,false,3733,3500,233,379,00:00:31.000,2025-04-15 10:19:50.840
false,false,3738,3505,233,97,00:00:33.000,2025-04-15 10:20:01.849
false,false,3823,3585,238,382,00:00:33.000,2025-04-15 10:22:27.005
false,false,3830,3591,239,609,00:00:33.000,2025-04-15 10:22:34.010
false,false,3832,3593,239,32,00:00:32.000,2025-04-15 10:22:42.019
false,false,3852,3608,244,657,00:00:30.000,2025-04-15 10:23:02.036
false,true,3860,3616,244,0,00:00:00.000,2025-04-15 10:23:11.047
false,false,3749,3515,234,442,00:00:30.000,2025-04-15 10:20:12.859
false,false,3763,3529,234,885,00:00:33.000,2025-04-15 10:20:26.876
false,true,3773,3538,235,0,00:00:00.000,2025-04-15 10:20:37.891
false,true,3773,3538,235,0,00:00:00.000,2025-04-15 10:20:39.894
false,false,3785,3548,237,123,00:00:32.000,2025-04-15 10:21:00.919
false,true,3786,3549,237,0,00:00:00.000,2025-04-15 10:21:10.929
false,false,3788,3551,237,62,00:00:32.000,2025-04-15 10:21:15.934
false,true,3798,3561,237,0,00:00:00.000,2025-04-15 10:21:38.955
false,false,3390,3182,208,127,00:00:33.000,2025-04-15 10:11:49.333
false,false,3421,3212,209,192,00:00:32.000,2025-04-15 10:12:32.378
false,false,3427,3218,209,188,00:00:32.000,2025-04-15 10:12:44.392
false,false,3435,3226,209,440,00:00:30.000,2025-04-15 10:12:52.399
false,false,3437,3228,209,33,00:00:33.000,2025-04-15 10:13:00.408
false,false,3439,3230,209,63,00:00:32.000,2025-04-15 10:13:08.414
false,false,3874,3630,244,436,00:00:31.000,2025-04-15 10:23:30.065
false,false,3876,3632,244,499,00:00:32.000,2025-04-15 10:23:32.069
false,false,3881,3636,245,659,00:00:32.000,2025-04-15 10:23:37.073
false,false,3904,3659,245,437,00:00:31.000,2025-04-15 10:24:06.109
false,true,3914,3669,245,0,00:00:00.000,2025-04-15 10:24:27.129
false,true,3917,3672,245,0,00:00:00.000,2025-04-15 10:24:34.135
false,false,3923,3677,246,189,00:00:32.000,2025-04-15 10:24:43.145
false,true,3928,3682,246,0,00:00:00.000,2025-04-15 10:24:54.156
false,false,4020,3770,250,31,00:00:31.000,2025-04-15 10:26:56.280
false,false,4024,3774,250,154,00:00:31.000,2025-04-15 10:27:00.284
false,false,4058,3806,252,93,00:00:32.000,2025-04-15 10:27:52.336
false,false,4069,3817,252,255,00:00:33.000,2025-04-15 10:28:09.352
false,false,4311,4048,263,277,00:00:33.000,2025-04-15 10:33:29.710
false,false,4313,4050,263,32,00:00:32.000,2025-04-15 10:33:43.721
false,false,4328,4064,264,252,00:00:33.000,2025-04-15 10:34:04.745
false,true,4333,4068,265,0,00:00:00.000,2025-04-15 10:34:20.764
false,false,4347,4082,265,93,00:00:30.000,2025-04-15 10:34:47.790
false,false,4350,4085,265,186,00:00:31.000,2025-04-15 10:34:50.792
false,true,4351,4086,265,0,00:00:00.000,2025-04-15 10:34:54.797
false,false,4241,3979,262,127,00:00:33.000,2025-04-15 10:32:01.606
false,false,4250,3987,263,409,00:00:31.000,2025-04-15 10:32:10.617
false,true,3942,3696,246,0,00:00:00.000,2025-04-15 10:25:14.174
false,false,3954,3708,246,377,00:00:31.000,2025-04-15 10:25:26.187
false,true,3973,3724,249,0,00:00:00.000,2025-04-15 10:26:03.228
false,false,3987,3738,249,442,00:00:33.000,2025-04-15 10:26:17.241
false,false,3996,3746,250,729,00:00:33.000,2025-04-15 10:26:26.252
false,true,4118,3865,253,0,00:00:00.000,2025-04-15 10:29:02.412
false,false,4120,3867,253,65,00:00:33.000,2025-04-15 10:29:06.416
false,false,4133,3879,254,478,00:00:32.000,2025-04-15 10:29:19.430
false,false,4134,3880,254,510,00:00:32.000,2025-04-15 10:29:20.431
false,false,4146,3892,254,125,00:00:30.000,2025-04-15 10:29:38.446
false,true,4174,3919,255,0,00:00:00.000,2025-04-15 10:30:18.487
false,false,4194,3937,257,63,00:00:31.000,2025-04-15 10:30:50.522
false,false,4202,3945,257,32,00:00:32.000,2025-04-15 10:31:10.546
false,false,4208,3950,258,221,00:00:31.000,2025-04-15 10:31:16.551
false,false,4229,3970,259,372,00:00:30.000,2025-04-15 10:31:43.583
false,false,4373,4105,268,693,00:00:31.000,2025-04-15 10:35:19.821
false,false,4392,4123,269,1296,00:00:30.000,2025-04-15 10:35:38.842
false,false,4406,4135,271,97,00:00:33.000,2025-04-15 10:35:58.863
false,false,4422,4150,272,186,00:00:32.000,2025-04-15 10:36:20.882
false,true,4427,4155,272,0,00:00:00.000,2025-04-15 10:36:26.889
false,true,4427,4155,272,0,00:00:00.000,2025-04-15 10:36:28.890
false,false,4605,4324,281,472,00:00:31.000,2025-04-15 10:40:06.105
false,false,4615,4332,283,790,00:00:33.000,2025-04-15 10:40:16.114
false,true,4616,4333,283,0,00:00:00.000,2025-04-15 10:40:19.118
false,true,4616,4333,283,0,00:00:00.000,2025-04-15 10:40:22.123
false,false,4618,4335,283,64,00:00:33.000,2025-04-15 10:40:25.125
false,true,4618,4335,283,0,00:00:00.000,2025-04-15 10:40:26.126
false,true,4618,4335,283,0,00:00:00.000,2025-04-15 10:40:27.128
false,false,4621,4338,283,63,00:00:33.000,2025-04-15 10:40:40.140
false,true,4623,4340,283,0,00:00:00.000,2025-04-15 10:40:43.144
false,false,4632,4348,284,287,00:00:33.000,2025-04-15 10:40:57.158
false,false,4635,4351,284,383,00:00:33.000,2025-04-15 10:41:00.160
false,false,4640,4356,284,95,00:00:33.000,2025-04-15 10:41:11.174
false,true,4645,4360,285,0,00:00:00.000,2025-04-15 10:41:20.182
false,false,4656,4370,286,251,00:00:30.000,2025-04-15 10:41:45.207
false,false,4448,4175,273,656,00:00:31.000,2025-04-15 10:36:52.914
false,false,4449,4176,273,686,00:00:30.000,2025-04-15 10:36:53.916
false,true,4451,4177,274,0,00:00:00.000,2025-04-15 10:36:58.920
false,false,4457,4183,274,187,00:00:32.000,2025-04-15 10:37:07.930
false,false,4482,4207,275,246,00:00:30.000,2025-04-15 10:37:44.966
false,false,4501,4224,277,841,00:00:33.000,2025-04-15 10:38:03.984
false,false,4504,4227,277,937,00:00:33.000,2025-04-15 10:38:06.987
false,false,4526,4247,279,1634,00:00:30.000,2025-04-15 10:38:29.011
false,false,4527,4248,279,1664,00:00:30.000,2025-04-15 10:38:30.013
false,false,4532,4253,279,1819,00:00:30.000,2025-04-15 10:38:35.016
false,false,4534,4255,279,1884,00:00:32.000,2025-04-15 10:38:37.019
false,true,4537,4258,279,0,00:00:00.000,2025-04-15 10:38:45.025
false,false,4550,4271,279,314,00:00:31.000,2025-04-15 10:39:05.041
false,false,4553,4274,279,410,00:00:32.000,2025-04-15 10:39:08.044
false,false,4564,4285,279,764,00:00:33.000,2025-04-15 10:39:19.057
false,false,4589,4309,280,1551,00:00:33.000,2025-04-15 10:39:44.079
true,false,2294,2148,146,95,00:00:32.000,2025-04-15 09:46:13.787
true,false,2313,2166,147,32,00:00:32.000,2025-04-15 09:47:02.829
true,false,2324,2177,147,379,00:00:33.000,2025-04-15 09:47:13.842
true,true,2326,2179,147,0,00:00:00.000,2025-04-15 09:47:19.851
true,true,2539,2380,159,0,00:00:00.000,2025-04-15 09:52:19.159
true,true,2671,2504,167,0,00:00:00.000,2025-04-15 09:55:16.331
true,false,2899,2721,178,124,00:00:30.000,2025-04-15 10:00:49.677
true,false,3220,3025,195,188,00:00:30.000,2025-04-15 10:07:53.092
true,false,2961,2777,184,1073,00:00:31.000,2025-04-15 10:02:15.763
true,true,3094,2907,187,0,00:00:00.000,2025-04-15 10:04:53.916
true,false,3645,3420,225,1837,00:00:33.000,2025-04-15 10:17:52.713
true,false,3417,3209,208,66,00:00:33.000,2025-04-15 10:12:28.373
true,false,4118,3865,253,1789,00:00:30.000,2025-04-15 10:28:58.408
true,false,4396,4127,269,1422,00:00:30.000,2025-04-15 10:35:42.846
true,true,4825,4530,295,0,00:00:00.000,2025-04-15 10:45:41.442
true,false,5110,4792,318,850,00:00:31.000,2025-04-15 10:52:07.861
true,false,5127,4809,318,341,00:00:30.000,2025-04-15 10:52:42.893
true,false,2617,2455,162,510,00:00:33.000,2025-04-15 09:54:07.269
true,true,2758,2587,171,0,00:00:00.000,2025-04-15 09:57:38.470
true,false,2713,2546,167,223,00:00:32.000,2025-04-15 09:56:31.397
true,false,2721,2554,167,472,00:00:30.000,2025-04-15 09:56:39.405
true,false,2890,2713,177,471,00:00:30.000,2025-04-15 10:00:34.660
true,false,3605,3385,220,587,00:00:30.000,2025-04-15 10:17:12.676
true,false,3681,3453,228,158,00:00:33.000,2025-04-15 10:18:40.761
true,false,3877,3633,244,531,00:00:32.000,2025-04-15 10:23:33.069
true,false,3880,3635,245,627,00:00:31.000,2025-04-15 10:23:36.071
true,true,4333,4068,265,0,00:00:00.000,2025-04-15 10:34:26.770
true,false,4261,3998,263,314,00:00:30.000,2025-04-15 10:32:27.638
true,false,4265,4002,263,441,00:00:32.000,2025-04-15 10:32:31.642
true,false,4780,4486,294,126,00:00:31.000,2025-04-15 10:44:43.391
true,true,4911,4611,300,0,00:00:00.000,2025-04-15 10:47:43.581
true,false,2578,2418,160,1038,00:00:31.000,2025-04-15 09:53:04.205
true,true,2911,2731,180,0,00:00:00.000,2025-04-15 10:01:12.699
true,true,3214,3019,195,0,00:00:00.000,2025-04-15 10:07:43.086
true,false,3520,3305,215,251,00:00:33.000,2025-04-15 10:14:59.535
true,false,3604,3384,220,557,00:00:30.000,2025-04-15 10:17:11.676
true,true,3558,3341,217,0,00:00:00.000,2025-04-15 10:16:04.600
true,true,4045,3793,252,0,00:00:00.000,2025-04-15 10:27:33.318
true,true,4311,4048,263,0,00:00:00.000,2025-04-15 10:33:35.714
true,false,4251,3988,263,441,00:00:32.000,2025-04-15 10:32:11.619
true,true,4142,3888,254,0,00:00:00.000,2025-04-15 10:29:34.441
true,false,4519,4241,278,1413,00:00:31.000,2025-04-15 10:38:22.005
true,false,4778,4484,294,63,00:00:30.000,2025-04-15 10:44:41.390
true,false,1996,1874,122,226,00:00:33.000,2025-04-15 09:39:45.385
true,true,2399,2248,151,0,00:00:00.000,2025-04-15 09:49:02.969
true,true,2312,2165,147,0,00:00:00.000,2025-04-15 09:47:01.829
true,true,2282,2137,145,0,00:00:00.000,2025-04-15 09:45:38.751
true,false,2401,2250,151,63,00:00:33.000,2025-04-15 09:49:06.973
true,false,3128,2940,188,127,00:00:33.000,2025-04-15 10:05:38.966
true,true,3676,3450,226,0,00:00:00.000,2025-04-15 10:18:32.753
true,false,3831,3592,239,640,00:00:31.000,2025-04-15 10:22:35.011
true,false,3865,3621,244,158,00:00:33.000,2025-04-15 10:23:21.056
true,false,3415,3207,208,539,00:00:31.000,2025-04-15 10:12:20.364
true,false,4340,4075,265,218,00:00:31.000,2025-04-15 10:34:34.777
true,false,4256,3993,263,161,00:00:33.000,2025-04-15 10:32:22.634
true,false,4259,3996,263,254,00:00:31.000,2025-04-15 10:32:25.637
true,false,4152,3897,255,314,00:00:33.000,2025-04-15 10:29:44.453
true,false,2025,1900,125,917,00:00:32.000,2025-04-15 09:40:20.425
true,true,2242,2102,140,0,00:00:00.000,2025-04-15 09:44:18.673
true,true,2470,2315,155,0,00:00:00.000,2025-04-15 09:50:35.051
true,false,2663,2496,167,677,00:00:32.000,2025-04-15 09:55:05.319
true,false,2821,2647,174,352,00:00:32.000,2025-04-15 09:59:01.551
true,false,3463,3253,210,251,00:00:30.000,2025-04-15 10:13:44.454
true,false,3450,3241,209,408,00:00:30.000,2025-04-15 10:13:19.425
true,true,3928,3682,246,0,00:00:00.000,2025-04-15 10:24:52.154
true,false,4235,3975,260,564,00:00:33.000,2025-04-15 10:31:49.591
true,true,4287,4024,263,0,00:00:00.000,2025-04-15 10:32:58.674
true,false,4407,4136,271,128,00:00:31.000,2025-04-15 10:35:59.865
true,false,4721,4429,292,624,00:00:30.000,2025-04-15 10:43:14.295
true,true,5346,5011,335,0,00:00:00.000,2025-04-15 10:57:19.157
true,false,5107,4789,318,757,00:00:33.000,2025-04-15 10:52:04.858
true,false,2235,2095,140,4550,00:00:30.000,2025-04-15 09:44:08.664
true,false,2881,2705,176,191,00:00:33.000,2025-04-15 10:00:25.648
true,false,3052,2866,186,286,00:00:33.000,2025-04-15 10:04:04.865
true,false,4860,4562,298,280,00:00:32.000,2025-04-15 10:46:45.512
true,false,5327,4992,335,756,00:00:32.000,2025-04-15 10:56:51.133
true,true,2356,2207,149,0,00:00:00.000,2025-04-15 09:48:03.904
true,false,3204,3009,195,410,00:00:33.000,2025-04-15 10:07:13.051
true,false,3212,3017,195,33,00:00:33.000,2025-04-15 10:07:39.083
true,false,3602,3382,220,497,00:00:30.000,2025-04-15 10:17:09.673
true,false,3638,3414,224,1619,00:00:32.000,2025-04-15 10:17:45.708
true,false,3660,3435,225,30,00:00:30.000,2025-04-15 10:18:13.732
true,true,3541,3324,217,0,00:00:00.000,2025-04-15 10:15:36.572
true,false,3716,3483,233,444,00:00:32.000,2025-04-15 10:19:27.817
true,true,3785,3548,237,0,00:00:00.000,2025-04-15 10:21:06.926
true,true,3914,3669,245,0,00:00:00.000,2025-04-15 10:24:26.128
true,true,4344,4079,265,0,00:00:00.000,2025-04-15 10:34:40.783
true,false,4653,4368,285,158,00:00:30.000,2025-04-15 10:41:42.205
true,false,4742,4449,293,314,00:00:30.000,2025-04-15 10:43:47.327
true,false,2296,2150,146,61,00:00:31.000,2025-04-15 09:46:21.792
true,false,2312,2165,147,63,00:00:32.000,2025-04-15 09:46:49.818
true,false,2232,2092,140,4457,00:00:33.000,2025-04-15 09:44:05.661
true,true,2250,2109,141,0,00:00:00.000,2025-04-15 09:44:46.699
true,true,2859,2685,174,0,00:00:00.000,2025-04-15 09:59:55.610
true,false,3183,2990,193,189,00:00:32.000,2025-04-15 10:06:46.026
true,false,3238,3042,196,761,00:00:31.000,2025-04-15 10:08:11.110
true,false,2939,2757,182,376,00:00:30.000,2025-04-15 10:01:53.737
true,false,3628,3405,223,1304,00:00:30.000,2025-04-15 10:17:35.698
true,false,3745,3511,234,318,00:00:32.000,2025-04-15 10:20:08.856
true,true,3421,3212,209,0,00:00:00.000,2025-04-15 10:12:36.384
true,false,3869,3625,244,284,00:00:31.000,2025-04-15 10:23:25.060
true,false,3997,3747,250,761,00:00:32.000,2025-04-15 10:26:27.254
true,false,4363,4096,267,380,00:00:32.000,2025-04-15 10:35:09.812
true,false,4554,4275,279,441,00:00:31.000,2025-04-15 10:39:09.045
true,true,2326,2179,147,0,00:00:00.000,2025-04-15 09:47:16.847
true,false,2431,2278,153,999,00:00:30.000,2025-04-15 09:49:36.999
true,false,2635,2471,164,413,00:00:33.000,2025-04-15 09:54:31.291
true,true,2581,2421,160,0,00:00:00.000,2025-04-15 09:53:09.213
true,false,3113,2925,188,590,00:00:33.000,2025-04-15 10:05:17.945
true,false,2929,2748,181,65,00:00:32.000,2025-04-15 10:01:43.730
true,false,3249,3053,196,281,00:00:30.000,2025-04-15 10:08:28.125
true,false,3281,3080,201,826,00:00:30.000,2025-04-15 10:09:12.172
true,false,3535,3319,216,129,00:00:33.000,2025-04-15 10:15:20.556
true,false,4724,4432,292,720,00:00:31.000,2025-04-15 10:43:17.296
true,false,1997,1875,122,33,00:00:33.000,2025-04-15 09:39:52.393
true,false,2599,2439,160,566,00:00:30.000,2025-04-15 09:53:31.235
true,true,2749,2579,170,0,00:00:00.000,2025-04-15 09:57:23.456
true,false,2786,2613,173,886,00:00:33.000,2025-04-15 09:58:08.505
true,false,2841,2667,174,65,00:00:33.000,2025-04-15 09:59:27.578
true,false,2879,2703,176,125,00:00:30.000,2025-04-15 10:00:23.647
true,false,3211,3016,195,63,00:00:33.000,2025-04-15 10:07:32.074
true,false,3321,3118,203,1100,00:00:31.000,2025-04-15 10:09:58.217
true,true,3340,3135,205,0,00:00:00.000,2025-04-15 10:10:33.259
true,false,3747,3513,234,380,00:00:30.000,2025-04-15 10:20:10.858
true,false,3425,3216,209,125,00:00:30.000,2025-04-15 10:12:42.391
true,false,4366,4099,267,474,00:00:30.000,2025-04-15 10:35:12.813
true,true,4701,4412,289,0,00:00:00.000,2025-04-15 10:42:54.273
true,false,5140,4820,320,752,00:00:32.000,2025-04-15 10:52:55.908
true,true,2242,2102,140,0,00:00:00.000,2025-04-15 09:44:17.672
true,false,2543,2384,159,129,00:00:33.000,2025-04-15 09:52:23.162
true,false,2835,2661,174,793,00:00:33.000,2025-04-15 09:59:15.563
true,false,3314,3112,202,882,00:00:31.000,2025-04-15 10:09:51.210
true,true,3690,3462,228,0,00:00:00.000,2025-04-15 10:18:54.776
true,true,3791,3554,237,0,00:00:00.000,2025-04-15 10:21:20.939
true,false,3976,3727,249,95,00:00:31.000,2025-04-15 10:26:06.233
true,false,4125,3872,253,225,00:00:32.000,2025-04-15 10:29:11.423
true,false,4197,3940,257,95,00:00:33.000,2025-04-15 10:30:59.531
true,false,4750,4456,294,568,00:00:32.000,2025-04-15 10:43:55.338
true,false,4927,4625,302,503,00:00:32.000,2025-04-15 10:48:04.603
true,false,2026,1901,125,949,00:00:32.000,2025-04-15 09:40:21.425
true,false,2359,2210,149,93,00:00:31.000,2025-04-15 09:48:06.907
true,false,2252,2111,141,33,00:00:33.000,2025-04-15 09:44:55.705
true,false,2887,2710,177,381,00:00:30.000,2025-04-15 10:00:31.655
true,false,3121,2933,188,841,00:00:30.000,2025-04-15 10:05:25.951
true,false,3172,2980,192,442,00:00:31.000,2025-04-15 10:06:29.009
true,false,3241,3045,196,32,00:00:32.000,2025-04-15 10:08:20.117
true,false,3070,2884,186,319,00:00:32.000,2025-04-15 10:04:28.889
true,false,3366,3161,205,319,00:00:33.000,2025-04-15 10:11:13.297
true,false,3842,3601,241,345,00:00:31.000,2025-04-15 10:22:52.027
true,true,4061,3809,252,0,00:00:00.000,2025-04-15 10:28:01.344
true,false,4395,4126,269,1392,00:00:31.000,2025-04-15 10:35:41.845
true,false,2231,2092,139,4424,00:00:32.000,2025-04-15 09:44:04.660
true,false,2640,2476,164,577,00:00:33.000,2025-04-15 09:54:36.295
true,false,2838,2664,174,888,00:00:32.000,2025-04-15 09:59:18.568
true,false,2839,2665,174,918,00:00:30.000,2025-04-15 09:59:19.569
true,true,2895,2717,178,0,00:00:00.000,2025-04-15 10:00:44.671
true,true,3214,3019,195,0,00:00:00.000,2025-04-15 10:07:44.086
true,false,3820,3582,238,283,00:00:30.000,2025-04-15 10:22:24.002
true,false,3754,3520,234,602,00:00:30.000,2025-04-15 10:20:17.864
true,false,4320,4057,263,253,00:00:31.000,2025-04-15 10:33:50.730
true,false,3956,3710,246,441,00:00:31.000,2025-04-15 10:25:28.188
true,false,4112,3859,253,1598,00:00:33.000,2025-04-15 10:28:52.401
true,false,4179,3924,255,153,00:00:31.000,2025-04-15 10:30:23.495
true,false,4636,4352,284,414,00:00:31.000,2025-04-15 10:41:01.161
true,true,4540,4261,279,0,00:00:00.000,2025-04-15 10:38:53.033
true,false,4673,4387,286,244,00:00:30.000,2025-04-15 10:42:08.228
true,true,4701,4412,289,0,00:00:00.000,2025-04-15 10:42:53.271
true,false,5398,5058,340,1086,00:00:31.000,2025-04-15 10:58:20.213
true,false,2013,1891,122,539,00:00:33.000,2025-04-15 09:40:08.409
true,true,2312,2165,147,0,00:00:00.000,2025-04-15 09:47:00.828
true,true,2251,2110,141,0,00:00:00.000,2025-04-15 09:44:49.702
true,false,2417,2265,152,563,00:00:33.000,2025-04-15 09:49:22.987
true,false,2464,2309,155,2043,00:00:31.000,2025-04-15 09:50:10.029
true,true,2927,2746,181,0,00:00:00.000,2025-04-15 10:01:39.728
true,false,3156,2964,192,1016,00:00:33.000,2025-04-15 10:06:06.989
true,false,3016,2831,185,30,00:00:30.000,2025-04-15 10:03:16.829
true,false,4122,3869,253,131,00:00:33.000,2025-04-15 10:29:08.419
true,true,4694,4405,289,0,00:00:00.000,2025-04-15 10:42:40.257
true,false,4726,4434,292,64,00:00:31.000,2025-04-15 10:43:25.303
true,false,4896,4596,300,790,00:00:30.000,2025-04-15 10:47:27.563
true,false,5363,5027,336,544,00:00:32.000,2025-04-15 10:57:39.180
true,true,2581,2421,160,0,00:00:00.000,2025-04-15 09:53:12.216
true,true,2839,2665,174,0,00:00:00.000,2025-04-15 09:59:25.577
true,false,3174,2982,192,505,00:00:33.000,2025-04-15 10:06:31.010
true,true,3191,2997,194,0,00:00:00.000,2025-04-15 10:06:55.034
true,false,3263,3063,200,254,00:00:31.000,2025-04-15 10:08:54.153
true,false,3363,3158,205,224,00:00:32.000,2025-04-15 10:11:10.293
true,false,3642,3417,225,1742,00:00:32.000,2025-04-15 10:17:49.712
true,true,3690,3462,228,0,00:00:00.000,2025-04-15 10:18:55.777
true,false,3731,3498,233,316,00:00:30.000,2025-04-15 10:19:48.838
true,true,4623,4340,283,0,00:00:00.000,2025-04-15 10:40:47.148
true,false,4483,4208,275,277,00:00:31.000,2025-04-15 10:37:45.967
true,false,4533,4254,279,1852,00:00:33.000,2025-04-15 10:38:36.018
true,false,5404,5064,340,1271,00:00:31.000,2025-04-15 10:58:26.221
true,false,2439,2285,154,1254,00:00:33.000,2025-04-15 09:49:45.005
true,false,2715,2548,167,285,00:00:32.000,2025-04-15 09:56:33.398
true,false,3108,2921,187,432,00:00:32.000,2025-04-15 10:05:12.939
true,false,3294,3092,202,254,00:00:33.000,2025-04-15 10:09:31.190
true,false,3322,3119,203,1131,00:00:31.000,2025-04-15 10:09:59.218
true,false,3619,3397,222,1024,00:00:32.000,2025-04-15 10:17:26.688
true,true,3547,3330,217,0,00:00:00.000,2025-04-15 10:15:47.583
true,false,3697,3467,230,218,00:00:30.000,2025-04-15 10:19:02.787
true,false,3789,3552,237,95,00:00:33.000,2025-04-15 10:21:16.936
true,false,3416,3208,208,33,00:00:33.000,2025-04-15 10:12:27.372
true,false,3932,3686,246,128,00:00:33.000,2025-04-15 10:24:58.159
true,false,4341,4076,265,250,00:00:32.000,2025-04-15 10:34:35.778
true,true,3965,3717,248,0,00:00:00.000,2025-04-15 10:25:44.205
true,false,4159,3904,255,529,00:00:33.000,2025-04-15 10:29:51.460
true,false,4185,3929,256,185,00:00:30.000,2025-04-15 10:30:35.509
true,true,4217,3959,258,0,00:00:00.000,2025-04-15 10:31:31.569
true,false,4230,3971,259,405,00:00:33.000,2025-04-15 10:31:44.585
true,false,4598,4318,280,254,00:00:32.000,2025-04-15 10:39:59.095
false,true,4665,4379,286,0,00:00:00.000,2025-04-15 10:41:57.221
false,false,4681,4395,286,64,00:00:31.000,2025-04-15 10:42:22.240
false,true,4694,4405,289,0,00:00:00.000,2025-04-15 10:42:41.258
false,false,4702,4413,289,31,00:00:31.000,2025-04-15 10:42:55.274
false,true,4724,4432,292,0,00:00:00.000,2025-04-15 10:43:20.298
false,false,4740,4447,293,251,00:00:30.000,2025-04-15 10:43:45.324
false,false,4752,4458,294,631,00:00:33.000,2025-04-15 10:43:57.341
false,false,4753,4459,294,661,00:00:30.000,2025-04-15 10:43:58.341
false,false,4760,4466,294,877,00:00:32.000,2025-04-15 10:44:05.348
false,false,4761,4467,294,909,00:00:32.000,2025-04-15 10:44:06.350
false,true,4776,4482,294,0,00:00:00.000,2025-04-15 10:44:35.385
false,false,4799,4504,295,728,00:00:31.000,2025-04-15 10:45:02.409
false,false,4806,4511,295,947,00:00:32.000,2025-04-15 10:45:09.417
false,true,4825,4530,295,0,00:00:00.000,2025-04-15 10:45:42.443
false,true,4825,4530,295,0,00:00:00.000,2025-04-15 10:45:43.445
false,true,4826,4531,295,0,00:00:00.000,2025-04-15 10:45:52.452
false,true,4837,4541,296,0,00:00:00.000,2025-04-15 10:46:05.468
false,false,4845,4548,297,185,00:00:30.000,2025-04-15 10:46:24.488
false,true,4871,4572,299,0,00:00:00.000,2025-04-15 10:46:57.527
false,true,4871,4572,299,0,00:00:00.000,2025-04-15 10:46:59.529
false,false,4886,4586,300,477,00:00:32.000,2025-04-15 10:47:17.553
false,false,4904,4604,300,1038,00:00:30.000,2025-04-15 10:47:35.573
false,true,4938,4634,304,0,00:00:00.000,2025-04-15 10:48:25.623
false,false,5340,5005,335,186,00:00:31.000,2025-04-15 10:57:10.151
false,false,5348,5013,335,65,00:00:33.000,2025-04-15 10:57:24.163
false,true,5364,5028,336,0,00:00:00.000,2025-04-15 10:57:46.184
false,false,5373,5035,338,288,00:00:32.000,2025-04-15 10:57:55.193
false,false,5382,5044,338,576,00:00:30.000,2025-04-15 10:58:04.201
false,false,5385,5047,338,670,00:00:31.000,2025-04-15 10:58:07.204
false,false,5387,5049,338,735,00:00:33.000,2025-04-15 10:58:09.205
false,false,5395,5056,339,991,00:00:32.000,2025-04-15 10:58:17.211
false,false,5089,4773,316,190,00:00:32.000,2025-04-15 10:51:46.842
false,false,5095,4779,316,378,00:00:33.000,2025-04-15 10:51:52.849
false,true,5110,4792,318,0,00:00:00.000,2025-04-15 10:52:10.863
false,false,5114,4796,318,128,00:00:32.000,2025-04-15 10:52:17.871
false,false,5116,4798,318,30,00:00:30.000,2025-04-15 10:52:25.879
false,true,5116,4798,318,0,00:00:00.000,2025-04-15 10:52:28.880
false,false,5126,4808,318,311,00:00:32.000,2025-04-15 10:52:41.891
false,false,5146,4826,320,943,00:00:32.000,2025-04-15 10:53:01.911
false,false,5147,4827,320,974,00:00:31.000,2025-04-15 10:53:02.911
false,false,5260,4933,327,910,00:00:33.000,2025-04-15 10:55:26.052
false,false,5268,4941,327,126,00:00:32.000,2025-04-15 10:55:40.063
false,false,5280,4951,329,504,00:00:30.000,2025-04-15 10:55:52.077
false,false,5285,4956,329,664,00:00:32.000,2025-04-15 10:55:57.082
false,false,5305,4974,331,64,00:00:32.000,2025-04-15 10:56:29.110
false,false,5310,4977,333,218,00:00:31.000,2025-04-15 10:56:34.116
false,false,4954,4650,304,496,00:00:30.000,2025-04-15 10:48:43.639
false,false,4967,4662,305,160,00:00:33.000,2025-04-15 10:49:08.664
false,false,4990,4683,307,478,00:00:31.000,2025-04-15 10:49:37.697
false,true,4995,4687,308,0,00:00:00.000,2025-04-15 10:49:48.711
false,false,5036,4727,309,688,00:00:30.000,2025-04-15 10:50:41.772
false,false,5046,4734,312,1001,00:00:32.000,2025-04-15 10:50:51.780
false,true,5079,4763,316,0,00:00:00.000,2025-04-15 10:51:27.820
false,false,5170,4849,321,689,00:00:32.000,2025-04-15 10:53:31.938
false,false,5194,4870,324,219,00:00:30.000,2025-04-15 10:54:01.964
false,false,5201,4877,324,440,00:00:33.000,2025-04-15 10:54:08.972
false,false,5205,4881,324,566,00:00:30.000,2025-04-15 10:54:12.978
false,false,5214,4890,324,95,00:00:31.000,2025-04-15 10:54:33.999
false,false,5476,5132,344,90,00:00:30.000,2025-04-15 11:00:14.332
false,true,5488,5144,344,0,00:00:00.000,2025-04-15 11:00:27.346
false,false,5497,5153,344,285,00:00:32.000,2025-04-15 11:00:41.360
false,true,5511,5163,348,0,00:00:00.000,2025-04-15 11:00:59.379
false,false,5515,5167,348,122,00:00:30.000,2025-04-15 11:01:05.387
false,false,5516,5168,348,154,00:00:32.000,2025-04-15 11:01:06.389
false,true,5540,5191,349,0,00:00:00.000,2025-04-15 11:01:40.423
false,false,5542,5193,349,64,00:00:33.000,2025-04-15 11:01:44.426
false,false,5547,5198,349,226,00:00:33.000,2025-04-15 11:01:49.429
false,false,5550,5201,349,319,00:00:31.000,2025-04-15 11:01:52.434
false,false,5562,5212,350,697,00:00:32.000,2025-04-15 11:02:04.446
false,false,5583,5233,350,33,00:00:33.000,2025-04-15 11:02:31.468
false,false,5590,5240,350,255,00:00:31.000,2025-04-15 11:02:38.475
false,true,5595,5245,350,0,00:00:00.000,2025-04-15 11:02:54.492
false,false,5598,5248,350,97,00:00:33.000,2025-04-15 11:03:04.502
false,false,5614,5264,350,346,00:00:31.000,2025-04-15 11:03:26.525
false,true,5701,5345,356,0,00:00:00.000,2025-04-15 11:05:31.660
false,true,5710,5353,357,0,00:00:00.000,2025-04-15 11:05:52.681
false,true,5741,5381,360,0,00:00:00.000,2025-04-15 11:06:43.731
false,false,5623,5273,350,629,00:00:32.000,2025-04-15 11:03:35.537
false,false,5651,5298,353,30,00:00:30.000,2025-04-15 11:04:09.572
false,false,5653,5300,353,90,00:00:30.000,2025-04-15 11:04:11.574
false,false,5655,5302,353,151,00:00:31.000,2025-04-15 11:04:13.576
false,true,5662,5307,355,0,00:00:00.000,2025-04-15 11:04:28.591
false,true,5663,5308,355,0,00:00:00.000,2025-04-15 11:04:38.602
false,false,5669,5313,356,193,00:00:33.000,2025-04-15 11:04:45.610
false,false,5674,5318,356,352,00:00:30.000,2025-04-15 11:04:50.616
false,false,5683,5327,356,636,00:00:33.000,2025-04-15 11:04:59.627
false,true,5685,5329,356,0,00:00:00.000,2025-04-15 11:05:06.635
false,true,5406,5066,340,0,00:00:00.000,2025-04-15 10:58:31.226
false,false,5409,5068,341,95,00:00:32.000,2025-04-15 10:58:37.235
false,false,5413,5072,341,220,00:00:31.000,2025-04-15 10:58:41.241
false,false,5416,5075,341,312,00:00:30.000,2025-04-15 10:58:44.244
false,true,5424,5082,342,0,00:00:00.000,2025-04-15 10:58:55.257
false,false,5431,5088,343,218,00:00:32.000,2025-04-15 10:59:05.267
false,true,5435,5092,343,0,00:00:00.000,2025-04-15 10:59:10.270
false,false,5442,5099,343,220,00:00:33.000,2025-04-15 10:59:22.281
false,false,5449,5105,344,63,00:00:31.000,2025-04-15 10:59:35.293
false,false,5450,5106,344,96,00:00:33.000,2025-04-15 10:59:36.294
false,false,5456,5112,344,286,00:00:33.000,2025-04-15 10:59:42.303
false,false,5464,5120,344,541,00:00:31.000,2025-04-15 10:59:50.310
false,true,5470,5126,344,0,00:00:00.000,2025-04-15 10:59:58.317
false,false,5880,5511,369,689,00:00:30.000,2025-04-15 11:10:10.948
false,true,5882,5513,369,0,00:00:00.000,2025-04-15 11:10:17.954
false,false,5884,5515,369,63,00:00:31.000,2025-04-15 11:10:20.957
false,true,5884,5515,369,0,00:00:00.000,2025-04-15 11:10:24.960
false,false,5902,5532,370,220,00:00:30.000,2025-04-15 11:10:56.991
false,false,5904,5534,370,30,00:00:30.000,2025-04-15 11:11:04.998
false,false,5926,5555,371,658,00:00:30.000,2025-04-15 11:11:33.025
false,true,5935,5563,372,0,00:00:00.000,2025-04-15 11:11:47.037
false,false,5809,5443,366,32,00:00:32.000,2025-04-15 11:08:35.850
false,false,5823,5455,368,127,00:00:30.000,2025-04-15 11:09:01.878
false,false,5831,5463,368,377,00:00:31.000,2025-04-15 11:09:09.886
false,false,5839,5471,368,628,00:00:30.000,2025-04-15 11:09:17.894
false,false,5844,5476,368,63,00:00:33.000,2025-04-15 11:09:28.906
false,true,5858,5489,369,0,00:00:00.000,2025-04-15 11:09:46.923
false,false,5875,5506,369,533,00:00:30.000,2025-04-15 11:10:05.944
false,false,5936,5564,372,31,00:00:31.000,2025-04-15 11:11:49.038
false,true,5937,5565,372,0,00:00:00.000,2025-04-15 11:11:52.043
false,false,5942,5570,372,156,00:00:30.000,2025-04-15 11:12:01.048
false,false,5962,5590,372,788,00:00:30.000,2025-04-15 11:12:21.067
false,false,5991,5615,376,722,00:00:32.000,2025-04-15 11:12:56.104
false,true,5996,5620,376,0,00:00:00.000,2025-04-15 11:13:06.117
false,false,5997,5621,376,31,00:00:31.000,2025-04-15 11:13:08.117
false,false,5999,5623,376,60,00:00:30.000,2025-04-15 11:13:16.126
false,true,5761,5400,361,0,00:00:00.000,2025-04-15 11:07:10.758
false,false,5762,5401,361,30,00:00:30.000,2025-04-15 11:07:12.759
false,false,5784,5420,364,314,00:00:33.000,2025-04-15 11:07:52.804
false,false,5786,5422,364,375,00:00:30.000,2025-04-15 11:07:54.806
false,false,5793,5428,365,595,00:00:30.000,2025-04-15 11:08:01.813
false,true,5795,5430,365,0,00:00:00.000,2025-04-15 11:08:06.817
false,true,5795,5430,365,0,00:00:00.000,2025-04-15 11:08:08.819
false,true,6006,5630,376,0,00:00:00.000,2025-04-15 11:13:34.141
false,false,6013,5637,376,161,00:00:32.000,2025-04-15 11:13:48.158
false,false,6015,5638,377,225,00:00:33.000,2025-04-15 11:13:50.160
false,false,6025,5647,378,539,00:00:32.000,2025-04-15 11:14:00.169
false,true,6034,5656,378,0,00:00:00.000,2025-04-15 11:14:11.181
false,false,6038,5660,378,97,00:00:33.000,2025-04-15 11:14:25.194
false,false,6044,5666,378,92,00:00:30.000,2025-04-15 11:14:37.203
false,false,6228,5841,387,159,00:00:32.000,2025-04-15 11:18:29.442
false,true,6232,5845,387,0,00:00:00.000,2025-04-15 11:18:36.451
false,true,6232,5845,387,0,00:00:00.000,2025-04-15 11:18:38.453
false,false,6269,5882,387,283,00:00:32.000,2025-04-15 11:19:22.501
false,false,6292,5904,388,379,00:00:31.000,2025-04-15 11:19:57.539
false,true,6078,5699,379,0,00:00:00.000,2025-04-15 11:15:24.256
false,true,6078,5699,379,0,00:00:00.000,2025-04-15 11:15:25.256
false,true,6111,5732,379,0,00:00:00.000,2025-04-15 11:16:11.307
false,false,6120,5741,379,292,00:00:33.000,2025-04-15 11:16:23.319
false,false,6125,5745,380,447,00:00:30.000,2025-04-15 11:16:28.323
false,false,6166,5784,382,1740,00:00:30.000,2025-04-15 11:17:09.363
false,false,6175,5792,383,2018,00:00:31.000,2025-04-15 11:17:18.370
false,false,6205,5820,385,284,00:00:33.000,2025-04-15 11:18:00.413
false,true,6223,5836,387,0,00:00:00.000,2025-04-15 11:18:19.433
false,true,6223,5836,387,0,00:00:00.000,2025-04-15 11:18:23.439
false,false,6297,5909,388,157,00:00:32.000,2025-04-15 11:20:08.548
false,true,6299,5911,388,0,00:00:00.000,2025-04-15 11:20:11.549
false,false,6352,5961,391,528,00:00:31.000,2025-04-15 11:21:21.620
false,false,6369,5978,391,1063,00:00:30.000,2025-04-15 11:21:38.636
false,true,6594,6189,405,0,00:00:00.000,2025-04-15 11:27:21.999
false,false,6607,6201,406,250,00:00:31.000,2025-04-15 11:27:43.017
false,false,6609,6203,406,311,00:00:30.000,2025-04-15 11:27:45.019
false,false,6527,6128,399,921,00:00:33.000,2025-04-15 11:25:46.906
false,false,6528,6129,399,952,00:00:31.000,2025-04-15 11:25:47.907
false,false,6529,6130,399,982,00:00:30.000,2025-04-15 11:25:48.909
false,false,6544,6142,402,1460,00:00:30.000,2025-04-15 11:26:03.919
false,false,6547,6144,403,1552,00:00:32.000,2025-04-15 11:26:06.923
false,false,6565,6161,404,435,00:00:30.000,2025-04-15 11:26:30.951
false,false,6374,5983,391,33,00:00:33.000,2025-04-15 11:21:49.644
false,true,6380,5989,391,0,00:00:00.000,2025-04-15 11:21:58.653
false,true,6399,6007,392,0,00:00:00.000,2025-04-15 11:22:33.694
false,true,6415,6022,393,0,00:00:00.000,2025-04-15 11:22:55.721
false,true,6428,6035,393,0,00:00:00.000,2025-04-15 11:23:31.758
false,true,6428,6035,393,0,00:00:00.000,2025-04-15 11:23:37.766
false,false,6456,6062,394,283,00:00:30.000,2025-04-15 11:24:17.810
false,true,6463,6068,395,0,00:00:00.000,2025-04-15 11:24:25.821
false,false,6477,6081,396,284,00:00:30.000,2025-04-15 11:24:50.843
false,false,6478,6081,397,315,00:00:31.000,2025-04-15 11:24:51.845
false,false,6488,6090,398,633,00:00:31.000,2025-04-15 11:25:01.854
false,false,6636,6228,408,95,00:00:30.000,2025-04-15 11:28:36.065
false,false,6641,6232,409,252,00:00:33.000,2025-04-15 11:28:41.072
false,true,6659,6248,411,0,00:00:00.000,2025-04-15 11:29:01.091
false,true,6659,6248,411,0,00:00:00.000,2025-04-15 11:29:04.094
false,true,6668,6256,412,0,00:00:00.000,2025-04-15 11:29:32.120
false,false,6670,6258,412,66,00:00:33.000,2025-04-15 11:29:34.121
false,true,6672,6260,412,0,00:00:00.000,2025-04-15 11:29:42.133
false,false,6689,6275,414,536,00:00:33.000,2025-04-15 11:29:59.150
false,false,6691,6277,414,600,00:00:32.000,2025-04-15 11:30:01.152
false,true,6692,6278,414,0,00:00:00.000,2025-04-15 11:30:08.159
false,true,6838,6419,419,0,00:00:00.000,2025-04-15 11:33:32.356
false,true,6838,6419,419,0,00:00:00.000,2025-04-15 11:33:39.364
false,true,6851,6431,420,0,00:00:00.000,2025-04-15 11:34:00.384
false,true,6855,6435,420,0,00:00:00.000,2025-04-15 11:34:12.398
false,true,6855,6435,420,0,00:00:00.000,2025-04-15 11:34:15.401
false,false,6870,6449,421,473,00:00:32.000,2025-04-15 11:34:30.421
false,true,6696,6282,414,0,00:00:00.000,2025-04-15 11:30:16.164
false,false,6711,6296,415,467,00:00:31.000,2025-04-15 11:30:33.182
false,false,6735,6320,415,1230,00:00:32.000,2025-04-15 11:30:57.201
false,false,6753,6338,415,1801,00:00:32.000,2025-04-15 11:31:15.222
false,false,6771,6354,417,2369,00:00:30.000,2025-04-15 11:31:33.238
false,true,6903,6481,422,0,00:00:00.000,2025-04-15 11:35:28.480
false,true,6903,6481,422,0,00:00:00.000,2025-04-15 11:35:32.485
false,false,6913,6491,422,311,00:00:31.000,2025-04-15 11:35:43.498
false,false,6934,6512,422,982,00:00:32.000,2025-04-15 11:36:04.520
false,false,6939,6517,422,1140,00:00:32.000,2025-04-15 11:36:09.525
false,false,6941,6519,422,1205,00:00:33.000,2025-04-15 11:36:11.526
false,false,6962,6536,426,63,00:00:30.000,2025-04-15 11:36:38.552
false,false,7066,6635,431,569,00:00:33.000,2025-04-15 11:38:52.685
false,false,7067,6636,431,602,00:00:33.000,2025-04-15 11:38:53.686
false,false,7094,6662,432,599,00:00:31.000,2025-04-15 11:39:26.725
false,false,7096,6664,432,663,00:00:33.000,2025-04-15 11:39:28.730
false,false,7116,6684,432,1296,00:00:30.000,2025-04-15 11:39:48.755
false,false,7134,6701,433,1863,00:00:30.000,2025-04-15 11:40:06.775
false,false,6793,6374,419,217,00:00:31.000,2025-04-15 11:32:01.262
false,false,6794,6375,419,249,00:00:32.000,2025-04-15 11:32:02.263
false,false,6800,6381,419,437,00:00:32.000,2025-04-15 11:32:08.269
false,true,6801,6382,419,0,00:00:00.000,2025-04-15 11:32:12.272
false,true,6801,6382,419,0,00:00:00.000,2025-04-15 11:32:15.273
false,true,6802,6383,419,0,00:00:00.000,2025-04-15 11:32:19.277
false,true,6802,6383,419,0,00:00:00.000,2025-04-15 11:32:22.282
false,false,6806,6387,419,122,00:00:31.000,2025-04-15 11:32:26.284
false,false,6808,6389,419,184,00:00:30.000,2025-04-15 11:32:28.285
false,false,6827,6408,419,220,00:00:31.000,2025-04-15 11:33:11.338
false,false,6833,6414,419,410,00:00:32.000,2025-04-15 11:33:17.342
false,true,6833,6414,419,0,00:00:00.000,2025-04-15 11:33:21.346
false,false,7000,6573,427,254,00:00:32.000,2025-04-15 11:37:40.614
false,false,7001,6574,427,285,00:00:31.000,2025-04-15 11:37:41.615
false,false,7011,6584,427,604,00:00:32.000,2025-04-15 11:37:51.624
false,false,7023,6595,428,982,00:00:32.000,2025-04-15 11:38:03.638
false,false,7035,6605,430,1360,00:00:30.000,2025-04-15 11:38:15.651
false,false,7039,6609,430,1485,00:00:32.000,2025-04-15 11:38:19.654
false,false,7042,6612,430,1578,00:00:32.000,2025-04-15 11:38:22.658
false,false,7141,6706,435,2084,00:00:33.000,2025-04-15 11:40:13.783
false,false,7142,6707,435,2114,00:00:30.000,2025-04-15 11:40:14.784
false,true,7145,6710,435,0,00:00:00.000,2025-04-15 11:40:18.787
false,true,7145,6710,435,0,00:00:00.000,2025-04-15 11:40:21.788
false,false,7149,6713,436,126,00:00:31.000,2025-04-15 11:40:27.797
false,false,7168,6729,439,63,00:00:30.000,2025-04-15 11:40:52.824
false,true,7171,6731,440,0,00:00:00.000,2025-04-15 11:40:56.830
false,false,7186,6745,441,474,00:00:31.000,2025-04-15 11:41:16.851
false,true,7202,6760,442,0,00:00:00.000,2025-04-15 11:41:33.870
false,false,7360,6907,453,157,00:00:30.000,2025-04-15 11:45:23.112
false,false,7365,6912,453,318,00:00:33.000,2025-04-15 11:45:28.117
false,false,7404,6946,458,786,00:00:33.000,2025-04-15 11:46:13.160
false,true,7406,6948,458,0,00:00:00.000,2025-04-15 11:46:32.183
false,true,7417,6958,459,0,00:00:00.000,2025-04-15 11:46:45.196
false,true,7242,6795,447,0,00:00:00.000,2025-04-15 11:42:40.943
false,false,7245,6798,447,93,00:00:30.000,2025-04-15 11:42:45.947
false,false,7418,6959,459,31,00:00:31.000,2025-04-15 11:46:51.202
false,false,7419,6960,459,64,00:00:33.000,2025-04-15 11:46:52.203
false,false,7420,6961,459,97,00:00:33.000,2025-04-15 11:46:53.204
false,false,7447,6987,460,155,00:00:30.000,2025-04-15 11:47:32.247
false,false,7453,6993,460,350,00:00:32.000,2025-04-15 11:47:38.255
false,false,7454,6994,460,382,00:00:32.000,2025-04-15 11:47:39.256
false,true,7466,7006,460,0,00:00:00.000,2025-04-15 11:48:03.286
false,false,7479,7017,462,404,00:00:33.000,2025-04-15 11:48:16.298
false,true,7489,7026,463,0,00:00:00.000,2025-04-15 11:48:28.313
false,false,7497,7034,463,63,00:00:30.000,2025-04-15 11:48:46.338
false,false,7530,7065,465,65,00:00:32.000,2025-04-15 11:49:25.372
false,false,7281,6833,448,32,00:00:32.000,2025-04-15 11:43:46.010
false,false,7288,6840,448,248,00:00:31.000,2025-04-15 11:43:53.016
false,false,7293,6844,449,406,00:00:33.000,2025-04-15 11:43:58.019
false,false,7294,6845,449,436,00:00:30.000,2025-04-15 11:43:59.019
false,false,7300,6851,449,626,00:00:31.000,2025-04-15 11:44:05.025
false,false,7335,6886,449,189,00:00:31.000,2025-04-15 11:44:52.079
false,true,7570,7104,466,0,00:00:00.000,2025-04-15 11:50:25.432
false,true,7570,7104,466,0,00:00:00.000,2025-04-15 11:50:26.432
false,false,7577,7111,466,221,00:00:31.000,2025-04-15 11:50:36.441
false,true,7580,7114,466,0,00:00:00.000,2025-04-15 11:50:44.446
false,false,7608,7141,467,879,00:00:32.000,2025-04-15 11:51:13.470
false,false,7613,7146,467,1035,00:00:33.000,2025-04-15 11:51:18.476
false,false,7626,7159,467,1442,00:00:30.000,2025-04-15 11:51:31.489
false,false,7629,7162,467,1536,00:00:31.000,2025-04-15 11:51:34.493
false,false,7722,7254,468,187,00:00:33.000,2025-04-15 11:53:37.627
false,false,7749,7280,469,1036,00:00:31.000,2025-04-15 11:54:04.663
false,true,7763,7293,470,0,00:00:00.000,2025-04-15 11:54:20.681
false,true,7763,7293,470,0,00:00:00.000,2025-04-15 11:54:23.683
false,false,7768,7298,470,162,00:00:32.000,2025-04-15 11:54:35.698
false,false,7647,7180,467,2100,00:00:30.000,2025-04-15 11:51:52.510
false,false,7661,7194,467,2548,00:00:33.000,2025-04-15 11:52:06.526
false,true,7666,7199,467,0,00:00:00.000,2025-04-15 11:52:15.536
false,false,7683,7215,468,536,00:00:30.000,2025-04-15 11:52:34.560
false,false,7685,7217,468,65,00:00:33.000,2025-04-15 11:52:42.567
false,false,7798,7328,470,284,00:00:31.000,2025-04-15 11:55:23.748
false,true,7811,7341,470,0,00:00:00.000,2025-04-15 11:55:43.773
false,true,7823,7350,473,0,00:00:00.000,2025-04-15 11:56:12.801
false,true,7828,7355,473,0,00:00:00.000,2025-04-15 11:56:25.816
false,true,7829,7356,473,0,00:00:00.000,2025-04-15 11:56:33.823
false,true,7829,7356,473,0,00:00:00.000,2025-04-15 11:56:34.825
false,false,7840,7367,473,351,00:00:33.000,2025-04-15 11:56:47.838
false,false,7842,7369,473,414,00:00:33.000,2025-04-15 11:56:49.841
false,false,7856,7383,473,369,00:00:30.000,2025-04-15 11:57:09.860
false,false,7862,7388,474,558,00:00:33.000,2025-04-15 11:57:15.867
false,false,7905,7431,474,1111,00:00:32.000,2025-04-15 11:58:10.937
false,false,8006,7528,478,405,00:00:32.000,2025-04-15 12:00:22.067
false,false,8028,7549,479,344,00:00:32.000,2025-04-15 12:00:56.100
false,false,5253,4926,327,692,00:00:31.000,2025-04-15 10:55:19.043
false,true,5264,4937,327,0,00:00:00.000,2025-04-15 10:55:34.056
false,false,5279,4950,329,474,00:00:31.000,2025-04-15 10:55:51.074
false,true,5298,4968,330,0,00:00:00.000,2025-04-15 10:56:14.098
false,false,5303,4972,331,154,00:00:32.000,2025-04-15 10:56:21.102
false,true,5303,4972,331,0,00:00:00.000,2025-04-15 10:56:27.109
false,false,5309,4976,333,187,00:00:30.000,2025-04-15 10:56:33.115
false,false,5321,4986,335,570,00:00:32.000,2025-04-15 10:56:45.124
false,true,4938,4634,304,0,00:00:00.000,2025-04-15 10:48:27.626
false,true,4995,4687,308,0,00:00:00.000,2025-04-15 10:49:43.705
false,true,5010,4701,309,0,00:00:00.000,2025-04-15 10:50:04.731
false,true,5010,4701,309,0,00:00:00.000,2025-04-15 10:50:09.737
false,false,5014,4705,309,126,00:00:33.000,2025-04-15 10:50:13.744
false,true,5014,4705,309,0,00:00:00.000,2025-04-15 10:50:19.749
false,false,5044,4732,312,937,00:00:33.000,2025-04-15 10:50:49.779
false,false,5069,4755,314,1723,00:00:32.000,2025-04-15 10:51:14.809
false,true,5083,4767,316,0,00:00:00.000,2025-04-15 10:51:35.829
false,false,5165,4844,321,535,00:00:31.000,2025-04-15 10:53:26.934
false,true,5187,4864,323,0,00:00:00.000,2025-04-15 10:53:49.956
false,true,5206,4882,324,0,00:00:00.000,2025-04-15 10:54:17.983
false,false,5236,4910,326,160,00:00:31.000,2025-04-15 10:55:02.024
false,false,5506,5159,347,570,00:00:31.000,2025-04-15 11:00:50.370
false,false,5521,5173,348,159,00:00:31.000,2025-04-15 11:01:17.399
false,false,5526,5178,348,316,00:00:31.000,2025-04-15 11:01:22.404
false,false,5528,5180,348,378,00:00:30.000,2025-04-15 11:01:24.406
false,false,5534,5185,349,573,00:00:32.000,2025-04-15 11:01:30.413
false,false,5577,5227,350,1166,00:00:33.000,2025-04-15 11:02:19.460
false,true,5590,5240,350,0,00:00:00.000,2025-04-15 11:02:44.481
false,false,5594,5244,350,127,00:00:32.000,2025-04-15 11:02:48.485
false,true,5687,5331,356,0,00:00:00.000,2025-04-15 11:05:13.643
false,true,5701,5345,356,0,00:00:00.000,2025-04-15 11:05:32.661
false,false,5703,5347,356,61,00:00:30.000,2025-04-15 11:05:43.671
false,false,5704,5348,356,93,00:00:32.000,2025-04-15 11:05:44.673
false,true,5710,5353,357,0,00:00:00.000,2025-04-15 11:05:53.682
false,true,5712,5355,357,0,00:00:00.000,2025-04-15 11:06:01.692
false,false,5713,5356,357,33,00:00:33.000,2025-04-15 11:06:05.694
false,false,5716,5359,357,127,00:00:33.000,2025-04-15 11:06:08.696
false,false,5736,5376,360,755,00:00:30.000,2025-04-15 11:06:28.717
false,false,5740,5380,360,885,00:00:33.000,2025-04-15 11:06:32.720
false,true,5741,5381,360,0,00:00:00.000,2025-04-15 11:06:34.722
false,false,5620,5270,350,534,00:00:30.000,2025-04-15 11:03:32.535
false,false,5625,5275,350,691,00:00:32.000,2025-04-15 11:03:37.538
false,true,5650,5297,353,0,00:00:00.000,2025-04-15 11:04:05.567
false,true,5650,5297,353,0,00:00:00.000,2025-04-15 11:04:06.569
false,true,5650,5297,353,0,00:00:00.000,2025-04-15 11:04:07.569
false,false,5652,5299,353,60,00:00:30.000,2025-04-15 11:04:10.572
false,true,5662,5307,355,0,00:00:00.000,2025-04-15 11:04:32.593
false,false,5419,5077,342,407,00:00:31.000,2025-04-15 10:58:47.246
false,false,5423,5081,342,532,00:00:32.000,2025-04-15 10:58:51.253
false,true,5424,5082,342,0,00:00:00.000,2025-04-15 10:58:57.259
false,true,5447,5104,343,0,00:00:00.000,2025-04-15 10:59:28.287
false,true,5447,5104,343,0,00:00:00.000,2025-04-15 10:59:30.288
false,true,5447,5104,343,0,00:00:00.000,2025-04-15 10:59:31.289
false,false,5878,5509,369,626,00:00:31.000,2025-04-15 11:10:08.946
false,false,5883,5514,369,32,00:00:32.000,2025-04-15 11:10:19.957
false,true,5884,5515,369,0,00:00:00.000,2025-04-15 11:10:22.958
false,true,5888,5518,370,0,00:00:00.000,2025-04-15 11:10:33.968
false,false,5924,5553,371,598,00:00:33.000,2025-04-15 11:11:31.023
false,false,5925,5554,371,628,00:00:30.000,2025-04-15 11:11:32.024
false,true,5808,5442,366,0,00:00:00.000,2025-04-15 11:08:34.850
false,true,5819,5452,367,0,00:00:00.000,2025-04-15 11:08:56.874
false,true,5819,5452,367,0,00:00:00.000,2025-04-15 11:08:57.874
false,false,5837,5469,368,567,00:00:33.000,2025-04-15 11:09:15.893
false,false,5841,5473,368,689,00:00:31.000,2025-04-15 11:09:19.895
false,false,5847,5479,368,158,00:00:32.000,2025-04-15 11:09:31.910
false,true,5935,5563,372,0,00:00:00.000,2025-04-15 11:11:48.037
false,true,5937,5565,372,0,00:00:00.000,2025-04-15 11:11:56.046
false,false,5950,5578,372,407,00:00:32.000,2025-04-15 11:12:09.053
false,false,5982,5606,376,437,00:00:32.000,2025-04-15 11:12:47.095
false,false,5984,5608,376,500,00:00:32.000,2025-04-15 11:12:49.098
false,false,5989,5613,376,659,00:00:31.000,2025-04-15 11:12:54.103
false,true,5996,5620,376,0,00:00:00.000,2025-04-15 11:13:03.111
false,false,6001,5625,376,124,00:00:31.000,2025-04-15 11:13:18.127
false,true,6004,5628,376,0,00:00:00.000,2025-04-15 11:13:24.133
false,true,5764,5402,362,0,00:00:00.000,2025-04-15 11:07:26.778
false,true,5774,5411,363,0,00:00:00.000,2025-04-15 11:07:37.787
false,false,5796,5431,365,31,00:00:31.000,2025-04-15 11:08:10.821
false,false,5799,5433,366,128,00:00:33.000,2025-04-15 11:08:13.825
false,true,5807,5441,366,0,00:00:00.000,2025-04-15 11:08:23.837
false,false,6006,5630,376,61,00:00:30.000,2025-04-15 11:13:29.137
false,true,6008,5632,376,0,00:00:00.000,2025-04-15 11:13:41.148
false,false,6011,5635,376,97,00:00:32.000,2025-04-15 11:13:46.155
false,false,6018,5640,378,321,00:00:30.000,2025-04-15 11:13:53.164
false,false,6023,5645,378,475,00:00:30.000,2025-04-15 11:13:58.168
false,false,6024,5646,378,507,00:00:32.000,2025-04-15 11:13:59.168
false,false,6033,5655,378,790,00:00:30.000,2025-04-15 11:14:08.177
false,true,6034,5656,378,0,00:00:00.000,2025-04-15 11:14:15.184
false,true,6035,5657,378,0,00:00:00.000,2025-04-15 11:14:18.189
false,false,6046,5668,378,155,00:00:30.000,2025-04-15 11:14:39.205
false,false,6051,5673,378,313,00:00:30.000,2025-04-15 11:14:44.213
false,false,6258,5871,387,815,00:00:33.000,2025-04-15 11:19:05.486
false,true,6260,5873,387,0,00:00:00.000,2025-04-15 11:19:11.491
false,false,6263,5876,387,93,00:00:30.000,2025-04-15 11:19:16.493
false,false,6287,5900,387,221,00:00:31.000,2025-04-15 11:19:52.534
false,true,6077,5698,379,0,00:00:00.000,2025-04-15 11:15:18.248
false,false,6127,5747,380,510,00:00:30.000,2025-04-15 11:16:30.324
false,false,6152,5771,381,1299,00:00:32.000,2025-04-15 11:16:55.347
false,false,6156,5775,381,1425,00:00:32.000,2025-04-15 11:16:59.351
false,false,6165,5784,381,1710,00:00:31.000,2025-04-15 11:17:08.363
false,false,6185,5801,384,2335,00:00:31.000,2025-04-15 11:17:28.380
false,false,6208,5823,385,380,00:00:31.000,2025-04-15 11:18:03.418
false,false,6299,5911,388,218,00:00:30.000,2025-04-15 11:20:10.549
false,true,6299,5911,388,0,00:00:00.000,2025-04-15 11:20:12.551
false,false,6328,5939,389,844,00:00:32.000,2025-04-15 11:20:51.589
false,false,6334,5944,390,1036,00:00:33.000,2025-04-15 11:20:57.600
false,false,6342,5952,390,220,00:00:33.000,2025-04-15 11:21:11.611
false,false,6344,5953,391,280,00:00:30.000,2025-04-15 11:21:13.614
false,false,6350,5959,391,467,00:00:30.000,2025-04-15 11:21:19.619
false,false,6355,5964,391,624,00:00:32.000,2025-04-15 11:21:24.622
false,false,6578,6174,404,315,00:00:33.000,2025-04-15 11:26:49.969
false,true,6588,6183,405,0,00:00:00.000,2025-04-15 11:27:10.989
false,true,6594,6189,405,0,00:00:00.000,2025-04-15 11:27:23.001
false,true,6594,6189,405,0,00:00:00.000,2025-04-15 11:27:24.002
false,false,6617,6211,406,190,00:00:32.000,2025-04-15 11:27:59.033
false,false,6627,6220,407,314,00:00:31.000,2025-04-15 11:28:15.049
false,false,6501,6103,398,98,00:00:33.000,2025-04-15 11:25:20.877
false,false,6518,6119,399,640,00:00:32.000,2025-04-15 11:25:37.894
false,false,6524,6125,399,826,00:00:30.000,2025-04-15 11:25:43.902
false,false,6532,6133,399,1079,00:00:33.000,2025-04-15 11:25:51.911
false,false,6538,6138,400,1267,00:00:33.000,2025-04-15 11:25:57.915
false,false,6545,6143,402,1490,00:00:30.000,2025-04-15 11:26:04.919
false,false,6560,6157,403,280,00:00:30.000,2025-04-15 11:26:25.949
false,true,6568,6164,404,0,00:00:00.000,2025-04-15 11:26:37.954
false,false,6575,6171,404,218,00:00:31.000,2025-04-15 11:26:46.966
false,false,6389,5998,391,291,00:00:33.000,2025-04-15 11:22:10.665
false,true,6391,6000,391,0,00:00:00.000,2025-04-15 11:22:17.674
false,true,6394,6003,391,0,00:00:00.000,2025-04-15 11:22:25.685
false,true,6399,6007,392,0,00:00:00.000,2025-04-15 11:22:34.695
false,true,6416,6023,393,0,00:00:00.000,2025-04-15 11:23:02.727
false,true,6416,6023,393,0,00:00:00.000,2025-04-15 11:23:06.731
false,false,6419,6026,393,92,00:00:30.000,2025-04-15 11:23:10.733
false,true,6429,6036,393,0,00:00:00.000,2025-04-15 11:23:42.771
false,false,6437,6043,394,252,00:00:33.000,2025-04-15 11:23:52.783
false,false,6480,6083,397,378,00:00:30.000,2025-04-15 11:24:53.847
false,false,6639,6230,409,188,00:00:32.000,2025-04-15 11:28:39.069
false,false,6646,6237,409,409,00:00:33.000,2025-04-15 11:28:46.075
false,true,6667,6255,412,0,00:00:00.000,2025-04-15 11:29:21.114
false,true,6667,6255,412,0,00:00:00.000,2025-04-15 11:29:23.115
false,false,6680,6267,413,256,00:00:33.000,2025-04-15 11:29:50.140
false,true,6838,6419,419,0,00:00:00.000,2025-04-15 11:33:30.354
false,false,6841,6422,419,93,00:00:30.000,2025-04-15 11:33:43.369
false,false,6850,6430,420,248,00:00:30.000,2025-04-15 11:33:58.383
false,false,6856,6436,420,31,00:00:31.000,2025-04-15 11:34:16.403
false,false,6864,6444,420,283,00:00:31.000,2025-04-15 11:34:24.412
false,false,6868,6447,421,411,00:00:33.000,2025-04-15 11:34:28.418
false,false,6882,6460,422,861,00:00:33.000,2025-04-15 11:34:42.434
false,true,6882,6460,422,0,00:00:00.000,2025-04-15 11:34:45.437
false,false,6886,6464,422,129,00:00:33.000,2025-04-15 11:34:58.449
false,false,6891,6469,422,287,00:00:31.000,2025-04-15 11:35:03.453
false,false,6694,6280,414,63,00:00:30.000,2025-04-15 11:30:10.161
false,true,6696,6282,414,0,00:00:00.000,2025-04-15 11:30:15.163
false,false,6699,6285,414,96,00:00:31.000,2025-04-15 11:30:21.168
false,false,6714,6299,415,565,00:00:32.000,2025-04-15 11:30:36.183
false,false,6729,6314,415,1039,00:00:33.000,2025-04-15 11:30:51.193
false,false,6744,6329,415,1514,00:00:33.000,2025-04-15 11:31:06.211
false,true,6891,6469,422,0,00:00:00.000,2025-04-15 11:35:09.460
false,false,6896,6474,422,94,00:00:32.000,2025-04-15 11:35:20.472
false,false,6898,6476,422,155,00:00:30.000,2025-04-15 11:35:22.473
false,false,6907,6485,422,127,00:00:30.000,2025-04-15 11:35:37.490
false,false,6921,6499,422,567,00:00:32.000,2025-04-15 11:35:51.506
false,false,6936,6514,422,1044,00:00:31.000,2025-04-15 11:36:06.521
false,false,6950,6527,423,1485,00:00:31.000,2025-04-15 11:36:20.533
false,false,6954,6529,425,1614,00:00:33.000,2025-04-15 11:36:24.538
false,true,6964,6538,426,0,00:00:00.000,2025-04-15 11:36:43.557
false,false,7075,6644,431,856,00:00:32.000,2025-04-15 11:39:01.696
false,false,7105,6673,432,945,00:00:33.000,2025-04-15 11:39:37.741
false,false,7113,6681,432,1203,00:00:33.000,2025-04-15 11:39:45.752
false,false,7120,6688,432,1422,00:00:31.000,2025-04-15 11:39:52.759
false,true,6801,6382,419,0,00:00:00.000,2025-04-15 11:32:11.270
false,true,6808,6389,419,0,00:00:00.000,2025-04-15 11:32:40.299
false,false,6811,6392,419,95,00:00:31.000,2025-04-15 11:32:43.302
false,true,6820,6401,419,0,00:00:00.000,2025-04-15 11:33:04.327
false,false,6823,6404,419,94,00:00:30.000,2025-04-15 11:33:07.332
false,false,6828,6409,419,250,00:00:30.000,2025-04-15 11:33:12.338
false,false,6838,6419,419,161,00:00:30.000,2025-04-15 11:33:28.352
false,false,6977,6551,426,286,00:00:31.000,2025-04-15 11:37:11.587
false,false,6982,6556,426,442,00:00:30.000,2025-04-15 11:37:16.592
false,false,6986,6560,426,568,00:00:30.000,2025-04-15 11:37:20.593
false,false,7038,6608,430,1453,00:00:31.000,2025-04-15 11:38:18.653
false,false,7043,6613,430,1610,00:00:32.000,2025-04-15 11:38:23.659
false,false,7137,6702,435,1957,00:00:33.000,2025-04-15 11:40:09.778
false,true,7145,6710,435,0,00:00:00.000,2025-04-15 11:40:20.788
false,true,7166,6727,439,0,00:00:00.000,2025-04-15 11:40:45.819
false,true,7171,6731,440,0,00:00:00.000,2025-04-15 11:40:58.832
false,false,7187,6746,441,507,00:00:33.000,2025-04-15 11:41:17.852
false,false,7207,6764,443,156,00:00:33.000,2025-04-15 11:41:43.880
false,false,7367,6913,454,382,00:00:31.000,2025-04-15 11:45:30.119
false,false,7372,6917,455,539,00:00:31.000,2025-04-15 11:45:35.122
false,true,7404,6946,458,0,00:00:00.000,2025-04-15 11:46:16.163
false,true,7417,6958,459,0,00:00:00.000,2025-04-15 11:46:46.198
false,true,7216,6771,445,0,00:00:00.000,2025-04-15 11:42:00.900
false,false,7226,6781,445,220,00:00:32.000,2025-04-15 11:42:20.922
false,false,7272,6824,448,565,00:00:32.000,2025-04-15 11:43:18.982
false,true,7442,6982,460,0,00:00:00.000,2025-04-15 11:47:24.240
false,true,7442,6982,460,0,00:00:00.000,2025-04-15 11:47:26.241
false,false,7457,6997,460,476,00:00:30.000,2025-04-15 11:47:42.261
false,false,7480,7018,462,436,00:00:32.000,2025-04-15 11:48:17.300
false,false,7483,7020,463,531,00:00:31.000,2025-04-15 11:48:20.305
false,false,7492,7029,463,97,00:00:32.000,2025-04-15 11:48:35.320
false,false,7496,7033,463,33,00:00:33.000,2025-04-15 11:48:45.335
false,false,7508,7044,464,409,00:00:30.000,2025-04-15 11:48:57.348
false,true,7545,7080,465,0,00:00:00.000,2025-04-15 11:49:51.400
false,false,7549,7083,466,125,00:00:32.000,2025-04-15 11:49:56.405
false,false,7285,6837,448,154,00:00:30.000,2025-04-15 11:43:50.015
false,true,7317,6868,449,0,00:00:00.000,2025-04-15 11:44:27.051
false,false,7325,6876,449,249,00:00:31.000,2025-04-15 11:44:36.061
false,false,7344,6894,450,475,00:00:32.000,2025-04-15 11:45:01.091
false,false,7560,7094,466,31,00:00:31.000,2025-04-15 11:50:13.420
false,true,7570,7104,466,0,00:00:00.000,2025-04-15 11:50:27.432
false,false,7584,7118,466,127,00:00:31.000,2025-04-15 11:50:49.451
false,false,7593,7126,467,409,00:00:30.000,2025-04-15 11:50:58.457
false,false,7600,7133,467,631,00:00:32.000,2025-04-15 11:51:05.463
false,false,7603,7136,467,724,00:00:30.000,2025-04-15 11:51:08.465
false,false,7604,7137,467,755,00:00:31.000,2025-04-15 11:51:09.466
false,false,7617,7150,467,1163,00:00:33.000,2025-04-15 11:51:22.480
false,false,7618,7151,467,1193,00:00:30.000,2025-04-15 11:51:23.481
false,false,7755,7285,470,1228,00:00:30.000,2025-04-15 11:54:10.669
false,true,7769,7299,470,0,00:00:00.000,2025-04-15 11:54:40.704
false,true,7769,7299,470,0,00:00:00.000,2025-04-15 11:54:41.705
false,false,7771,7301,470,64,00:00:33.000,2025-04-15 11:54:44.707
false,true,7774,7304,470,0,00:00:00.000,2025-04-15 11:54:51.713
false,false,7789,7319,470,466,00:00:31.000,2025-04-15 11:55:08.731
false,false,7667,7200,467,33,00:00:33.000,2025-04-15 11:52:18.540
false,false,7670,7202,468,130,00:00:31.000,2025-04-15 11:52:21.544
false,false,7674,7206,468,257,00:00:31.000,2025-04-15 11:52:25.548
false,false,7677,7209,468,351,00:00:31.000,2025-04-15 11:52:28.553
false,false,7690,7222,468,227,00:00:32.000,2025-04-15 11:52:47.574
false,true,7700,7232,468,0,00:00:00.000,2025-04-15 11:53:06.596
false,false,7706,7238,468,195,00:00:33.000,2025-04-15 11:53:15.604
false,false,7710,7242,468,324,00:00:31.000,2025-04-15 11:53:19.607
false,false,7711,7243,468,354,00:00:30.000,2025-04-15 11:53:20.608
false,true,7716,7248,468,0,00:00:00.000,2025-04-15 11:53:27.617
false,true,7789,7319,470,0,00:00:00.000,2025-04-15 11:55:10.733
false,false,7806,7336,470,158,00:00:32.000,2025-04-15 11:55:37.763
false,true,7817,7347,470,0,00:00:00.000,2025-04-15 11:55:55.783
false,true,7824,7351,473,0,00:00:00.000,2025-04-15 11:56:14.804
false,true,7824,7351,473,0,00:00:00.000,2025-04-15 11:56:15.804
false,true,7824,7351,473,0,00:00:00.000,2025-04-15 11:56:19.809
false,true,7828,7355,473,0,00:00:00.000,2025-04-15 11:56:28.819
false,false,7857,7383,474,400,00:00:31.000,2025-04-15 11:57:10.861
false,false,7914,7439,475,1394,00:00:31.000,2025-04-15 11:58:19.944
false,false,8016,7538,478,722,00:00:33.000,2025-04-15 12:00:32.078
false,true,8017,7538,479,0,00:00:00.000,2025-04-15 12:00:43.086
false,false,8022,7543,479,152,00:00:31.000,2025-04-15 12:00:50.095
false,true,5148,4828,320,0,00:00:00.000,2025-04-15 10:53:04.912
false,true,5148,4828,320,0,00:00:00.000,2025-04-15 10:53:05.913
false,false,5150,4830,320,62,00:00:32.000,2025-04-15 10:53:11.919
false,false,5155,4834,321,220,00:00:32.000,2025-04-15 10:53:16.923
false,false,5160,4839,321,380,00:00:32.000,2025-04-15 10:53:21.927
false,false,5246,4919,327,472,00:00:33.000,2025-04-15 10:55:12.036
false,false,5274,4946,328,315,00:00:31.000,2025-04-15 10:55:46.071
false,false,5276,4947,329,379,00:00:32.000,2025-04-15 10:55:48.072
false,false,5299,4969,330,30,00:00:30.000,2025-04-15 10:56:17.098
false,false,5301,4970,331,91,00:00:31.000,2025-04-15 10:56:19.100
false,false,5318,4983,335,474,00:00:30.000,2025-04-15 10:56:42.124
false,false,4955,4651,304,526,00:00:30.000,2025-04-15 10:48:44.640
false,false,4960,4656,304,63,00:00:32.000,2025-04-15 10:48:55.649
false,false,4966,4661,305,127,00:00:32.000,2025-04-15 10:49:07.663
false,true,4995,4687,308,0,00:00:00.000,2025-04-15 10:49:47.710
false,false,4998,4689,309,92,00:00:31.000,2025-04-15 10:49:51.715
false,false,5000,4691,309,155,00:00:30.000,2025-04-15 10:49:53.717
false,true,5010,4701,309,0,00:00:00.000,2025-04-15 10:50:05.732
false,false,5047,4735,312,1034,00:00:33.000,2025-04-15 10:50:52.782
false,false,5052,4740,312,1193,00:00:33.000,2025-04-15 10:50:57.787
false,true,5079,4763,316,0,00:00:00.000,2025-04-15 10:51:29.822
false,false,5178,4856,322,943,00:00:31.000,2025-04-15 10:53:39.945
false,true,5187,4864,323,0,00:00:00.000,2025-04-15 10:53:52.957
false,false,5219,4894,325,249,00:00:31.000,2025-04-15 10:54:39.002
false,false,5228,4902,326,530,00:00:32.000,2025-04-15 10:54:48.012
false,true,5231,4905,326,0,00:00:00.000,2025-04-15 10:54:53.017
false,true,5231,4905,326,0,00:00:00.000,2025-04-15 10:54:54.018
false,true,5231,4905,326,0,00:00:00.000,2025-04-15 10:54:57.020
false,true,5473,5129,344,0,00:00:00.000,2025-04-15 11:00:11.329
false,false,5474,5130,344,30,00:00:30.000,2025-04-15 11:00:12.330
false,false,5530,5182,348,444,00:00:33.000,2025-04-15 11:01:26.408
false,false,5543,5194,349,97,00:00:33.000,2025-04-15 11:01:45.426
false,false,5551,5202,349,352,00:00:33.000,2025-04-15 11:01:53.435
false,false,5582,5232,350,1319,00:00:30.000,2025-04-15 11:02:24.463
false,true,5582,5232,350,0,00:00:00.000,2025-04-15 11:02:30.467
false,false,5586,5236,350,130,00:00:32.000,2025-04-15 11:02:34.471
false,true,5595,5245,350,0,00:00:00.000,2025-04-15 11:02:50.487
false,false,5601,5251,350,192,00:00:33.000,2025-04-15 11:03:07.506
false,true,5603,5253,350,0,00:00:00.000,2025-04-15 11:03:10.507
false,false,5605,5255,350,64,00:00:31.000,2025-04-15 11:03:17.513
false,false,5612,5262,350,283,00:00:30.000,2025-04-15 11:03:24.521
false,true,5687,5331,356,0,00:00:00.000,2025-04-15 11:05:12.641
false,false,5710,5353,357,282,00:00:30.000,2025-04-15 11:05:50.678
false,true,5710,5353,357,0,00:00:00.000,2025-04-15 11:05:55.683
false,false,5711,5354,357,30,00:00:30.000,2025-04-15 11:05:57.686
false,false,5715,5358,357,94,00:00:31.000,2025-04-15 11:06:07.694
false,false,5719,5362,357,218,00:00:30.000,2025-04-15 11:06:11.700
false,false,5722,5365,357,309,00:00:31.000,2025-04-15 11:06:14.703
false,false,5726,5368,358,434,00:00:30.000,2025-04-15 11:06:18.707
false,false,5727,5369,358,467,00:00:33.000,2025-04-15 11:06:19.707
false,false,5617,5267,350,443,00:00:31.000,2025-04-15 11:03:29.531
false,false,5626,5276,350,721,00:00:30.000,2025-04-15 11:03:38.539
false,false,5630,5280,350,847,00:00:33.000,2025-04-15 11:03:42.544
false,false,5635,5283,352,1004,00:00:33.000,2025-04-15 11:03:47.547
false,false,5647,5294,353,1384,00:00:33.000,2025-04-15 11:03:59.559
false,false,5656,5303,353,32,00:00:32.000,2025-04-15 11:04:20.584
false,false,5667,5311,356,127,00:00:32.000,2025-04-15 11:04:43.608
false,false,5879,5510,369,659,00:00:33.000,2025-04-15 11:10:09.946
false,true,5884,5515,369,0,00:00:00.000,2025-04-15 11:10:25.961
false,true,5895,5525,370,0,00:00:00.000,2025-04-15 11:10:49.982
false,false,5901,5531,370,190,00:00:30.000,2025-04-15 11:10:55.990
false,true,5903,5533,370,0,00:00:00.000,2025-04-15 11:10:58.992
false,true,5903,5533,370,0,00:00:00.000,2025-04-15 11:11:01.994
false,false,5910,5539,371,154,00:00:30.000,2025-04-15 11:11:17.011
false,false,5919,5548,371,435,00:00:30.000,2025-04-15 11:11:26.021
false,false,5929,5557,372,753,00:00:32.000,2025-04-15 11:11:36.026
false,false,5931,5559,372,818,00:00:33.000,2025-04-15 11:11:38.026
false,false,5819,5452,367,191,00:00:33.000,2025-04-15 11:08:51.869
false,false,5820,5453,367,33,00:00:33.000,2025-04-15 11:08:58.875
false,false,5842,5474,368,720,00:00:31.000,2025-04-15 11:09:20.897
false,true,5842,5474,368,0,00:00:00.000,2025-04-15 11:09:24.902
false,true,5842,5474,368,0,00:00:00.000,2025-04-15 11:09:25.903
false,true,5858,5489,369,0,00:00:00.000,2025-04-15 11:09:47.925
false,false,5872,5503,369,441,00:00:33.000,2025-04-15 11:10:02.942
false,false,5874,5505,369,503,00:00:32.000,2025-04-15 11:10:04.943
false,true,5968,5595,373,0,00:00:00.000,2025-04-15 11:12:28.073
false,true,5968,5595,373,0,00:00:00.000,2025-04-15 11:12:31.077
false,false,5998,5622,376,30,00:00:30.000,2025-04-15 11:13:15.125
false,true,6004,5628,376,0,00:00:00.000,2025-04-15 11:13:27.135
false,true,5761,5400,361,0,00:00:00.000,2025-04-15 11:07:09.757
false,true,5764,5402,362,0,00:00:00.000,2025-04-15 11:07:22.771
false,true,5774,5411,363,0,00:00:00.000,2025-04-15 11:07:41.793
false,false,5781,5417,364,218,00:00:30.000,2025-04-15 11:07:49.801
false,false,5782,5418,364,251,00:00:33.000,2025-04-15 11:07:50.803
false,false,5783,5419,364,281,00:00:30.000,2025-04-15 11:07:51.804
false,false,6026,5648,378,572,00:00:33.000,2025-04-15 11:14:01.170
false,true,6034,5656,378,0,00:00:00.000,2025-04-15 11:14:10.181
false,true,6034,5656,378,0,00:00:00.000,2025-04-15 11:14:12.182
false,true,6035,5657,378,0,00:00:00.000,2025-04-15 11:14:17.187
false,false,6039,5661,378,127,00:00:30.000,2025-04-15 11:14:26.195
false,false,6043,5665,378,62,00:00:31.000,2025-04-15 11:14:36.202
false,false,6048,5670,378,219,00:00:31.000,2025-04-15 11:14:41.208
false,false,6254,5867,387,692,00:00:33.000,2025-04-15 11:19:01.480
false,false,6255,5868,387,722,00:00:30.000,2025-04-15 11:19:02.481
false,false,6260,5873,387,878,00:00:31.000,2025-04-15 11:19:07.488
false,true,6260,5873,387,0,00:00:00.000,2025-04-15 11:19:13.492
false,false,6271,5884,387,344,00:00:30.000,2025-04-15 11:19:24.504
false,false,6274,5887,387,31,00:00:31.000,2025-04-15 11:19:33.515
false,true,6292,5904,388,0,00:00:00.000,2025-04-15 11:20:03.543
false,false,6295,5907,388,95,00:00:32.000,2025-04-15 11:20:06.546
false,false,6074,5695,379,287,00:00:32.000,2025-04-15 11:15:13.240
false,true,6077,5698,379,0,00:00:00.000,2025-04-15 11:15:22.252
false,false,6090,5711,379,386,00:00:32.000,2025-04-15 11:15:41.274
false,false,6108,5729,379,471,00:00:31.000,2025-04-15 11:16:05.300
false,false,6124,5744,380,417,00:00:31.000,2025-04-15 11:16:27.323
false,false,6128,5748,380,540,00:00:30.000,2025-04-15 11:16:31.326
false,false,6139,5758,381,886,00:00:30.000,2025-04-15 11:16:42.339
false,false,6150,5769,381,1235,00:00:31.000,2025-04-15 11:16:53.347
false,false,6160,5779,381,1550,00:00:32.000,2025-04-15 11:17:03.355
false,false,6174,5791,383,1987,00:00:31.000,2025-04-15 11:17:17.369
false,false,6178,5794,384,2112,00:00:33.000,2025-04-15 11:17:21.373
false,false,6194,5809,385,285,00:00:30.000,2025-04-15 11:17:43.398
false,true,6196,5811,385,0,00:00:00.000,2025-04-15 11:17:47.401
false,false,6223,5836,387,847,00:00:33.000,2025-04-15 11:18:18.433
false,false,6224,5837,387,30,00:00:30.000,2025-04-15 11:18:25.440
false,true,6299,5911,388,0,00:00:00.000,2025-04-15 11:20:13.553
false,false,6304,5916,388,95,00:00:31.000,2025-04-15 11:20:27.564
false,false,6310,5922,388,279,00:00:30.000,2025-04-15 11:20:33.571
false,false,6332,5942,390,973,00:00:32.000,2025-04-15 11:20:55.595
false,true,6335,5945,390,0,00:00:00.000,2025-04-15 11:21:01.602
false,false,6367,5976,391,1003,00:00:30.000,2025-04-15 11:21:36.633
false,false,6582,6178,404,438,00:00:31.000,2025-04-15 11:26:53.972
false,false,6584,6179,405,502,00:00:31.000,2025-04-15 11:26:55.975
false,true,6588,6183,405,0,00:00:00.000,2025-04-15 11:27:09.988
false,false,6591,6186,405,90,00:00:30.000,2025-04-15 11:27:14.992
false,false,6596,6191,405,62,00:00:30.000,2025-04-15 11:27:26.003
false,true,6599,6194,405,0,00:00:00.000,2025-04-15 11:27:30.006
false,false,6625,6218,407,251,00:00:33.000,2025-04-15 11:28:13.047
false,false,6626,6219,407,283,00:00:32.000,2025-04-15 11:28:14.047
false,false,6632,6224,408,32,00:00:32.000,2025-04-15 11:28:26.058
false,false,6633,6225,408,63,00:00:31.000,2025-04-15 11:28:27.059
false,false,6526,6127,399,888,00:00:32.000,2025-04-15 11:25:45.905
false,false,6558,6155,403,220,00:00:31.000,2025-04-15 11:26:23.945
false,false,6559,6156,403,250,00:00:30.000,2025-04-15 11:26:24.947
false,true,6568,6164,404,0,00:00:00.000,2025-04-15 11:26:38.955
false,false,6382,5991,391,66,00:00:33.000,2025-04-15 11:22:03.657
false,false,6390,5999,391,324,00:00:33.000,2025-04-15 11:22:11.666
false,true,6399,6007,392,0,00:00:00.000,2025-04-15 11:22:37.699
false,false,6407,6014,393,249,00:00:30.000,2025-04-15 11:22:46.711
false,false,6412,6019,393,409,00:00:32.000,2025-04-15 11:22:51.716
false,false,6417,6024,393,30,00:00:30.000,2025-04-15 11:23:08.733
false,true,6447,6053,394,0,00:00:00.000,2025-04-15 11:24:07.798
false,true,6633,6225,408,0,00:00:00.000,2025-04-15 11:28:33.062
false,true,6667,6255,412,0,00:00:00.000,2025-04-15 11:29:25.117
false,false,6884,6462,422,63,00:00:32.000,2025-04-15 11:34:56.449
false,false,6887,6465,422,161,00:00:32.000,2025-04-15 11:34:59.449
false,false,6693,6279,414,33,00:00:33.000,2025-04-15 11:30:09.160
false,false,6702,6288,414,188,00:00:31.000,2025-04-15 11:30:24.172
false,false,6708,6293,415,376,00:00:31.000,2025-04-15 11:30:30.178
false,false,6720,6305,415,755,00:00:33.000,2025-04-15 11:30:42.187
false,false,6757,6341,416,1928,00:00:32.000,2025-04-15 11:31:19.224
false,false,6758,6342,416,1961,00:00:33.000,2025-04-15 11:31:20.225
false,false,6762,6346,416,2086,00:00:30.000,2025-04-15 11:31:24.229
false,false,6781,6362,419,2687,00:00:30.000,2025-04-15 11:31:43.246
false,false,6892,6470,422,33,00:00:33.000,2025-04-15 11:35:10.461
false,false,6903,6481,422,311,00:00:30.000,2025-04-15 11:35:27.479
false,false,6906,6484,422,97,00:00:33.000,2025-04-15 11:35:36.489
false,false,6925,6503,422,696,00:00:31.000,2025-04-15 11:35:55.510
false,false,6931,6509,422,885,00:00:32.000,2025-04-15 11:36:01.517
false,false,6942,6520,422,1235,00:00:30.000,2025-04-15 11:36:12.527
false,false,6955,6530,425,1644,00:00:30.000,2025-04-15 11:36:25.540
false,false,7052,6622,430,125,00:00:30.000,2025-04-15 11:38:38.676
false,false,7074,6643,431,824,00:00:32.000,2025-04-15 11:39:00.694
false,false,7088,6657,431,411,00:00:30.000,2025-04-15 11:39:20.715
false,false,7108,6676,432,1041,00:00:33.000,2025-04-15 11:39:40.746
false,false,7133,6700,433,1833,00:00:33.000,2025-04-15 11:40:05.772
false,false,6790,6371,419,122,00:00:30.000,2025-04-15 11:31:58.260
false,false,6801,6382,419,470,00:00:33.000,2025-04-15 11:32:09.270
false,true,6808,6389,419,0,00:00:00.000,2025-04-15 11:32:30.289
false,true,6808,6389,419,0,00:00:00.000,2025-04-15 11:32:39.298
false,true,6833,6414,419,0,00:00:00.000,2025-04-15 11:33:18.342
false,false,6971,6545,426,94,00:00:32.000,2025-04-15 11:37:05.579
false,false,6987,6561,426,598,00:00:30.000,2025-04-15 11:37:21.593
false,true,6992,6566,426,0,00:00:00.000,2025-04-15 11:37:28.601
false,true,6992,6566,426,0,00:00:00.000,2025-04-15 11:37:30.602
false,false,7010,6583,427,572,00:00:33.000,2025-04-15 11:37:50.623
false,false,7014,6587,427,699,00:00:30.000,2025-04-15 11:37:54.626
false,false,7017,6590,427,795,00:00:31.000,2025-04-15 11:37:57.629
false,false,7030,6601,429,1206,00:00:32.000,2025-04-15 11:38:10.646
false,false,7150,6714,436,158,00:00:32.000,2025-04-15 11:40:28.799
false,false,7154,6717,437,283,00:00:31.000,2025-04-15 11:40:32.803
false,false,7159,6722,437,441,00:00:33.000,2025-04-15 11:40:37.807
false,false,7161,6723,438,503,00:00:30.000,2025-04-15 11:40:39.811
false,true,7171,6731,440,0,00:00:00.000,2025-04-15 11:41:01.837
false,false,7173,6733,440,65,00:00:32.000,2025-04-15 11:41:03.839
false,false,7182,6742,440,349,00:00:30.000,2025-04-15 11:41:12.847
false,false,7183,6743,440,380,00:00:31.000,2025-04-15 11:41:13.848
false,false,7196,6755,441,792,00:00:33.000,2025-04-15 11:41:26.863
false,false,7364,6911,453,285,00:00:32.000,2025-04-15 11:45:27.117
false,false,7396,6938,458,534,00:00:33.000,2025-04-15 11:46:05.154
false,true,7404,6946,458,0,00:00:00.000,2025-04-15 11:46:22.173
false,false,7409,6951,458,93,00:00:31.000,2025-04-15 11:46:36.188
false,false,7410,6951,459,123,00:00:30.000,2025-04-15 11:46:37.189
false,true,7213,6768,445,0,00:00:00.000,2025-04-15 11:41:50.887
false,true,7219,6774,445,0,00:00:00.000,2025-04-15 11:42:13.914
false,false,7234,6788,446,468,00:00:31.000,2025-04-15 11:42:28.932
false,false,7244,6797,447,63,00:00:30.000,2025-04-15 11:42:44.946
false,false,7274,6826,448,33,00:00:33.000,2025-04-15 11:43:26.992
false,false,7428,6969,459,188,00:00:33.000,2025-04-15 11:47:07.218
false,false,7451,6991,460,285,00:00:32.000,2025-04-15 11:47:36.252
false,true,7466,7006,460,0,00:00:00.000,2025-04-15 11:47:58.280
false,false,7477,7015,462,339,00:00:32.000,2025-04-15 11:48:14.296
false,false,7494,7031,463,159,00:00:31.000,2025-04-15 11:48:37.322
false,true,7495,7032,463,0,00:00:00.000,2025-04-15 11:48:42.330
false,false,7502,7039,463,220,00:00:31.000,2025-04-15 11:48:51.344
false,false,7522,7057,465,854,00:00:33.000,2025-04-15 11:49:11.364
false,true,7540,7075,465,0,00:00:00.000,2025-04-15 11:49:38.387
false,true,7545,7080,465,0,00:00:00.000,2025-04-15 11:49:48.399
false,false,7551,7085,466,191,00:00:33.000,2025-04-15 11:49:58.405
false,false,7559,7093,466,440,00:00:30.000,2025-04-15 11:50:06.414
false,true,7277,6829,448,0,00:00:00.000,2025-04-15 11:43:30.994
false,true,7280,6832,448,0,00:00:00.000,2025-04-15 11:43:42.007
false,false,7284,6836,448,124,00:00:30.000,2025-04-15 11:43:49.014
false,false,7291,6842,449,342,00:00:30.000,2025-04-15 11:43:56.017
false,true,7317,6868,449,0,00:00:00.000,2025-04-15 11:44:23.044
false,false,7323,6874,449,186,00:00:30.000,2025-04-15 11:44:34.058
false,false,7329,6880,449,375,00:00:32.000,2025-04-15 11:44:40.066
false,true,7329,6880,449,0,00:00:00.000,2025-04-15 11:44:41.067
false,false,7342,6892,450,413,00:00:33.000,2025-04-15 11:44:59.088
false,false,7345,6895,450,506,00:00:31.000,2025-04-15 11:45:02.091
false,false,7567,7101,466,250,00:00:31.000,2025-04-15 11:50:20.427
false,false,7589,7123,466,286,00:00:31.000,2025-04-15 11:50:54.454
false,false,7591,7124,467,347,00:00:30.000,2025-04-15 11:50:56.455
false,false,7595,7128,467,471,00:00:32.000,2025-04-15 11:51:00.458
false,false,7605,7138,467,787,00:00:32.000,2025-04-15 11:51:10.467
false,false,7625,7158,467,1412,00:00:32.000,2025-04-15 11:51:30.488
false,false,7641,7174,467,1915,00:00:32.000,2025-04-15 11:51:46.502
false,false,7745,7276,469,912,00:00:30.000,2025-04-15 11:54:00.656
false,false,7748,7279,469,1005,00:00:31.000,2025-04-15 11:54:03.660
false,false,7751,7282,469,1101,00:00:33.000,2025-04-15 11:54:06.666
false,false,7760,7290,470,1388,00:00:32.000,2025-04-15 11:54:15.675
false,false,7761,7291,470,1419,00:00:31.000,2025-04-15 11:54:16.677
false,false,7763,7293,470,1482,00:00:32.000,2025-04-15 11:54:18.679
false,true,7763,7293,470,0,00:00:00.000,2025-04-15 11:54:19.680
false,true,7763,7293,470,0,00:00:00.000,2025-04-15 11:54:22.683
false,false,7769,7299,470,195,00:00:33.000,2025-04-15 11:54:36.698
false,false,7776,7306,470,61,00:00:30.000,2025-04-15 11:54:55.715
false,false,7780,7310,470,182,00:00:31.000,2025-04-15 11:54:59.719
false,false,7785,7315,470,341,00:00:32.000,2025-04-15 11:55:04.725
false,false,7665,7198,467,2676,00:00:31.000,2025-04-15 11:52:10.530
false,true,7666,7199,467,0,00:00:00.000,2025-04-15 11:52:12.534
false,true,7666,7199,467,0,00:00:00.000,2025-04-15 11:52:17.539
false,true,7683,7215,468,0,00:00:00.000,2025-04-15 11:52:35.560
false,false,7692,7224,468,64,00:00:32.000,2025-04-15 11:52:55.583
false,true,7700,7232,468,0,00:00:00.000,2025-04-15 11:53:08.598
false,false,7703,7235,468,97,00:00:32.000,2025-04-15 11:53:12.601
false,false,7707,7239,468,227,00:00:32.000,2025-04-15 11:53:16.604
false,false,7709,7241,468,293,00:00:33.000,2025-04-15 11:53:18.606
false,true,7789,7319,470,0,00:00:00.000,2025-04-15 11:55:13.736
false,false,7792,7322,470,95,00:00:33.000,2025-04-15 11:55:17.739
false,true,7811,7341,470,0,00:00:00.000,2025-04-15 11:55:45.775
false,false,7816,7346,470,155,00:00:31.000,2025-04-15 11:55:53.781
false,true,7817,7347,470,0,00:00:00.000,2025-04-15 11:55:59.785
false,true,7817,7347,470,0,00:00:00.000,2025-04-15 11:56:00.786
false,true,7823,7350,473,0,00:00:00.000,2025-04-15 11:56:07.794
false,true,7828,7355,473,0,00:00:00.000,2025-04-15 11:56:26.817
false,true,7828,7355,473,0,00:00:00.000,2025-04-15 11:56:29.820
false,true,7829,7356,473,0,00:00:00.000,2025-04-15 11:56:35.825
false,false,7853,7380,473,278,00:00:30.000,2025-04-15 11:57:06.857
false,false,7859,7385,474,462,00:00:31.000,2025-04-15 11:57:12.864
false,false,7871,7397,474,31,00:00:31.000,2025-04-15 11:57:36.899
false,false,7872,7398,474,63,00:00:32.000,2025-04-15 11:57:37.900
false,false,7888,7414,474,571,00:00:32.000,2025-04-15 11:57:53.917
false,false,7896,7422,474,829,00:00:33.000,2025-04-15 11:58:01.926
false,false,7897,7423,474,861,00:00:32.000,2025-04-15 11:58:02.927
false,false,7899,7425,474,925,00:00:31.000,2025-04-15 11:58:04.929
false,false,7919,7444,475,1549,00:00:30.000,2025-04-15 11:58:24.947
false,false,7998,7520,478,157,00:00:33.000,2025-04-15 12:00:14.060
false,false,8007,7529,478,438,00:00:33.000,2025-04-15 12:00:23.068
false,false,8020,7541,479,90,00:00:30.000,2025-04-15 12:00:48.092
false,false,8027,7548,479,312,00:00:33.000,2025-04-15 12:00:55.099
false,false,5149,4829,320,30,00:00:30.000,2025-04-15 10:53:10.919
false,false,5249,4922,327,566,00:00:30.000,2025-04-15 10:55:15.039
false,false,5257,4930,327,814,00:00:30.000,2025-04-15 10:55:23.049
false,false,5261,4934,327,943,00:00:33.000,2025-04-15 10:55:27.053
false,false,5265,4938,327,31,00:00:31.000,2025-04-15 10:55:37.060
false,false,5272,4944,328,252,00:00:31.000,2025-04-15 10:55:44.069
false,true,5298,4968,330,0,00:00:00.000,2025-04-15 10:56:11.097
false,false,5300,4969,331,60,00:00:30.000,2025-04-15 10:56:18.099
false,true,5303,4972,331,0,00:00:00.000,2025-04-15 10:56:24.105
false,false,4940,4636,304,63,00:00:31.000,2025-04-15 10:48:29.627
false,false,4970,4665,305,254,00:00:33.000,2025-04-15 10:49:11.667
false,false,5001,4692,309,185,00:00:30.000,2025-04-15 10:49:54.718
false,false,5028,4719,309,439,00:00:32.000,2025-04-15 10:50:33.766
false,false,5032,4723,309,566,00:00:32.000,2025-04-15 10:50:37.768
false,false,5034,4725,309,626,00:00:30.000,2025-04-15 10:50:39.771
false,false,5059,4746,313,1409,00:00:32.000,2025-04-15 10:51:04.795
false,false,5074,4759,315,1877,00:00:33.000,2025-04-15 10:51:19.812
false,true,5079,4763,316,0,00:00:00.000,2025-04-15 10:51:30.823
false,true,5083,4767,316,0,00:00:00.000,2025-04-15 10:51:39.835
false,false,5087,4771,316,125,00:00:32.000,2025-04-15 10:51:44.839
false,false,5173,4851,322,783,00:00:33.000,2025-04-15 10:53:34.942
false,false,5180,4858,322,1005,00:00:32.000,2025-04-15 10:53:41.947
false,true,5187,4864,323,0,00:00:00.000,2025-04-15 10:53:54.959
false,false,5203,4879,324,503,00:00:33.000,2025-04-15 10:54:10.975
false,true,5206,4882,324,0,00:00:00.000,2025-04-15 10:54:16.981
false,false,5212,4888,324,32,00:00:32.000,2025-04-15 10:54:31.996
false,false,5217,4892,325,188,00:00:30.000,2025-04-15 10:54:37.001
false,false,5224,4898,326,405,00:00:30.000,2025-04-15 10:54:44.007
false,true,5473,5129,344,0,00:00:00.000,2025-04-15 11:00:10.328
false,false,5482,5138,344,281,00:00:33.000,2025-04-15 11:00:20.340
false,false,5485,5141,344,374,00:00:30.000,2025-04-15 11:00:23.343
false,false,5488,5144,344,468,00:00:33.000,2025-04-15 11:00:26.345
false,false,5513,5165,348,61,00:00:30.000,2025-04-15 11:01:03.385
false,false,5514,5166,348,92,00:00:31.000,2025-04-15 11:01:04.386
false,false,5523,5175,348,224,00:00:33.000,2025-04-15 11:01:19.401
false,true,5540,5191,349,0,00:00:00.000,2025-04-15 11:01:42.425
false,false,5566,5216,350,818,00:00:31.000,2025-04-15 11:02:08.452
false,false,5569,5219,350,911,00:00:30.000,2025-04-15 11:02:11.456
false,true,5582,5232,350,0,00:00:00.000,2025-04-15 11:02:29.466
false,false,5595,5245,350,159,00:00:32.000,2025-04-15 11:02:49.486
false,false,5596,5246,350,33,00:00:33.000,2025-04-15 11:03:02.499
false,false,5606,5256,350,96,00:00:32.000,2025-04-15 11:03:18.515
false,false,5609,5259,350,189,00:00:30.000,2025-04-15 11:03:21.517
false,false,5694,5338,356,220,00:00:32.000,2025-04-15 11:05:22.651
false,false,5697,5341,356,316,00:00:31.000,2025-04-15 11:05:25.654
false,true,5701,5345,356,0,00:00:00.000,2025-04-15 11:05:40.668
false,false,5707,5351,356,191,00:00:33.000,2025-04-15 11:05:47.674
false,false,5731,5371,360,596,00:00:32.000,2025-04-15 11:06:23.711
false,false,5739,5379,360,852,00:00:33.000,2025-04-15 11:06:31.719
false,true,5741,5381,360,0,00:00:00.000,2025-04-15 11:06:44.732
false,true,5741,5381,360,0,00:00:00.000,2025-04-15 11:06:45.733
false,true,5662,5307,355,0,00:00:00.000,2025-04-15 11:04:29.592
false,true,5662,5307,355,0,00:00:00.000,2025-04-15 11:04:30.593
false,true,5663,5308,355,0,00:00:00.000,2025-04-15 11:04:34.597
false,false,5673,5317,356,322,00:00:31.000,2025-04-15 11:04:49.614
false,false,5676,5320,356,417,00:00:32.000,2025-04-15 11:04:52.619
false,false,5678,5322,356,479,00:00:32.000,2025-04-15 11:04:54.622
false,false,5680,5324,356,540,00:00:31.000,2025-04-15 11:04:56.623
false,true,5406,5066,340,0,00:00:00.000,2025-04-15 10:58:34.231
false,false,5422,5080,342,500,00:00:30.000,2025-04-15 10:58:50.252
false,true,5424,5082,342,0,00:00:00.000,2025-04-15 10:58:53.254
false,false,5434,5091,343,311,00:00:31.000,2025-04-15 10:59:08.269
false,true,5447,5104,343,0,00:00:00.000,2025-04-15 10:59:32.290
false,false,5466,5122,344,602,00:00:30.000,2025-04-15 10:59:52.312
false,false,5470,5126,344,726,00:00:31.000,2025-04-15 10:59:56.316
false,true,5888,5518,370,0,00:00:00.000,2025-04-15 11:10:36.970
false,false,5896,5526,370,32,00:00:32.000,2025-04-15 11:10:50.983
false,false,5900,5530,370,160,00:00:33.000,2025-04-15 11:10:54.989
false,true,5903,5533,370,0,00:00:00.000,2025-04-15 11:11:00.993
false,true,5905,5535,370,0,00:00:00.000,2025-04-15 11:11:11.004
false,false,5906,5536,370,31,00:00:31.000,2025-04-15 11:11:13.006
false,false,5907,5537,370,61,00:00:30.000,2025-04-15 11:11:14.007
false,true,5935,5563,372,0,00:00:00.000,2025-04-15 11:11:43.032
false,false,5816,5450,366,95,00:00:32.000,2025-04-15 11:08:48.865
false,false,5822,5454,368,97,00:00:33.000,2025-04-15 11:09:00.877
false,false,5825,5457,368,190,00:00:30.000,2025-04-15 11:09:03.881
false,false,5852,5484,368,315,00:00:31.000,2025-04-15 11:09:36.914
false,false,5978,5602,376,310,00:00:30.000,2025-04-15 11:12:43.092
false,false,5980,5604,376,373,00:00:33.000,2025-04-15 11:12:45.093
false,true,5761,5400,361,0,00:00:00.000,2025-04-15 11:07:11.759
false,false,5792,5427,365,565,00:00:33.000,2025-04-15 11:08:00.813
false,false,5795,5430,365,660,00:00:32.000,2025-04-15 11:08:03.815
false,false,5804,5438,366,286,00:00:30.000,2025-04-15 11:08:18.830
false,false,6021,5643,378,414,00:00:30.000,2025-04-15 11:13:56.167
false,false,6035,5657,378,30,00:00:30.000,2025-04-15 11:14:16.185
false,false,6040,5662,378,159,00:00:32.000,2025-04-15 11:14:27.196
false,false,6227,5840,387,127,00:00:32.000,2025-04-15 11:18:28.442
false,false,6240,5853,387,251,00:00:32.000,2025-04-15 11:18:47.463
false,false,6242,5855,387,314,00:00:31.000,2025-04-15 11:18:49.466
false,true,6260,5873,387,0,00:00:00.000,2025-04-15 11:19:09.489
false,false,6279,5892,387,187,00:00:30.000,2025-04-15 11:19:38.521
false,true,6280,5893,387,0,00:00:00.000,2025-04-15 11:19:40.522
false,true,6093,5714,379,0,00:00:00.000,2025-04-15 11:15:50.285
false,false,6113,5734,379,65,00:00:33.000,2025-04-15 11:16:16.312
false,false,6140,5759,381,918,00:00:32.000,2025-04-15 11:16:43.339
false,false,6167,5785,382,1770,00:00:30.000,2025-04-15 11:17:10.363
false,false,6204,5819,385,251,00:00:32.000,2025-04-15 11:17:59.412
false,false,6220,5833,387,752,00:00:30.000,2025-04-15 11:18:15.430
false,false,6335,5945,390,1069,00:00:33.000,2025-04-15 11:20:58.599
false,false,6356,5965,391,657,00:00:33.000,2025-04-15 11:21:25.622
false,false,6357,5966,391,690,00:00:33.000,2025-04-15 11:21:26.623
false,false,6362,5971,391,846,00:00:31.000,2025-04-15 11:21:31.628
false,true,6373,5982,391,0,00:00:00.000,2025-04-15 11:21:45.642
false,true,6373,5982,391,0,00:00:00.000,2025-04-15 11:21:46.643
false,false,6580,6176,404,376,00:00:31.000,2025-04-15 11:26:51.970
false,true,6588,6183,405,0,00:00:00.000,2025-04-15 11:27:00.979
false,false,6598,6193,405,124,00:00:30.000,2025-04-15 11:27:28.005
false,true,6617,6211,406,0,00:00:00.000,2025-04-15 11:28:00.034
false,true,6617,6211,406,0,00:00:00.000,2025-04-15 11:28:02.036
false,false,6623,6216,407,187,00:00:31.000,2025-04-15 11:28:11.045
false,false,6631,6224,407,440,00:00:30.000,2025-04-15 11:28:19.052
false,true,6633,6225,408,0,00:00:00.000,2025-04-15 11:28:28.060
false,false,6496,6098,398,886,00:00:33.000,2025-04-15 11:25:09.865
false,false,6498,6100,398,948,00:00:30.000,2025-04-15 11:25:11.865
false,true,6498,6100,398,0,00:00:00.000,2025-04-15 11:25:16.872
false,false,6499,6101,398,32,00:00:32.000,2025-04-15 11:25:18.874
false,false,6500,6102,398,65,00:00:33.000,2025-04-15 11:25:19.875
false,false,6522,6123,399,763,00:00:30.000,2025-04-15 11:25:41.899
false,false,6546,6144,402,1520,00:00:30.000,2025-04-15 11:26:05.922
false,false,6550,6147,403,1643,00:00:31.000,2025-04-15 11:26:09.927
false,false,6552,6149,403,30,00:00:30.000,2025-04-15 11:26:17.938
false,false,6555,6152,403,124,00:00:32.000,2025-04-15 11:26:20.941
false,false,6562,6159,403,340,00:00:30.000,2025-04-15 11:26:27.950
false,false,6383,5992,391,99,00:00:33.000,2025-04-15 11:22:04.658
false,true,6394,6003,391,0,00:00:00.000,2025-04-15 11:22:23.683
false,true,6399,6007,392,0,00:00:00.000,2025-04-15 11:22:36.698
false,true,6416,6023,393,0,00:00:00.000,2025-04-15 11:23:07.732
false,false,6418,6025,393,62,00:00:32.000,2025-04-15 11:23:09.733
false,true,6429,6036,393,0,00:00:00.000,2025-04-15 11:23:44.772
false,true,6447,6053,394,0,00:00:00.000,2025-04-15 11:24:08.799
false,false,6453,6059,394,191,00:00:32.000,2025-04-15 11:24:14.804
false,false,6467,6072,395,129,00:00:33.000,2025-04-15 11:24:34.829
false,true,6633,6225,408,0,00:00:00.000,2025-04-15 11:28:29.060
false,false,6634,6226,408,32,00:00:32.000,2025-04-15 11:28:34.064
false,true,6659,6248,411,0,00:00:00.000,2025-04-15 11:29:05.094
false,true,6668,6256,412,0,00:00:00.000,2025-04-15 11:29:30.119
false,true,6668,6256,412,0,00:00:00.000,2025-04-15 11:29:31.120
false,false,6671,6259,412,97,00:00:31.000,2025-04-15 11:29:35.123
false,false,6675,6263,412,95,00:00:32.000,2025-04-15 11:29:45.136
false,true,6851,6431,420,0,00:00:00.000,2025-04-15 11:34:03.387
false,false,6860,6440,420,158,00:00:33.000,2025-04-15 11:34:20.408
false,true,6882,6460,422,0,00:00:00.000,2025-04-15 11:34:43.435
false,true,6882,6460,422,0,00:00:00.000,2025-04-15 11:34:46.438
false,false,6888,6466,422,193,00:00:32.000,2025-04-15 11:35:00.451
false,false,6695,6281,414,96,00:00:33.000,2025-04-15 11:30:11.162
false,false,6696,6282,414,127,00:00:31.000,2025-04-15 11:30:12.162
false,true,6696,6282,414,0,00:00:00.000,2025-04-15 11:30:13.162
false,true,6696,6282,414,0,00:00:00.000,2025-04-15 11:30:17.164
false,false,6710,6295,415,436,00:00:30.000,2025-04-15 11:30:32.181
false,false,6754,6339,415,1832,00:00:31.000,2025-04-15 11:31:16.222
false,false,6759,6343,416,1992,00:00:31.000,2025-04-15 11:31:21.225
false,false,6761,6345,416,2056,00:00:32.000,2025-04-15 11:31:23.228
false,false,6767,6350,417,2245,00:00:33.000,2025-04-15 11:31:29.234
false,false,6769,6352,417,2306,00:00:30.000,2025-04-15 11:31:31.236
false,false,6902,6480,422,281,00:00:30.000,2025-04-15 11:35:26.478
false,false,6908,6486,422,158,00:00:31.000,2025-04-15 11:35:38.492
false,false,6918,6496,422,473,00:00:32.000,2025-04-15 11:35:48.504
false,false,6928,6506,422,793,00:00:32.000,2025-04-15 11:35:58.514
false,false,6933,6511,422,950,00:00:33.000,2025-04-15 11:36:03.519
false,true,6960,6535,425,0,00:00:00.000,2025-04-15 11:36:31.545
false,true,6960,6535,425,0,00:00:00.000,2025-04-15 11:36:36.548
false,false,6964,6538,426,125,00:00:30.000,2025-04-15 11:36:40.555
false,true,6964,6538,426,0,00:00:00.000,2025-04-15 11:36:45.558
false,false,7071,6640,431,729,00:00:32.000,2025-04-15 11:38:57.689
false,false,7086,6655,431,348,00:00:32.000,2025-04-15 11:39:18.714
false,false,7091,6660,431,505,00:00:33.000,2025-04-15 11:39:23.719
false,false,7112,6680,432,1170,00:00:33.000,2025-04-15 11:39:44.750
false,false,6805,6386,419,91,00:00:30.000,2025-04-15 11:32:25.284
false,true,6808,6389,419,0,00:00:00.000,2025-04-15 11:32:32.292
false,false,6814,6395,419,186,00:00:30.000,2025-04-15 11:32:46.305
false,false,6832,6413,419,378,00:00:33.000,2025-04-15 11:33:16.341
false,false,6974,6548,426,189,00:00:30.000,2025-04-15 11:37:08.583
false,false,7004,6577,427,381,00:00:33.000,2025-04-15 11:37:44.617
false,false,7006,6579,427,444,00:00:32.000,2025-04-15 11:37:46.618
false,false,7007,6580,427,475,00:00:31.000,2025-04-15 11:37:47.619
false,false,7018,6591,427,825,00:00:30.000,2025-04-15 11:37:58.630
false,false,7020,6592,428,890,00:00:33.000,2025-04-15 11:38:00.633
false,false,7022,6594,428,950,00:00:30.000,2025-04-15 11:38:02.637
false,false,7024,6596,428,1012,00:00:30.000,2025-04-15 11:38:04.639
false,false,7026,6598,428,1078,00:00:33.000,2025-04-15 11:38:06.642
false,true,7166,6727,439,0,00:00:00.000,2025-04-15 11:40:47.821
false,true,7171,6731,440,0,00:00:00.000,2025-04-15 11:40:57.830
false,false,7202,6760,442,982,00:00:32.000,2025-04-15 11:41:32.869
false,false,7203,6761,442,30,00:00:30.000,2025-04-15 11:41:39.876
false,false,7354,6901,453,793,00:00:33.000,2025-04-15 11:45:11.099
false,true,7355,6902,453,0,00:00:00.000,2025-04-15 11:45:18.107
false,false,7359,6906,453,127,00:00:31.000,2025-04-15 11:45:22.111
false,false,7362,6909,453,223,00:00:33.000,2025-04-15 11:45:25.114
false,false,7366,6913,453,351,00:00:33.000,2025-04-15 11:45:29.118
false,false,7382,6926,456,95,00:00:32.000,2025-04-15 11:45:51.139
false,true,7404,6946,458,0,00:00:00.000,2025-04-15 11:46:20.170
false,true,7404,6946,458,0,00:00:00.000,2025-04-15 11:46:25.176
false,false,7406,6948,458,64,00:00:32.000,2025-04-15 11:46:27.178
false,false,7415,6956,459,280,00:00:31.000,2025-04-15 11:46:42.193
false,true,7213,6768,445,0,00:00:00.000,2025-04-15 11:41:53.890
false,true,7213,6768,445,0,00:00:00.000,2025-04-15 11:41:54.892
false,true,7219,6774,445,0,00:00:00.000,2025-04-15 11:42:10.910
false,false,7220,6775,445,32,00:00:32.000,2025-04-15 11:42:14.915
false,false,7231,6786,445,375,00:00:31.000,2025-04-15 11:42:25.930
false,true,7254,6807,447,0,00:00:00.000,2025-04-15 11:42:55.956
false,false,7429,6970,459,218,00:00:30.000,2025-04-15 11:47:08.219
false,true,7442,6982,460,0,00:00:00.000,2025-04-15 11:47:27.242
false,true,7464,7004,460,0,00:00:00.000,2025-04-15 11:47:53.276
false,true,7464,7004,460,0,00:00:00.000,2025-04-15 11:47:55.277
false,false,7473,7011,462,216,00:00:32.000,2025-04-15 11:48:10.290
false,false,7525,7060,465,948,00:00:30.000,2025-04-15 11:49:14.365
false,false,7528,7063,465,1044,00:00:32.000,2025-04-15 11:49:17.365
false,false,7543,7078,465,90,00:00:30.000,2025-04-15 11:49:44.395
false,true,7277,6829,448,0,00:00:00.000,2025-04-15 11:43:33.998
false,false,7278,6830,448,31,00:00:31.000,2025-04-15 11:43:37.002
false,true,7280,6832,448,0,00:00:00.000,2025-04-15 11:43:45.009
false,false,7287,6839,448,217,00:00:32.000,2025-04-15 11:43:52.015
false,false,7301,6852,449,657,00:00:31.000,2025-04-15 11:44:06.027
false,false,7314,6865,449,1064,00:00:32.000,2025-04-15 11:44:19.039
false,true,7317,6868,449,0,00:00:00.000,2025-04-15 11:44:24.047
false,false,7321,6872,449,126,00:00:32.000,2025-04-15 11:44:32.055
false,false,7341,6891,450,380,00:00:33.000,2025-04-15 11:44:58.087
false,true,7570,7104,466,0,00:00:00.000,2025-04-15 11:50:24.431
false,false,7609,7142,467,909,00:00:30.000,2025-04-15 11:51:14.472
false,false,7638,7171,467,1821,00:00:32.000,2025-04-15 11:51:43.501
false,false,7737,7269,468,661,00:00:31.000,2025-04-15 11:53:52.648
false,true,7763,7293,470,0,00:00:00.000,2025-04-15 11:54:24.685
false,true,7763,7293,470,0,00:00:00.000,2025-04-15 11:54:26.687
false,false,7778,7308,470,121,00:00:30.000,2025-04-15 11:54:57.718
false,false,7664,7197,467,2645,00:00:33.000,2025-04-15 11:52:09.529
false,true,7666,7199,467,0,00:00:00.000,2025-04-15 11:52:13.535
false,false,7691,7223,468,32,00:00:32.000,2025-04-15 11:52:54.582
false,true,7700,7232,468,0,00:00:00.000,2025-04-15 11:53:09.599
false,true,7716,7248,468,0,00:00:00.000,2025-04-15 11:53:28.618
false,false,7794,7324,470,157,00:00:32.000,2025-04-15 11:55:19.742
false,false,7802,7332,470,31,00:00:31.000,2025-04-15 11:55:33.760
false,false,7804,7334,470,95,00:00:33.000,2025-04-15 11:55:35.762
false,false,7809,7339,470,250,00:00:30.000,2025-04-15 11:55:40.768
false,true,7811,7341,470,0,00:00:00.000,2025-04-15 11:55:48.777
false,true,7823,7350,473,0,00:00:00.000,2025-04-15 11:56:11.799
false,false,7825,7352,473,33,00:00:33.000,2025-04-15 11:56:20.810
false,true,7844,7371,473,0,00:00:00.000,2025-04-15 11:56:53.844
false,false,7890,7416,474,636,00:00:32.000,2025-04-15 11:57:55.920
false,false,7921,7446,475,1612,00:00:30.000,2025-04-15 11:58:26.949
false,false,8012,7534,478,595,00:00:30.000,2025-04-15 12:00:28.075
false,true,8016,7538,478,0,00:00:00.000,2025-04-15 12:00:37.083
false,false,8038,7559,479,93,00:00:31.000,2025-04-15 12:01:12.113
false,false,8043,7564,479,251,00:00:32.000,2025-04-15 12:01:17.119
false,false,5278,4949,329,443,00:00:33.000,2025-04-15 10:55:50.073
false,true,4958,4654,304,0,00:00:00.000,2025-04-15 10:48:53.648
false,true,4962,4657,305,0,00:00:00.000,2025-04-15 10:49:03.659
false,false,4964,4659,305,64,00:00:32.000,2025-04-15 10:49:05.660
false,false,4968,4663,305,190,00:00:30.000,2025-04-15 10:49:09.664
false,false,5002,4693,309,215,00:00:30.000,2025-04-15 10:49:55.720
false,false,5019,4710,309,156,00:00:31.000,2025-04-15 10:50:24.754
false,false,5027,4718,309,407,00:00:30.000,2025-04-15 10:50:32.765
false,false,5033,4724,309,596,00:00:30.000,2025-04-15 10:50:38.770
false,false,5051,4739,312,1160,00:00:32.000,2025-04-15 10:50:56.786
false,false,5077,4761,316,1972,00:00:33.000,2025-04-15 10:51:22.815
false,true,5083,4767,316,0,00:00:00.000,2025-04-15 10:51:37.832
false,false,5086,4770,316,93,00:00:30.000,2025-04-15 10:51:43.838
false,true,5187,4864,323,0,00:00:00.000,2025-04-15 10:53:53.958
false,false,5190,4867,323,93,00:00:32.000,2025-04-15 10:53:57.961
false,false,5207,4883,324,32,00:00:32.000,2025-04-15 10:54:20.984
false,true,5211,4887,324,0,00:00:00.000,2025-04-15 10:54:28.994
false,false,5239,4913,326,253,00:00:32.000,2025-04-15 10:55:05.028
false,true,5511,5163,348,0,00:00:00.000,2025-04-15 11:00:57.377
false,true,5511,5163,348,0,00:00:00.000,2025-04-15 11:00:58.379
false,true,5516,5168,348,0,00:00:00.000,2025-04-15 11:01:09.392
false,false,5518,5170,348,63,00:00:31.000,2025-04-15 11:01:14.395
false,true,5540,5191,349,0,00:00:00.000,2025-04-15 11:01:38.422
false,false,5591,5241,350,33,00:00:33.000,2025-04-15 11:02:45.481
false,false,5599,5249,350,128,00:00:31.000,2025-04-15 11:03:05.503
false,false,5602,5252,350,222,00:00:30.000,2025-04-15 11:03:08.507
false,true,5603,5253,350,0,00:00:00.000,2025-04-15 11:03:13.510
false,true,5603,5253,350,0,00:00:00.000,2025-04-15 11:03:15.511
false,true,5701,5345,356,0,00:00:00.000,2025-04-15 11:05:39.667
false,false,5712,5355,357,61,00:00:31.000,2025-04-15 11:05:58.688
false,false,5718,5361,357,188,00:00:31.000,2025-04-15 11:06:10.698
false,false,5723,5366,357,339,00:00:30.000,2025-04-15 11:06:15.703
false,false,5738,5378,360,819,00:00:32.000,2025-04-15 11:06:30.718
false,true,5741,5381,360,0,00:00:00.000,2025-04-15 11:06:40.727
false,false,5631,5281,350,877,00:00:30.000,2025-04-15 11:03:43.544
false,false,5639,5286,353,1132,00:00:33.000,2025-04-15 11:03:51.552
false,false,5642,5289,353,1226,00:00:30.000,2025-04-15 11:03:54.555
false,false,5650,5297,353,1479,00:00:31.000,2025-04-15 11:04:02.563
false,true,5655,5302,353,0,00:00:00.000,2025-04-15 11:04:17.581
false,true,5424,5082,342,0,00:00:00.000,2025-04-15 10:58:56.258
false,false,5427,5085,342,93,00:00:32.000,2025-04-15 10:59:01.263
false,false,5472,5128,344,64,00:00:33.000,2025-04-15 11:00:04.321
false,false,5889,5519,370,33,00:00:33.000,2025-04-15 11:10:37.971
false,false,5903,5533,370,253,00:00:33.000,2025-04-15 11:10:57.992
false,true,5903,5533,370,0,00:00:00.000,2025-04-15 11:11:03.997
false,true,5905,5535,370,0,00:00:00.000,2025-04-15 11:11:12.005
false,false,5908,5538,370,93,00:00:32.000,2025-04-15 11:11:15.008
false,false,5914,5543,371,283,00:00:33.000,2025-04-15 11:11:21.016
false,false,5812,5446,366,126,00:00:31.000,2025-04-15 11:08:38.854
false,true,5813,5447,366,0,00:00:00.000,2025-04-15 11:08:45.861
false,false,5817,5451,366,126,00:00:31.000,2025-04-15 11:08:49.867
false,true,5819,5452,367,0,00:00:00.000,2025-04-15 11:08:54.873
false,true,5819,5452,367,0,00:00:00.000,2025-04-15 11:08:55.874
false,false,5824,5456,368,160,00:00:33.000,2025-04-15 11:09:02.879
false,false,5833,5465,368,440,00:00:30.000,2025-04-15 11:09:11.888
false,false,5834,5466,368,471,00:00:31.000,2025-04-15 11:09:12.889
false,false,5845,5477,368,96,00:00:33.000,2025-04-15 11:09:29.907
false,false,5865,5496,369,221,00:00:31.000,2025-04-15 11:09:55.937
false,true,5937,5565,372,0,00:00:00.000,2025-04-15 11:11:53.044
false,false,5940,5568,372,95,00:00:33.000,2025-04-15 11:11:59.047
false,false,5954,5582,372,534,00:00:32.000,2025-04-15 11:12:13.059
false,false,5993,5617,376,784,00:00:32.000,2025-04-15 11:12:58.105
false,false,5756,5396,360,473,00:00:31.000,2025-04-15 11:07:00.746
false,false,5759,5398,361,566,00:00:31.000,2025-04-15 11:07:03.748
false,false,5772,5409,363,255,00:00:33.000,2025-04-15 11:07:34.784
false,true,5774,5411,363,0,00:00:00.000,2025-04-15 11:07:40.792
false,false,5777,5413,364,92,00:00:30.000,2025-04-15 11:07:45.797
false,false,5785,5421,364,345,00:00:31.000,2025-04-15 11:07:53.805
false,true,5795,5430,365,0,00:00:00.000,2025-04-15 11:08:05.816
false,true,5807,5441,366,0,00:00:00.000,2025-04-15 11:08:24.838
false,false,6008,5632,376,63,00:00:31.000,2025-04-15 11:13:37.144
false,true,6034,5656,378,0,00:00:00.000,2025-04-15 11:14:14.183
false,false,6056,5678,378,469,00:00:30.000,2025-04-15 11:14:49.217
false,false,6064,5686,378,722,00:00:30.000,2025-04-15 11:14:57.227
false,false,6065,5687,378,752,00:00:30.000,2025-04-15 11:14:58.226
false,true,6065,5687,378,0,00:00:00.000,2025-04-15 11:15:02.230
false,false,6239,5852,387,219,00:00:33.000,2025-04-15 11:18:46.462
false,false,6261,5874,387,33,00:00:33.000,2025-04-15 11:19:14.492
false,true,6273,5886,387,0,00:00:00.000,2025-04-15 11:19:28.509
false,true,6273,5886,387,0,00:00:00.000,2025-04-15 11:19:30.511
false,false,6283,5896,387,94,00:00:33.000,2025-04-15 11:19:48.529
false,false,6284,5897,387,127,00:00:33.000,2025-04-15 11:19:49.531
false,true,6078,5699,379,0,00:00:00.000,2025-04-15 11:15:27.257
false,false,6086,5707,379,256,00:00:33.000,2025-04-15 11:15:37.271
false,false,6102,5723,379,285,00:00:32.000,2025-04-15 11:15:59.292
false,false,6107,5728,379,440,00:00:32.000,2025-04-15 11:16:04.299
false,true,6111,5732,379,0,00:00:00.000,2025-04-15 11:16:12.308
false,false,6130,5750,380,603,00:00:30.000,2025-04-15 11:16:33.328
false,false,6142,5761,381,980,00:00:31.000,2025-04-15 11:16:45.340
false,false,6149,5768,381,1204,00:00:33.000,2025-04-15 11:16:52.346
false,false,6168,5786,382,1800,00:00:30.000,2025-04-15 11:17:11.365
false,false,6195,5810,385,317,00:00:32.000,2025-04-15 11:17:44.399
false,false,6197,5812,385,32,00:00:32.000,2025-04-15 11:17:52.407
false,false,6221,5834,387,783,00:00:31.000,2025-04-15 11:18:16.430
false,true,6301,5913,388,0,00:00:00.000,2025-04-15 11:20:21.559
false,true,6301,5913,388,0,00:00:00.000,2025-04-15 11:20:24.562
false,false,6321,5932,389,621,00:00:30.000,2025-04-15 11:20:44.581
false,false,6336,5946,390,30,00:00:30.000,2025-04-15 11:21:05.606
false,false,6347,5956,391,376,00:00:33.000,2025-04-15 11:21:16.618
false,false,6373,5982,391,1188,00:00:31.000,2025-04-15 11:21:42.639
false,true,6588,6183,405,0,00:00:00.000,2025-04-15 11:27:01.979
false,true,6588,6183,405,0,00:00:00.000,2025-04-15 11:27:02.980
false,true,6588,6183,405,0,00:00:00.000,2025-04-15 11:27:07.986
false,true,6599,6194,405,0,00:00:00.000,2025-04-15 11:27:31.007
false,true,6611,6205,406,0,00:00:00.000,2025-04-15 11:27:51.024
false,false,6619,6213,406,62,00:00:30.000,2025-04-15 11:28:07.039
false,false,6502,6104,398,131,00:00:33.000,2025-04-15 11:25:21.878
false,false,6531,6132,399,1046,00:00:33.000,2025-04-15 11:25:50.911
false,false,6535,6136,399,1174,00:00:32.000,2025-04-15 11:25:54.913
false,false,6537,6138,399,1234,00:00:30.000,2025-04-15 11:25:56.914
false,false,6551,6148,403,1675,00:00:32.000,2025-04-15 11:26:10.929
false,true,6551,6148,403,0,00:00:00.000,2025-04-15 11:26:11.930
false,false,6556,6153,403,156,00:00:32.000,2025-04-15 11:26:21.942
false,false,6561,6158,403,310,00:00:30.000,2025-04-15 11:26:26.950
false,true,6394,6003,391,0,00:00:00.000,2025-04-15 11:22:26.687
false,false,6399,6007,392,158,00:00:31.000,2025-04-15 11:22:32.693
false,false,6420,6027,393,124,00:00:32.000,2025-04-15 11:23:11.734
false,true,6425,6032,393,0,00:00:00.000,2025-04-15 11:23:17.740
false,true,6428,6035,393,0,00:00:00.000,2025-04-15 11:23:26.751
false,true,6428,6035,393,0,00:00:00.000,2025-04-15 11:23:28.755
false,true,6428,6035,393,0,00:00:00.000,2025-04-15 11:23:34.763
false,false,6434,6040,394,156,00:00:31.000,2025-04-15 11:23:49.777
false,false,6435,6041,394,188,00:00:32.000,2025-04-15 11:23:50.780
false,true,6468,6072,396,0,00:00:00.000,2025-04-15 11:24:37.830
false,false,6486,6089,397,569,00:00:33.000,2025-04-15 11:24:59.851
false,false,6669,6257,412,33,00:00:33.000,2025-04-15 11:29:33.121
false,false,6676,6264,412,127,00:00:32.000,2025-04-15 11:29:46.137
false,false,6685,6271,414,412,00:00:30.000,2025-04-15 11:29:55.147
false,false,6842,6422,420,125,00:00:32.000,2025-04-15 11:33:44.370
false,true,6842,6422,420,0,00:00:00.000,2025-04-15 11:33:47.372
false,true,6851,6431,420,0,00:00:00.000,2025-04-15 11:34:04.387
false,false,6855,6435,420,127,00:00:32.000,2025-04-15 11:34:09.394
false,false,6879,6457,422,763,00:00:32.000,2025-04-15 11:34:39.430
false,false,6889,6467,422,223,00:00:30.000,2025-04-15 11:35:01.452
false,false,6700,6286,414,127,00:00:31.000,2025-04-15 11:30:22.170
false,false,6725,6310,415,911,00:00:31.000,2025-04-15 11:30:47.189
false,false,6736,6321,415,1262,00:00:32.000,2025-04-15 11:30:58.201
false,false,6748,6333,415,1641,00:00:32.000,2025-04-15 11:31:10.216
false,false,6775,6358,417,2498,00:00:32.000,2025-04-15 11:31:37.241
false,false,6893,6471,422,65,00:00:32.000,2025-04-15 11:35:11.463
false,false,6923,6501,422,632,00:00:32.000,2025-04-15 11:35:53.509
false,false,6926,6504,422,728,00:00:32.000,2025-04-15 11:35:56.511
false,false,6958,6533,425,1737,00:00:30.000,2025-04-15 11:36:28.542
false,false,6965,6539,426,33,00:00:33.000,2025-04-15 11:36:47.559
false,true,7048,6618,430,0,00:00:00.000,2025-04-15 11:38:34.673
false,false,7053,6623,430,158,00:00:33.000,2025-04-15 11:38:39.676
false,false,7058,6628,430,315,00:00:32.000,2025-04-15 11:38:44.679
false,false,7068,6637,431,635,00:00:33.000,2025-04-15 11:38:54.686
false,false,7069,6638,431,666,00:00:31.000,2025-04-15 11:38:55.686
false,false,7093,6661,432,568,00:00:30.000,2025-04-15 11:39:25.724
false,false,7101,6669,432,822,00:00:33.000,2025-04-15 11:39:33.736
false,false,7109,6677,432,1074,00:00:33.000,2025-04-15 11:39:41.747
false,false,7121,6689,432,1453,00:00:31.000,2025-04-15 11:39:53.760
false,false,7124,6692,432,1547,00:00:33.000,2025-04-15 11:39:56.762
false,false,7127,6695,432,1643,00:00:32.000,2025-04-15 11:39:59.766
false,true,6786,6367,419,0,00:00:00.000,2025-04-15 11:31:51.251
false,false,6796,6377,419,313,00:00:33.000,2025-04-15 11:32:04.264
false,true,6802,6383,419,0,00:00:00.000,2025-04-15 11:32:20.279
false,true,6819,6400,419,0,00:00:00.000,2025-04-15 11:32:57.319
false,false,6983,6557,426,472,00:00:30.000,2025-04-15 11:37:17.592
false,false,7139,6704,435,2020,00:00:32.000,2025-04-15 11:40:11.779
false,true,7145,6710,435,0,00:00:00.000,2025-04-15 11:40:23.791
false,false,7156,6719,437,347,00:00:33.000,2025-04-15 11:40:34.805
false,true,7171,6731,440,0,00:00:00.000,2025-04-15 11:41:00.835
false,false,7177,6737,440,191,00:00:33.000,2025-04-15 11:41:07.840
false,false,7198,6757,441,857,00:00:32.000,2025-04-15 11:41:28.864
false,false,7204,6762,442,62,00:00:32.000,2025-04-15 11:41:40.877
false,false,7355,6902,453,826,00:00:33.000,2025-04-15 11:45:12.100
false,true,7379,6923,456,0,00:00:00.000,2025-04-15 11:45:46.134
false,false,7380,6924,456,33,00:00:33.000,2025-04-15 11:45:49.137
false,false,7392,6934,458,407,00:00:30.000,2025-04-15 11:46:01.150
false,false,7393,6935,458,438,00:00:31.000,2025-04-15 11:46:02.150
false,false,7395,6937,458,501,00:00:30.000,2025-04-15 11:46:04.152
false,true,7406,6948,458,0,00:00:00.000,2025-04-15 11:46:28.179
false,true,7417,6958,459,0,00:00:00.000,2025-04-15 11:46:49.200
false,false,7213,6768,445,347,00:00:33.000,2025-04-15 11:41:49.887
false,true,7216,6771,445,0,00:00:00.000,2025-04-15 11:42:02.900
false,true,7219,6774,445,0,00:00:00.000,2025-04-15 11:42:09.910
false,false,7235,6789,446,498,00:00:30.000,2025-04-15 11:42:29.934
false,false,7237,6791,446,562,00:00:33.000,2025-04-15 11:42:31.937
false,false,7242,6795,447,724,00:00:31.000,2025-04-15 11:42:36.939
false,true,7242,6795,447,0,00:00:00.000,2025-04-15 11:42:37.941
false,true,7242,6795,447,0,00:00:00.000,2025-04-15 11:42:42.944
false,false,7252,6805,447,311,00:00:30.000,2025-04-15 11:42:52.952
false,false,7267,6820,447,406,00:00:33.000,2025-04-15 11:43:13.976
false,false,7273,6825,448,596,00:00:31.000,2025-04-15 11:43:19.984
false,false,7425,6966,459,94,00:00:30.000,2025-04-15 11:47:04.213
false,true,7442,6982,460,0,00:00:00.000,2025-04-15 11:47:25.241
false,true,7464,7004,460,0,00:00:00.000,2025-04-15 11:47:54.277
false,true,7466,7006,460,0,00:00:00.000,2025-04-15 11:48:02.285
false,false,7505,7041,464,313,00:00:30.000,2025-04-15 11:48:54.347
false,false,7521,7056,465,821,00:00:30.000,2025-04-15 11:49:10.363
false,true,7528,7063,465,0,00:00:00.000,2025-04-15 11:49:19.367
false,true,7528,7063,465,0,00:00:00.000,2025-04-15 11:49:20.368
false,true,7540,7075,465,0,00:00:00.000,2025-04-15 11:49:36.386
false,false,7541,7076,465,30,00:00:30.000,2025-04-15 11:49:42.392
false,false,7548,7082,466,93,00:00:31.000,2025-04-15 11:49:55.405
false,false,7558,7092,466,410,00:00:30.000,2025-04-15 11:50:05.413
false,true,7277,6829,448,0,00:00:00.000,2025-04-15 11:43:31.995
false,false,7280,6832,448,96,00:00:32.000,2025-04-15 11:43:39.005
false,false,7282,6834,448,62,00:00:30.000,2025-04-15 11:43:47.011
false,false,7309,6860,449,908,00:00:33.000,2025-04-15 11:44:14.035
false,false,7316,6867,449,1126,00:00:31.000,2025-04-15 11:44:21.042
false,false,7327,6878,449,312,00:00:32.000,2025-04-15 11:44:38.065
false,true,7329,6880,449,0,00:00:00.000,2025-04-15 11:44:46.071
false,false,7340,6890,450,347,00:00:30.000,2025-04-15 11:44:57.087
false,false,7347,6896,451,570,00:00:31.000,2025-04-15 11:45:04.093
false,false,7571,7105,466,32,00:00:32.000,2025-04-15 11:50:30.435
false,false,7585,7119,466,160,00:00:33.000,2025-04-15 11:50:50.451
false,false,7610,7143,467,940,00:00:31.000,2025-04-15 11:51:15.473
false,false,7621,7154,467,1285,00:00:31.000,2025-04-15 11:51:26.484
false,false,7718,7250,468,63,00:00:33.000,2025-04-15 11:53:33.622
false,false,7723,7255,468,218,00:00:31.000,2025-04-15 11:53:38.629
false,false,7726,7258,468,311,00:00:33.000,2025-04-15 11:53:41.633
false,false,7730,7262,468,438,00:00:31.000,2025-04-15 11:53:45.638
false,false,7732,7264,468,500,00:00:32.000,2025-04-15 11:53:47.640
false,false,7734,7266,468,565,00:00:33.000,2025-04-15 11:53:49.644
false,false,7740,7272,468,757,00:00:30.000,2025-04-15 11:53:55.651
false,false,7746,7277,469,944,00:00:32.000,2025-04-15 11:54:01.656
false,false,7648,7181,467,2133,00:00:33.000,2025-04-15 11:51:53.510
false,false,7657,7190,467,2421,00:00:30.000,2025-04-15 11:52:02.519
false,false,7669,7201,468,99,00:00:33.000,2025-04-15 11:52:20.542
false,false,7673,7205,468,226,00:00:31.000,2025-04-15 11:52:24.547
false,true,7690,7222,468,0,00:00:00.000,2025-04-15 11:52:51.576
false,false,7694,7226,468,124,00:00:30.000,2025-04-15 11:52:57.587
false,false,7695,7227,468,156,00:00:32.000,2025-04-15 11:52:58.589
false,false,7715,7247,468,481,00:00:30.000,2025-04-15 11:53:24.612
false,true,7716,7248,468,0,00:00:00.000,2025-04-15 11:53:29.619
false,false,7799,7329,470,315,00:00:31.000,2025-04-15 11:55:24.749
false,true,7801,7331,470,0,00:00:00.000,2025-04-15 11:55:30.756
false,true,7801,7331,470,0,00:00:00.000,2025-04-15 11:55:32.758
false,true,7811,7341,470,0,00:00:00.000,2025-04-15 11:55:46.775
false,true,7817,7347,470,0,00:00:00.000,2025-04-15 11:55:57.784
false,true,7817,7347,470,0,00:00:00.000,2025-04-15 11:55:58.784
false,false,7837,7364,473,253,00:00:32.000,2025-04-15 11:56:44.834
false,false,7898,7424,474,894,00:00:33.000,2025-04-15 11:58:03.929
false,false,7911,7437,474,1298,00:00:32.000,2025-04-15 11:58:16.942
false,false,7996,7518,478,92,00:00:30.000,2025-04-15 12:00:12.059
false,false,8010,7532,478,533,00:00:33.000,2025-04-15 12:00:26.072
false,true,8016,7538,478,0,00:00:00.000,2025-04-15 12:00:36.082
false,false,8034,7555,479,534,00:00:30.000,2025-04-15 12:01:02.105
false,true,8035,7556,479,0,00:00:00.000,2025-04-15 12:01:05.108
false,false,8036,7557,479,31,00:00:31.000,2025-04-15 12:01:10.113
false,true,5148,4828,320,0,00:00:00.000,2025-04-15 10:53:09.918
false,false,5251,4924,327,631,00:00:32.000,2025-04-15 10:55:17.040
false,false,5254,4927,327,724,00:00:32.000,2025-04-15 10:55:20.045
false,true,5264,4937,327,0,00:00:00.000,2025-04-15 10:55:36.059
false,false,5281,4952,329,536,00:00:32.000,2025-04-15 10:55:53.078
false,false,5298,4968,330,1072,00:00:31.000,2025-04-15 10:56:10.095
false,true,5298,4968,330,0,00:00:00.000,2025-04-15 10:56:15.098
false,false,5308,4975,333,157,00:00:33.000,2025-04-15 10:56:32.114
false,false,5315,4981,334,379,00:00:31.000,2025-04-15 10:56:39.121
false,false,4939,4635,304,32,00:00:32.000,2025-04-15 10:48:28.627
false,false,4948,4644,304,310,00:00:31.000,2025-04-15 10:48:37.634
false,false,4976,4671,305,30,00:00:30.000,2025-04-15 10:49:23.681
false,true,4995,4687,308,0,00:00:00.000,2025-04-15 10:49:46.710
false,true,5010,4701,309,0,00:00:00.000,2025-04-15 10:50:06.732
false,false,5037,4728,309,719,00:00:31.000,2025-04-15 10:50:42.774
false,false,5053,4741,312,1223,00:00:30.000,2025-04-15 10:50:58.788
false,false,5063,4750,313,1534,00:00:30.000,2025-04-15 10:51:08.800
false,false,5084,4768,316,30,00:00:30.000,2025-04-15 10:51:41.836
false,false,5167,4846,321,596,00:00:30.000,2025-04-15 10:53:28.935
false,false,5176,4854,322,880,00:00:33.000,2025-04-15 10:53:37.942
false,false,5182,4859,323,1069,00:00:31.000,2025-04-15 10:53:43.949
false,false,5193,4869,324,189,00:00:32.000,2025-04-15 10:54:00.963
false,false,5198,4874,324,346,00:00:33.000,2025-04-15 10:54:05.969
false,false,5226,4900,326,467,00:00:32.000,2025-04-15 10:54:46.010
false,false,5229,4903,326,561,00:00:31.000,2025-04-15 10:54:49.012
false,false,5234,4908,326,96,00:00:33.000,2025-04-15 10:55:00.022
false,false,5487,5143,344,435,00:00:30.000,2025-04-15 11:00:25.345
false,false,5495,5151,344,222,00:00:30.000,2025-04-15 11:00:39.358
false,false,5498,5154,344,318,00:00:33.000,2025-04-15 11:00:42.361
false,false,5511,5163,348,730,00:00:33.000,2025-04-15 11:00:55.375
false,false,5531,5183,348,477,00:00:33.000,2025-04-15 11:01:27.409
false,false,5536,5187,349,636,00:00:31.000,2025-04-15 11:01:32.417
false,false,5538,5189,349,698,00:00:30.000,2025-04-15 11:01:34.419
false,false,5540,5191,349,759,00:00:31.000,2025-04-15 11:01:36.420
false,false,5544,5195,349,128,00:00:31.000,2025-04-15 11:01:46.426
false,false,5545,5196,349,160,00:00:32.000,2025-04-15 11:01:47.426
false,false,5560,5210,350,635,00:00:32.000,2025-04-15 11:02:02.444
false,false,5561,5211,350,665,00:00:30.000,2025-04-15 11:02:03.445
false,false,5567,5217,350,849,00:00:31.000,2025-04-15 11:02:09.454
false,false,5572,5222,350,1008,00:00:31.000,2025-04-15 11:02:14.458
false,false,5574,5224,350,1071,00:00:30.000,2025-04-15 11:02:16.459
false,false,5579,5229,350,1227,00:00:30.000,2025-04-15 11:02:21.461
false,false,5581,5231,350,1289,00:00:32.000,2025-04-15 11:02:23.463
false,true,5582,5232,350,0,00:00:00.000,2025-04-15 11:02:26.465
false,false,5585,5235,350,98,00:00:33.000,2025-04-15 11:02:33.469
false,true,5590,5240,350,0,00:00:00.000,2025-04-15 11:02:43.480
false,true,5595,5245,350,0,00:00:00.000,2025-04-15 11:02:56.495
false,false,5610,5260,350,220,00:00:31.000,2025-04-15 11:03:22.518
false,true,5687,5331,356,0,00:00:00.000,2025-04-15 11:05:10.639
false,true,5687,5331,356,0,00:00:00.000,2025-04-15 11:05:15.644
false,false,5729,5370,359,532,00:00:33.000,2025-04-15 11:06:21.707
false,false,5615,5265,350,379,00:00:33.000,2025-04-15 11:03:27.528
false,false,5619,5269,350,504,00:00:30.000,2025-04-15 11:03:31.534
false,false,5646,5293,353,1351,00:00:30.000,2025-04-15 11:03:58.559
false,false,5658,5304,354,94,00:00:31.000,2025-04-15 11:04:22.586
false,false,5406,5066,340,1334,00:00:30.000,2025-04-15 10:58:28.222
false,false,5457,5113,344,319,00:00:33.000,2025-04-15 10:59:43.304
false,true,5888,5518,370,0,00:00:00.000,2025-04-15 11:10:35.970
false,false,5927,5555,372,691,00:00:33.000,2025-04-15 11:11:34.025
false,false,5933,5561,372,881,00:00:33.000,2025-04-15 11:11:40.029
false,false,5935,5563,372,945,00:00:31.000,2025-04-15 11:11:42.031
false,true,5935,5563,372,0,00:00:00.000,2025-04-15 11:11:44.032
false,false,5830,5462,368,346,00:00:31.000,2025-04-15 11:09:08.885
false,false,5857,5489,368,472,00:00:31.000,2025-04-15 11:09:41.916
false,false,5863,5494,369,160,00:00:31.000,2025-04-15 11:09:53.933
false,false,5964,5592,372,850,00:00:32.000,2025-04-15 11:12:23.069
false,false,5972,5597,375,124,00:00:30.000,2025-04-15 11:12:37.085
false,false,5976,5600,376,249,00:00:30.000,2025-04-15 11:12:41.090
false,false,5981,5605,376,405,00:00:32.000,2025-04-15 11:12:46.093
false,false,5990,5614,376,690,00:00:31.000,2025-04-15 11:12:55.103
false,false,5994,5618,376,816,00:00:32.000,2025-04-15 11:12:59.105
false,true,5997,5621,376,0,00:00:00.000,2025-04-15 11:13:09.119
false,false,5750,5390,360,287,00:00:33.000,2025-04-15 11:06:54.741
false,false,5753,5393,360,380,00:00:33.000,2025-04-15 11:06:57.742
false,true,5761,5400,361,0,00:00:00.000,2025-04-15 11:07:08.756
false,true,5764,5402,362,0,00:00:00.000,2025-04-15 11:07:21.771
false,true,5774,5411,363,0,00:00:00.000,2025-04-15 11:07:38.788
false,false,5803,5437,366,256,00:00:33.000,2025-04-15 11:08:17.829
false,false,6005,5629,376,31,00:00:31.000,2025-04-15 11:13:28.137
false,false,6016,5639,377,258,00:00:33.000,2025-04-15 11:13:51.160
false,false,6029,5651,378,664,00:00:31.000,2025-04-15 11:14:04.173
false,true,6035,5657,378,0,00:00:00.000,2025-04-15 11:14:20.191
false,true,6041,5663,378,0,00:00:00.000,2025-04-15 11:14:31.198
false,true,6065,5687,378,0,00:00:00.000,2025-04-15 11:14:59.226
false,false,6230,5843,387,223,00:00:32.000,2025-04-15 11:18:31.445
false,false,6235,5848,387,91,00:00:31.000,2025-04-15 11:18:42.457
false,false,6237,5850,387,153,00:00:31.000,2025-04-15 11:18:44.461
false,false,6241,5854,387,283,00:00:32.000,2025-04-15 11:18:48.465
false,false,6247,5860,387,475,00:00:32.000,2025-04-15 11:18:54.474
false,false,6249,5862,387,537,00:00:30.000,2025-04-15 11:18:56.476
false,false,6276,5889,387,94,00:00:33.000,2025-04-15 11:19:35.518
false,true,6280,5893,387,0,00:00:00.000,2025-04-15 11:19:41.522
false,false,6281,5894,387,31,00:00:31.000,2025-04-15 11:19:46.526
false,true,6077,5698,379,0,00:00:00.000,2025-04-15 11:15:19.249
false,false,6088,5709,379,322,00:00:33.000,2025-04-15 11:15:39.273
false,false,6093,5714,379,480,00:00:31.000,2025-04-15 11:15:44.279
false,true,6093,5714,379,0,00:00:00.000,2025-04-15 11:15:49.283
false,false,6098,5719,379,157,00:00:33.000,2025-04-15 11:15:55.288
false,false,6115,5736,379,129,00:00:33.000,2025-04-15 11:16:18.313
false,true,6185,5801,384,0,00:00:00.000,2025-04-15 11:17:31.384
false,true,6185,5801,384,0,00:00:00.000,2025-04-15 11:17:32.385
false,true,6185,5801,384,0,00:00:00.000,2025-04-15 11:17:34.385
false,false,6219,5832,387,722,00:00:30.000,2025-04-15 11:18:14.429
false,false,6222,5835,387,814,00:00:31.000,2025-04-15 11:18:17.433
false,false,6298,5910,388,188,00:00:31.000,2025-04-15 11:20:09.549
false,false,6315,5927,388,434,00:00:30.000,2025-04-15 11:20:38.577
false,false,6320,5931,389,591,00:00:30.000,2025-04-15 11:20:43.581
false,false,6339,5949,390,124,00:00:30.000,2025-04-15 11:21:08.607
false,false,6351,5960,391,497,00:00:30.000,2025-04-15 11:21:20.619
false,false,6371,5980,391,1126,00:00:33.000,2025-04-15 11:21:40.637
false,false,6592,6187,405,123,00:00:33.000,2025-04-15 11:27:15.993
false,false,6594,6189,405,185,00:00:30.000,2025-04-15 11:27:17.994
false,false,6620,6214,406,93,00:00:31.000,2025-04-15 11:28:08.041
false,false,6630,6223,407,410,00:00:32.000,2025-04-15 11:28:18.052
false,false,6513,6114,399,480,00:00:33.000,2025-04-15 11:25:32.888
false,false,6525,6126,399,856,00:00:30.000,2025-04-15 11:25:44.904
false,false,6533,6134,399,1111,00:00:32.000,2025-04-15 11:25:52.912
false,true,6551,6148,403,0,00:00:00.000,2025-04-15 11:26:16.937
false,false,6572,6168,404,122,00:00:32.000,2025-04-15 11:26:43.961
false,false,6573,6169,404,154,00:00:32.000,2025-04-15 11:26:44.962
false,false,6406,6013,393,219,00:00:31.000,2025-04-15 11:22:45.709
false,false,6409,6016,393,312,00:00:33.000,2025-04-15 11:22:48.714
false,false,6415,6022,393,503,00:00:33.000,2025-04-15 11:22:54.720
false,true,6415,6022,393,0,00:00:00.000,2025-04-15 11:22:59.726
false,true,6416,6023,393,0,00:00:00.000,2025-04-15 11:23:03.729
false,true,6425,6032,393,0,00:00:00.000,2025-04-15 11:23:19.742
false,false,6427,6034,393,65,00:00:32.000,2025-04-15 11:23:24.748
false,false,6428,6035,393,97,00:00:32.000,2025-04-15 11:23:25.749
false,true,6429,6036,393,0,00:00:00.000,2025-04-15 11:23:40.769
false,false,6471,6075,396,95,00:00:32.000,2025-04-15 11:24:44.836
false,false,6479,6082,397,348,00:00:33.000,2025-04-15 11:24:52.845
false,false,6483,6086,397,473,00:00:33.000,2025-04-15 11:24:56.850
false,false,6638,6230,408,156,00:00:30.000,2025-04-15 11:28:38.068
false,true,6659,6248,411,0,00:00:00.000,2025-04-15 11:29:03.093
false,true,6659,6248,411,0,00:00:00.000,2025-04-15 11:29:09.099
false,false,6672,6260,412,128,00:00:31.000,2025-04-15 11:29:36.125
false,true,6672,6260,412,0,00:00:00.000,2025-04-15 11:29:38.127
false,true,6838,6419,419,0,00:00:00.000,2025-04-15 11:33:37.361
false,true,6842,6422,420,0,00:00:00.000,2025-04-15 11:33:50.375
false,false,6848,6428,420,187,00:00:31.000,2025-04-15 11:33:56.381
false,false,6772,6355,417,2402,00:00:33.000,2025-04-15 11:31:34.239
false,false,6774,6357,417,2466,00:00:31.000,2025-04-15 11:31:36.239
false,false,6895,6473,422,62,00:00:31.000,2025-04-15 11:35:19.471
false,false,6901,6479,422,251,00:00:30.000,2025-04-15 11:35:25.477
false,true,6903,6481,422,0,00:00:00.000,2025-04-15 11:35:29.481
false,false,6935,6513,422,1013,00:00:31.000,2025-04-15 11:36:05.520
false,false,6943,6521,422,1266,00:00:31.000,2025-04-15 11:36:13.529
false,false,6948,6525,423,1423,00:00:33.000,2025-04-15 11:36:18.532
false,false,6957,6532,425,1707,00:00:31.000,2025-04-15 11:36:27.542
false,true,7048,6618,430,0,00:00:00.000,2025-04-15 11:38:31.670
false,false,7049,6619,430,31,00:00:31.000,2025-04-15 11:38:35.673
false,false,7056,6626,430,252,00:00:33.000,2025-04-15 11:38:42.679
false,false,7070,6639,431,697,00:00:31.000,2025-04-15 11:38:56.689
false,false,7104,6672,432,912,00:00:30.000,2025-04-15 11:39:36.739
false,false,6812,6393,419,125,00:00:30.000,2025-04-15 11:32:44.303
false,false,6813,6394,419,156,00:00:31.000,2025-04-15 11:32:45.304
false,true,6819,6400,419,0,00:00:00.000,2025-04-15 11:32:53.314
false,false,6824,6405,419,127,00:00:33.000,2025-04-15 11:33:08.333
false,false,6831,6412,419,345,00:00:31.000,2025-04-15 11:33:15.341
false,false,6836,6417,419,99,00:00:33.000,2025-04-15 11:33:26.351
false,false,6969,6543,426,30,00:00:30.000,2025-04-15 11:37:03.577
false,false,6978,6552,426,317,00:00:31.000,2025-04-15 11:37:12.587
false,false,6985,6559,426,538,00:00:33.000,2025-04-15 11:37:19.592
false,false,6993,6566,427,33,00:00:33.000,2025-04-15 11:37:33.606
false,false,6998,6571,427,191,00:00:32.000,2025-04-15 11:37:38.611
false,false,7040,6610,430,1516,00:00:31.000,2025-04-15 11:38:20.655
false,false,7045,6615,430,1675,00:00:32.000,2025-04-15 11:38:25.662
false,false,7145,6710,435,2207,00:00:30.000,2025-04-15 11:40:17.786
false,false,7164,6726,438,600,00:00:32.000,2025-04-15 11:40:42.815
false,false,7165,6726,439,631,00:00:31.000,2025-04-15 11:40:43.816
false,false,7178,6738,440,222,00:00:31.000,2025-04-15 11:41:08.842
false,true,7202,6760,442,0,00:00:00.000,2025-04-15 11:41:34.871
false,false,7212,6768,444,314,00:00:30.000,2025-04-15 11:41:48.887
false,false,7358,6905,453,96,00:00:33.000,2025-04-15 11:45:21.110
false,false,7368,6914,454,412,00:00:30.000,2025-04-15 11:45:31.120
false,false,7376,6920,456,666,00:00:30.000,2025-04-15 11:45:39.127
false,true,7379,6923,456,0,00:00:00.000,2025-04-15 11:45:48.136
false,false,7389,6931,458,315,00:00:30.000,2025-04-15 11:45:58.148
false,false,7391,6933,458,377,00:00:31.000,2025-04-15 11:46:00.149
false,true,7404,6946,458,0,00:00:00.000,2025-04-15 11:46:19.169
false,false,7215,6770,445,60,00:00:30.000,2025-04-15 11:41:57.895
false,true,7216,6771,445,0,00:00:00.000,2025-04-15 11:42:03.902
false,false,7223,6778,445,123,00:00:31.000,2025-04-15 11:42:17.919
false,false,7239,6793,446,627,00:00:33.000,2025-04-15 11:42:33.939
false,true,7254,6807,447,0,00:00:00.000,2025-04-15 11:42:58.960
false,false,7440,6980,460,566,00:00:30.000,2025-04-15 11:47:19.232
false,false,7474,7012,462,246,00:00:30.000,2025-04-15 11:48:11.293
false,false,7499,7036,463,126,00:00:31.000,2025-04-15 11:48:48.341
false,false,7510,7046,464,472,00:00:30.000,2025-04-15 11:48:59.351
false,false,7511,7047,464,502,00:00:30.000,2025-04-15 11:49:00.352
false,false,7519,7054,465,758,00:00:31.000,2025-04-15 11:49:08.361
false,false,7533,7068,465,163,00:00:33.000,2025-04-15 11:49:28.374
false,false,7535,7070,465,226,00:00:31.000,2025-04-15 11:49:30.377
false,false,7539,7074,465,349,00:00:30.000,2025-04-15 11:49:34.383
false,true,7545,7080,465,0,00:00:00.000,2025-04-15 11:49:50.400
false,false,7554,7088,466,286,00:00:33.000,2025-04-15 11:50:01.408
false,false,7286,6838,448,185,00:00:31.000,2025-04-15 11:43:51.015
false,false,7302,6853,449,687,00:00:30.000,2025-04-15 11:44:07.028
false,false,7310,6861,449,939,00:00:31.000,2025-04-15 11:44:15.036
false,false,7315,6866,449,1095,00:00:31.000,2025-04-15 11:44:20.041
false,true,7317,6868,449,0,00:00:00.000,2025-04-15 11:44:26.049
false,false,7568,7102,466,282,00:00:32.000,2025-04-15 11:50:21.428
false,true,7570,7104,466,0,00:00:00.000,2025-04-15 11:50:28.433
false,false,7628,7161,467,1505,00:00:32.000,2025-04-15 11:51:33.492
false,false,7719,7251,468,94,00:00:31.000,2025-04-15 11:53:34.623
false,false,7773,7303,470,127,00:00:32.000,2025-04-15 11:54:46.709
false,false,7784,7314,470,309,00:00:32.000,2025-04-15 11:55:03.723
false,false,7681,7213,468,476,00:00:31.000,2025-04-15 11:52:32.558
false,false,7701,7233,468,33,00:00:33.000,2025-04-15 11:53:10.599
false,false,7708,7240,468,260,00:00:33.000,2025-04-15 11:53:17.605
false,false,7713,7245,468,418,00:00:33.000,2025-04-15 11:53:22.610
false,true,7801,7331,470,0,00:00:00.000,2025-04-15 11:55:28.754
false,true,7801,7331,470,0,00:00:00.000,2025-04-15 11:55:29.755
false,true,7823,7350,473,0,00:00:00.000,2025-04-15 11:56:10.798
false,true,7824,7351,473,0,00:00:00.000,2025-04-15 11:56:17.806
false,false,7827,7354,473,99,00:00:33.000,2025-04-15 11:56:22.811
false,true,7828,7355,473,0,00:00:00.000,2025-04-15 11:56:27.818
false,false,7833,7360,473,124,00:00:32.000,2025-04-15 11:56:40.829
false,false,7864,7390,474,622,00:00:33.000,2025-04-15 11:57:17.869
false,false,7866,7392,474,687,00:00:33.000,2025-04-15 11:57:19.872
false,false,7873,7399,474,93,00:00:30.000,2025-04-15 11:57:38.900
false,false,7879,7405,474,286,00:00:30.000,2025-04-15 11:57:44.907
false,false,7894,7420,474,764,00:00:33.000,2025-04-15 11:57:59.924
false,false,7895,7421,474,796,00:00:32.000,2025-04-15 11:58:00.925
false,false,7903,7429,474,1049,00:00:32.000,2025-04-15 11:58:08.933
false,false,7909,7435,474,1234,00:00:32.000,2025-04-15 11:58:14.939
false,false,7912,7438,474,1331,00:00:33.000,2025-04-15 11:58:17.943
false,false,8014,7536,478,658,00:00:32.000,2025-04-15 12:00:30.077
false,true,8035,7556,479,0,00:00:00.000,2025-04-15 12:01:09.112
false,false,5252,4925,327,661,00:00:30.000,2025-04-15 10:55:18.041
false,false,5288,4959,329,758,00:00:32.000,2025-04-15 10:56:00.085
false,false,5317,4982,335,444,00:00:32.000,2025-04-15 10:56:41.123
false,true,4962,4657,305,0,00:00:00.000,2025-04-15 10:49:01.656
false,false,4991,4684,307,508,00:00:30.000,2025-04-15 10:49:38.698
false,true,5014,4705,309,0,00:00:00.000,2025-04-15 10:50:14.744
false,true,5014,4705,309,0,00:00:00.000,2025-04-15 10:50:15.745
false,true,5014,4705,309,0,00:00:00.000,2025-04-15 10:50:16.746
false,false,5024,4715,309,314,00:00:31.000,2025-04-15 10:50:29.761
false,false,5025,4716,309,346,00:00:32.000,2025-04-15 10:50:30.762
false,false,5040,4730,310,814,00:00:30.000,2025-04-15 10:50:45.774
false,false,5041,4730,311,844,00:00:30.000,2025-04-15 10:50:46.776
false,false,5075,4760,315,1909,00:00:32.000,2025-04-15 10:51:20.813
false,true,5079,4763,316,0,00:00:00.000,2025-04-15 10:51:26.819
false,false,5169,4848,321,657,00:00:30.000,2025-04-15 10:53:30.937
false,false,5184,4861,323,1134,00:00:33.000,2025-04-15 10:53:45.951
false,false,5213,4889,324,64,00:00:32.000,2025-04-15 10:54:32.997
false,false,5218,4893,325,218,00:00:30.000,2025-04-15 10:54:38.001
false,false,5475,5131,344,60,00:00:30.000,2025-04-15 11:00:13.331
false,false,5477,5133,344,122,00:00:32.000,2025-04-15 11:00:15.333
false,true,5488,5144,344,0,00:00:00.000,2025-04-15 11:00:31.349
false,false,5491,5147,344,96,00:00:33.000,2025-04-15 11:00:35.356
false,false,5494,5150,344,192,00:00:32.000,2025-04-15 11:00:38.358
false,false,5499,5154,345,349,00:00:31.000,2025-04-15 11:00:43.363
false,false,5503,5157,346,476,00:00:30.000,2025-04-15 11:00:47.367
false,false,5507,5160,347,601,00:00:31.000,2025-04-15 11:00:51.372
false,false,5510,5162,348,697,00:00:33.000,2025-04-15 11:00:54.375
false,true,5511,5163,348,0,00:00:00.000,2025-04-15 11:01:01.382
false,false,5512,5164,348,31,00:00:31.000,2025-04-15 11:01:02.383
false,true,5516,5168,348,0,00:00:00.000,2025-04-15 11:01:08.391
false,true,5516,5168,348,0,00:00:00.000,2025-04-15 11:01:11.394
false,false,5535,5186,349,605,00:00:32.000,2025-04-15 11:01:31.414
false,false,5549,5200,349,288,00:00:30.000,2025-04-15 11:01:51.431
false,false,5584,5234,350,65,00:00:32.000,2025-04-15 11:02:32.469
false,false,5589,5239,350,224,00:00:31.000,2025-04-15 11:02:37.474
false,true,5590,5240,350,0,00:00:00.000,2025-04-15 11:02:42.480
false,true,5595,5245,350,0,00:00:00.000,2025-04-15 11:02:55.494
false,false,5597,5247,350,64,00:00:31.000,2025-04-15 11:03:03.501
false,false,5690,5334,356,94,00:00:31.000,2025-04-15 11:05:18.646
false,true,5701,5345,356,0,00:00:00.000,2025-04-15 11:05:33.661
false,true,5701,5345,356,0,00:00:00.000,2025-04-15 11:05:38.665
false,false,5714,5357,357,63,00:00:30.000,2025-04-15 11:06:06.694
false,false,5721,5364,357,278,00:00:30.000,2025-04-15 11:06:13.702
false,false,5621,5271,350,564,00:00:30.000,2025-04-15 11:03:33.535
false,false,5628,5278,350,782,00:00:30.000,2025-04-15 11:03:40.541
false,false,5632,5282,350,908,00:00:31.000,2025-04-15 11:03:44.545
false,false,5641,5288,353,1196,00:00:32.000,2025-04-15 11:03:53.554
false,false,5643,5290,353,1258,00:00:32.000,2025-04-15 11:03:55.555
false,false,5649,5296,353,1448,00:00:33.000,2025-04-15 11:04:01.562
false,true,5662,5307,355,0,00:00:00.000,2025-04-15 11:04:31.593
false,false,5663,5308,355,33,00:00:33.000,2025-04-15 11:04:33.594
false,false,5671,5315,356,258,00:00:33.000,2025-04-15 11:04:47.611
false,true,5406,5066,340,0,00:00:00.000,2025-04-15 10:58:29.223
false,true,5406,5066,340,0,00:00:00.000,2025-04-15 10:58:30.225
false,false,5425,5083,342,30,00:00:30.000,2025-04-15 10:58:59.261
false,false,5428,5086,342,123,00:00:30.000,2025-04-15 10:59:02.265
false,false,5436,5093,343,30,00:00:30.000,2025-04-15 10:59:16.276
false,false,5444,5101,343,283,00:00:30.000,2025-04-15 10:59:24.283
false,false,5446,5103,343,348,00:00:33.000,2025-04-15 10:59:26.285
false,false,5458,5114,344,349,00:00:30.000,2025-04-15 10:59:44.304
false,false,5465,5121,344,572,00:00:31.000,2025-04-15 10:59:51.311
false,true,5470,5126,344,0,00:00:00.000,2025-04-15 10:59:59.317
false,false,5881,5512,369,721,00:00:32.000,2025-04-15 11:10:11.949
false,false,5915,5544,371,313,00:00:30.000,2025-04-15 11:11:22.017
false,false,5934,5562,372,914,00:00:33.000,2025-04-15 11:11:41.030
false,true,5819,5452,367,0,00:00:00.000,2025-04-15 11:08:52.869
false,false,5828,5460,368,284,00:00:31.000,2025-04-15 11:09:06.882
false,false,5862,5493,369,129,00:00:33.000,2025-04-15 11:09:52.931
false,false,5947,5575,372,313,00:00:31.000,2025-04-15 11:12:06.051
false,false,5971,5596,375,94,00:00:31.000,2025-04-15 11:12:36.084
false,false,5973,5598,375,156,00:00:32.000,2025-04-15 11:12:38.086
false,false,5975,5599,376,219,00:00:32.000,2025-04-15 11:12:40.088
false,true,5996,5620,376,0,00:00:00.000,2025-04-15 11:13:05.114
false,false,5749,5389,360,254,00:00:31.000,2025-04-15 11:06:53.740
false,false,5755,5395,360,442,00:00:30.000,2025-04-15 11:06:59.745
false,true,5764,5402,362,0,00:00:00.000,2025-04-15 11:07:17.764
false,false,5775,5411,364,31,00:00:31.000,2025-04-15 11:07:43.795
false,false,5807,5441,366,380,00:00:33.000,2025-04-15 11:08:21.834
false,false,6007,5631,376,32,00:00:32.000,2025-04-15 11:13:36.143
false,true,6008,5632,376,0,00:00:00.000,2025-04-15 11:13:43.152
false,false,6020,5642,378,384,00:00:31.000,2025-04-15 11:13:55.167
false,true,6041,5663,378,0,00:00:00.000,2025-04-15 11:14:34.200
false,false,6232,5845,387,283,00:00:30.000,2025-04-15 11:18:33.448
false,false,6251,5864,387,599,00:00:31.000,2025-04-15 11:18:58.478
false,false,6253,5866,387,659,00:00:30.000,2025-04-15 11:19:00.479
false,false,6259,5872,387,847,00:00:32.000,2025-04-15 11:19:06.487
false,false,6262,5875,387,63,00:00:30.000,2025-04-15 11:19:15.492
false,false,6266,5879,387,189,00:00:31.000,2025-04-15 11:19:19.498
false,false,6272,5885,387,375,00:00:31.000,2025-04-15 11:19:25.506
false,false,6296,5908,388,125,00:00:30.000,2025-04-15 11:20:07.547
false,false,6069,5691,378,126,00:00:33.000,2025-04-15 11:15:08.235
false,false,6091,5712,379,416,00:00:30.000,2025-04-15 11:15:42.275
false,true,6093,5714,379,0,00:00:00.000,2025-04-15 11:15:45.279
false,false,6112,5733,379,32,00:00:32.000,2025-04-15 11:16:15.311
false,false,6114,5735,379,96,00:00:31.000,2025-04-15 11:16:17.312
false,false,6119,5740,379,259,00:00:33.000,2025-04-15 11:16:22.317
false,false,6129,5749,380,573,00:00:33.000,2025-04-15 11:16:32.327
false,false,6164,5783,381,1679,00:00:33.000,2025-04-15 11:17:07.361
false,false,6172,5789,383,1925,00:00:31.000,2025-04-15 11:17:15.367
false,false,6189,5805,384,128,00:00:33.000,2025-04-15 11:17:38.392
false,false,6190,5806,384,160,00:00:32.000,2025-04-15 11:17:39.393
false,false,6202,5817,385,186,00:00:31.000,2025-04-15 11:17:57.412
false,false,6215,5828,387,598,00:00:30.000,2025-04-15 11:18:10.425
false,false,6225,5838,387,63,00:00:33.000,2025-04-15 11:18:26.441
false,false,6300,5912,388,33,00:00:33.000,2025-04-15 11:20:17.556
false,true,6301,5913,388,0,00:00:00.000,2025-04-15 11:20:20.559
false,true,6301,5913,388,0,00:00:00.000,2025-04-15 11:20:22.561
false,false,6346,5955,391,343,00:00:31.000,2025-04-15 11:21:15.617
false,false,6358,5967,391,722,00:00:32.000,2025-04-15 11:21:27.623
false,true,6373,5982,391,0,00:00:00.000,2025-04-15 11:21:47.644
false,false,6587,6182,405,594,00:00:30.000,2025-04-15 11:26:58.977
false,false,6608,6202,406,281,00:00:31.000,2025-04-15 11:27:44.018
false,false,6611,6205,406,374,00:00:30.000,2025-04-15 11:27:47.020
false,false,6612,6206,406,31,00:00:31.000,2025-04-15 11:27:54.028
false,false,6615,6209,406,128,00:00:32.000,2025-04-15 11:27:57.032
false,true,6498,6100,398,0,00:00:00.000,2025-04-15 11:25:12.867
false,true,6568,6164,404,0,00:00:00.000,2025-04-15 11:26:36.954
false,false,6378,5987,391,158,00:00:33.000,2025-04-15 11:21:53.647
false,true,6391,6000,391,0,00:00:00.000,2025-04-15 11:22:16.674
false,false,6393,6002,391,62,00:00:31.000,2025-04-15 11:22:20.680
false,false,6402,6010,392,94,00:00:31.000,2025-04-15 11:22:41.704
false,true,6415,6022,393,0,00:00:00.000,2025-04-15 11:23:00.727
false,true,6416,6023,393,0,00:00:00.000,2025-04-15 11:23:05.730
false,true,6428,6035,393,0,00:00:00.000,2025-04-15 11:23:35.764
false,true,6429,6036,393,0,00:00:00.000,2025-04-15 11:23:39.767
false,false,6439,6045,394,312,00:00:30.000,2025-04-15 11:23:54.784
false,false,6449,6055,394,64,00:00:31.000,2025-04-15 11:24:10.801
false,true,6463,6068,395,0,00:00:00.000,2025-04-15 11:24:28.823
false,true,6633,6225,408,0,00:00:00.000,2025-04-15 11:28:30.061
false,false,6637,6229,408,126,00:00:31.000,2025-04-15 11:28:37.066
false,false,6662,6250,412,93,00:00:30.000,2025-04-15 11:29:14.105
false,false,6684,6270,414,382,00:00:30.000,2025-04-15 11:29:54.145
false,true,6838,6419,419,0,00:00:00.000,2025-04-15 11:33:36.360
false,true,6842,6422,420,0,00:00:00.000,2025-04-15 11:33:45.370
false,true,6855,6435,420,0,00:00:00.000,2025-04-15 11:34:13.399
false,false,6863,6443,420,252,00:00:30.000,2025-04-15 11:34:23.412
false,true,6882,6460,422,0,00:00:00.000,2025-04-15 11:34:54.446
false,true,6891,6469,422,0,00:00:00.000,2025-04-15 11:35:04.454
false,true,6891,6469,422,0,00:00:00.000,2025-04-15 11:35:06.457
false,true,6891,6469,422,0,00:00:00.000,2025-04-15 11:35:07.458
false,false,6716,6301,415,628,00:00:31.000,2025-04-15 11:30:38.184
false,false,6718,6303,415,691,00:00:31.000,2025-04-15 11:30:40.185
false,false,6719,6304,415,722,00:00:31.000,2025-04-15 11:30:41.186
false,false,6746,6331,415,1576,00:00:30.000,2025-04-15 11:31:08.214
false,false,6777,6360,417,2560,00:00:32.000,2025-04-15 11:31:39.244
false,false,6778,6360,418,2591,00:00:31.000,2025-04-15 11:31:40.245
false,true,6893,6471,422,0,00:00:00.000,2025-04-15 11:35:14.466
false,false,6894,6472,422,31,00:00:31.000,2025-04-15 11:35:18.470
false,true,6903,6481,422,0,00:00:00.000,2025-04-15 11:35:33.486
false,false,6905,6483,422,64,00:00:31.000,2025-04-15 11:35:35.487
false,false,6946,6523,423,1359,00:00:31.000,2025-04-15 11:36:16.530
false,false,6947,6524,423,1390,00:00:31.000,2025-04-15 11:36:17.530
false,false,7060,6630,430,380,00:00:32.000,2025-04-15 11:38:46.681
false,false,7061,6630,431,410,00:00:30.000,2025-04-15 11:38:47.682
false,false,7062,6631,431,441,00:00:31.000,2025-04-15 11:38:48.683
false,false,7076,6645,431,32,00:00:32.000,2025-04-15 11:39:08.700
false,false,7095,6663,432,630,00:00:31.000,2025-04-15 11:39:27.727
false,false,7111,6679,432,1137,00:00:33.000,2025-04-15 11:39:43.749
false,true,6786,6367,419,0,00:00:00.000,2025-04-15 11:31:53.253
false,false,6788,6369,419,62,00:00:30.000,2025-04-15 11:31:56.257
false,false,6819,6400,419,342,00:00:31.000,2025-04-15 11:32:51.311
false,true,6968,6542,426,0,00:00:00.000,2025-04-15 11:36:58.571
false,false,6984,6558,426,505,00:00:33.000,2025-04-15 11:37:18.592
false,false,6989,6563,426,663,00:00:32.000,2025-04-15 11:37:23.597
false,false,6992,6566,426,759,00:00:31.000,2025-04-15 11:37:26.599
false,false,7027,6599,428,1111,00:00:33.000,2025-04-15 11:38:07.642
false,false,7031,6601,430,1238,00:00:32.000,2025-04-15 11:38:11.647
false,false,7037,6607,430,1422,00:00:30.000,2025-04-15 11:38:17.652
false,false,7047,6617,430,1738,00:00:31.000,2025-04-15 11:38:27.665
false,false,7148,6712,436,95,00:00:32.000,2025-04-15 11:40:26.796
false,false,7160,6722,438,473,00:00:32.000,2025-04-15 11:40:38.810
false,true,7166,6727,439,0,00:00:00.000,2025-04-15 11:40:46.819
false,true,7166,6727,439,0,00:00:00.000,2025-04-15 11:40:48.821
false,false,7176,6736,440,158,00:00:30.000,2025-04-15 11:41:06.839
false,false,7184,6743,441,410,00:00:30.000,2025-04-15 11:41:14.849
false,true,7202,6760,442,0,00:00:00.000,2025-04-15 11:41:37.873
false,false,7205,6762,443,92,00:00:30.000,2025-04-15 11:41:41.878
false,false,7375,6919,456,636,00:00:32.000,2025-04-15 11:45:38.125
false,true,7379,6923,456,0,00:00:00.000,2025-04-15 11:45:44.132
false,false,7400,6942,458,657,00:00:30.000,2025-04-15 11:46:09.157
false,false,7413,6954,459,216,00:00:30.000,2025-04-15 11:46:40.191
false,true,7213,6768,445,0,00:00:00.000,2025-04-15 11:41:51.888
false,false,7224,6779,445,155,00:00:32.000,2025-04-15 11:42:18.920
false,false,7240,6793,447,660,00:00:33.000,2025-04-15 11:42:34.939
false,false,7247,6800,447,154,00:00:30.000,2025-04-15 11:42:47.948
false,true,7254,6807,447,0,00:00:00.000,2025-04-15 11:42:57.959
false,false,7255,6808,447,31,00:00:31.000,2025-04-15 11:43:01.963
false,false,7262,6815,447,250,00:00:31.000,2025-04-15 11:43:08.970
false,false,7263,6816,447,282,00:00:32.000,2025-04-15 11:43:09.971
false,false,7266,6819,447,373,00:00:30.000,2025-04-15 11:43:12.974
false,false,7423,6964,459,31,00:00:31.000,2025-04-15 11:47:02.211
false,false,7426,6967,459,125,00:00:31.000,2025-04-15 11:47:05.215
false,false,7427,6968,459,155,00:00:30.000,2025-04-15 11:47:06.217
false,true,7466,7006,460,0,00:00:00.000,2025-04-15 11:48:01.284
false,false,7485,7022,463,593,00:00:32.000,2025-04-15 11:48:22.306
false,false,7490,7027,463,32,00:00:32.000,2025-04-15 11:48:33.319
false,false,7509,7045,464,442,00:00:33.000,2025-04-15 11:48:58.350
false,false,7517,7052,465,694,00:00:33.000,2025-04-15 11:49:06.360
false,false,7526,7061,465,979,00:00:31.000,2025-04-15 11:49:15.365
false,false,7527,7062,465,1012,00:00:33.000,2025-04-15 11:49:16.365
false,true,7545,7080,465,0,00:00:00.000,2025-04-15 11:49:47.398
false,false,7547,7082,465,62,00:00:32.000,2025-04-15 11:49:54.403
false,true,7277,6829,448,0,00:00:00.000,2025-04-15 11:43:36.001
false,false,7304,6855,449,750,00:00:32.000,2025-04-15 11:44:09.030
false,false,7324,6875,449,218,00:00:32.000,2025-04-15 11:44:35.059
false,false,7343,6893,450,443,00:00:30.000,2025-04-15 11:45:00.089
false,true,7559,7093,466,0,00:00:00.000,2025-04-15 11:50:10.419
false,false,7573,7107,466,95,00:00:31.000,2025-04-15 11:50:32.437
false,false,7576,7110,466,190,00:00:32.000,2025-04-15 11:50:35.441
false,false,7592,7125,467,379,00:00:32.000,2025-04-15 11:50:57.456
false,false,7606,7139,467,817,00:00:30.000,2025-04-15 11:51:11.468
false,false,7611,7144,467,972,00:00:32.000,2025-04-15 11:51:16.474
false,false,7635,7168,467,1724,00:00:30.000,2025-04-15 11:51:40.498
false,false,7636,7169,467,1757,00:00:33.000,2025-04-15 11:51:41.498
false,false,7731,7263,468,468,00:00:30.000,2025-04-15 11:53:46.639
false,false,7744,7275,469,882,00:00:30.000,2025-04-15 11:53:59.656
false,false,7759,7289,470,1356,00:00:32.000,2025-04-15 11:54:14.674
false,true,7774,7304,470,0,00:00:00.000,2025-04-15 11:54:48.710
false,false,7649,7182,467,2165,00:00:32.000,2025-04-15 11:51:54.511
false,false,7651,7184,467,2230,00:00:33.000,2025-04-15 11:51:56.512
false,false,7653,7186,467,2292,00:00:32.000,2025-04-15 11:51:58.515
false,false,7675,7207,468,289,00:00:32.000,2025-04-15 11:52:26.550
false,false,7689,7221,468,195,00:00:31.000,2025-04-15 11:52:46.573
false,false,7698,7230,468,253,00:00:33.000,2025-04-15 11:53:01.592
false,false,7712,7244,468,385,00:00:31.000,2025-04-15 11:53:21.609
false,false,7814,7344,470,94,00:00:33.000,2025-04-15 11:55:51.778
false,false,7818,7347,471,33,00:00:33.000,2025-04-15 11:56:01.788
false,false,7839,7366,473,318,00:00:32.000,2025-04-15 11:56:46.836
false,true,7870,7396,474,0,00:00:00.000,2025-04-15 11:57:26.885
false,false,7889,7415,474,604,00:00:33.000,2025-04-15 11:57:54.919
false,false,7902,7428,474,1017,00:00:30.000,2025-04-15 11:58:07.931
false,false,8005,7527,478,373,00:00:31.000,2025-04-15 12:00:21.065
false,true,8017,7538,479,0,00:00:00.000,2025-04-15 12:00:42.086
false,false,8019,7540,479,60,00:00:30.000,2025-04-15 12:00:47.090
false,false,8024,7545,479,216,00:00:33.000,2025-04-15 12:00:52.097
false,false,8039,7560,479,126,00:00:33.000,2025-04-15 12:01:13.115
false,false,5248,4921,327,536,00:00:31.000,2025-04-15 10:55:14.038
false,true,5264,4937,327,0,00:00:00.000,2025-04-15 10:55:32.056
false,false,5270,4942,328,189,00:00:31.000,2025-04-15 10:55:42.066
false,false,5271,4943,328,221,00:00:32.000,2025-04-15 10:55:43.067
false,false,5289,4959,330,789,00:00:31.000,2025-04-15 10:56:01.085
false,false,5291,4961,330,853,00:00:31.000,2025-04-15 10:56:03.087
false,false,5292,4962,330,886,00:00:33.000,2025-04-15 10:56:04.087
false,false,5294,4964,330,950,00:00:31.000,2025-04-15 10:56:06.090
false,true,5303,4972,331,0,00:00:00.000,2025-04-15 10:56:26.108
false,true,4938,4634,304,0,00:00:00.000,2025-04-15 10:48:26.623
false,false,4974,4669,305,381,00:00:31.000,2025-04-15 10:49:15.672
false,false,4989,4682,307,447,00:00:32.000,2025-04-15 10:49:36.695
false,false,5011,4702,309,31,00:00:31.000,2025-04-15 10:50:10.740
false,false,5050,4738,312,1128,00:00:32.000,2025-04-15 10:50:55.784
false,false,5065,4751,314,1597,00:00:31.000,2025-04-15 10:51:10.803
false,false,5085,4769,316,63,00:00:33.000,2025-04-15 10:51:42.838
false,false,5171,4850,321,720,00:00:31.000,2025-04-15 10:53:32.939
false,false,5183,4860,323,1101,00:00:32.000,2025-04-15 10:53:44.951
false,false,5186,4863,323,1197,00:00:31.000,2025-04-15 10:53:47.953
false,false,5200,4876,324,407,00:00:31.000,2025-04-15 10:54:07.972
false,true,5206,4882,324,0,00:00:00.000,2025-04-15 10:54:19.984
false,false,5210,4886,324,127,00:00:32.000,2025-04-15 10:54:23.989
false,true,5211,4887,324,0,00:00:00.000,2025-04-15 10:54:25.991
false,true,5211,4887,324,0,00:00:00.000,2025-04-15 10:54:26.992
false,true,5211,4887,324,0,00:00:00.000,2025-04-15 10:54:29.995
false,true,5473,5129,344,0,00:00:00.000,2025-04-15 11:00:07.323
false,false,5484,5140,344,344,00:00:33.000,2025-04-15 11:00:22.342
false,false,5492,5148,344,128,00:00:32.000,2025-04-15 11:00:36.357
false,false,5493,5149,344,160,00:00:32.000,2025-04-15 11:00:37.357
false,false,5520,5172,348,128,00:00:33.000,2025-04-15 11:01:16.397
false,false,5522,5174,348,191,00:00:32.000,2025-04-15 11:01:18.400
false,false,5539,5190,349,728,00:00:30.000,2025-04-15 11:01:35.420
false,false,5570,5220,350,944,00:00:33.000,2025-04-15 11:02:12.457
false,true,5582,5232,350,0,00:00:00.000,2025-04-15 11:02:28.466
false,false,5603,5253,350,252,00:00:30.000,2025-04-15 11:03:09.507
false,true,5685,5329,356,0,00:00:00.000,2025-04-15 11:05:07.637
false,false,5689,5333,356,63,00:00:32.000,2025-04-15 11:05:17.645
false,false,5696,5340,356,285,00:00:32.000,2025-04-15 11:05:24.653
false,false,5699,5343,356,379,00:00:32.000,2025-04-15 11:05:27.656
false,false,5702,5346,356,31,00:00:31.000,2025-04-15 11:05:42.670
false,true,5712,5355,357,0,00:00:00.000,2025-04-15 11:05:59.690
false,true,5712,5355,357,0,00:00:00.000,2025-04-15 11:06:00.691
false,true,5741,5381,360,0,00:00:00.000,2025-04-15 11:06:39.727
false,false,5640,5287,353,1164,00:00:32.000,2025-04-15 11:03:52.553
false,false,5645,5292,353,1321,00:00:33.000,2025-04-15 11:03:57.558
false,true,5650,5297,353,0,00:00:00.000,2025-04-15 11:04:04.565
false,false,5662,5307,355,219,00:00:30.000,2025-04-15 11:04:26.589
false,false,5672,5316,356,291,00:00:33.000,2025-04-15 11:04:48.613
false,false,5682,5326,356,603,00:00:30.000,2025-04-15 11:04:58.626
false,true,5685,5329,356,0,00:00:00.000,2025-04-15 11:05:03.633
false,false,5430,5087,343,186,00:00:32.000,2025-04-15 10:59:04.267
false,true,5435,5092,343,0,00:00:00.000,2025-04-15 10:59:13.273
false,true,5447,5104,343,0,00:00:00.000,2025-04-15 10:59:33.291
false,true,5882,5513,369,0,00:00:00.000,2025-04-15 11:10:15.952
false,true,5895,5525,370,0,00:00:00.000,2025-04-15 11:10:44.977
false,true,5905,5535,370,0,00:00:00.000,2025-04-15 11:11:08.000
false,false,5920,5549,371,468,00:00:33.000,2025-04-15 11:11:27.022
false,false,5928,5556,372,721,00:00:30.000,2025-04-15 11:11:35.026
false,false,5808,5442,366,32,00:00:32.000,2025-04-15 11:08:28.842
false,true,5808,5442,366,0,00:00:00.000,2025-04-15 11:08:30.844
false,true,5813,5447,366,0,00:00:00.000,2025-04-15 11:08:41.856
false,true,5813,5447,366,0,00:00:00.000,2025-04-15 11:08:43.859
false,true,5842,5474,368,0,00:00:00.000,2025-04-15 11:09:23.901
false,false,5870,5501,369,375,00:00:30.000,2025-04-15 11:10:00.940
false,false,5871,5502,369,408,00:00:33.000,2025-04-15 11:10:01.941
false,false,5939,5567,372,62,00:00:31.000,2025-04-15 11:11:58.047
false,false,5948,5576,372,345,00:00:32.000,2025-04-15 11:12:07.053
false,true,5968,5595,373,0,00:00:00.000,2025-04-15 11:12:30.075
false,false,5974,5599,375,187,00:00:31.000,2025-04-15 11:12:39.086
false,false,5987,5611,376,597,00:00:33.000,2025-04-15 11:12:52.101
false,false,5996,5620,376,877,00:00:31.000,2025-04-15 11:13:01.109
false,false,5745,5385,360,128,00:00:33.000,2025-04-15 11:06:49.736
false,false,5747,5387,360,190,00:00:30.000,2025-04-15 11:06:51.738
false,false,5758,5397,361,535,00:00:30.000,2025-04-15 11:07:02.748
false,false,5760,5399,361,599,00:00:33.000,2025-04-15 11:07:04.750
false,false,5790,5425,365,500,00:00:32.000,2025-04-15 11:07:58.810
false,true,5795,5430,365,0,00:00:00.000,2025-04-15 11:08:07.817
false,false,5798,5432,366,95,00:00:31.000,2025-04-15 11:08:12.823
false,false,5800,5434,366,160,00:00:32.000,2025-04-15 11:08:14.826
false,true,5807,5441,366,0,00:00:00.000,2025-04-15 11:08:22.835
false,true,5807,5441,366,0,00:00:00.000,2025-04-15 11:08:26.839
false,false,6009,5633,376,33,00:00:33.000,2025-04-15 11:13:44.153
false,false,6034,5656,378,822,00:00:32.000,2025-04-15 11:14:09.178
false,true,6035,5657,378,0,00:00:00.000,2025-04-15 11:14:21.191
false,false,6061,5683,378,626,00:00:31.000,2025-04-15 11:14:54.221
false,true,6065,5687,378,0,00:00:00.000,2025-04-15 11:15:00.228
false,true,6232,5845,387,0,00:00:00.000,2025-04-15 11:18:37.452
false,false,6233,5846,387,30,00:00:30.000,2025-04-15 11:18:40.456
false,true,6273,5886,387,0,00:00:00.000,2025-04-15 11:19:27.508
false,false,6289,5902,387,285,00:00:33.000,2025-04-15 11:19:54.536
false,false,6291,5903,388,348,00:00:32.000,2025-04-15 11:19:56.538
false,true,6292,5904,388,0,00:00:00.000,2025-04-15 11:19:58.539
false,true,6292,5904,388,0,00:00:00.000,2025-04-15 11:20:01.540
false,false,6073,5694,379,255,00:00:32.000,2025-04-15 11:15:12.240
false,false,6078,5699,379,32,00:00:32.000,2025-04-15 11:15:23.254
false,true,6078,5699,379,0,00:00:00.000,2025-04-15 11:15:29.259
false,false,6084,5705,379,192,00:00:32.000,2025-04-15 11:15:35.267
false,false,6097,5718,379,124,00:00:30.000,2025-04-15 11:15:54.287
false,false,6101,5722,379,253,00:00:33.000,2025-04-15 11:15:58.292
false,false,6147,5766,381,1141,00:00:32.000,2025-04-15 11:16:50.342
false,false,6148,5767,381,1171,00:00:30.000,2025-04-15 11:16:51.345
false,false,6157,5776,381,1455,00:00:30.000,2025-04-15 11:17:00.352
false,false,6161,5780,381,1582,00:00:32.000,2025-04-15 11:17:04.357
false,false,6169,5786,383,1831,00:00:31.000,2025-04-15 11:17:12.365
false,false,6170,5787,383,1864,00:00:33.000,2025-04-15 11:17:13.366
false,false,6181,5797,384,2208,00:00:32.000,2025-04-15 11:17:24.376
false,false,6183,5799,384,2273,00:00:32.000,2025-04-15 11:17:26.378
false,false,6188,5804,384,95,00:00:33.000,2025-04-15 11:17:37.391
false,true,6196,5811,385,0,00:00:00.000,2025-04-15 11:17:50.404
false,false,6203,5818,385,219,00:00:33.000,2025-04-15 11:17:58.412
false,true,6301,5913,388,0,00:00:00.000,2025-04-15 11:20:23.562
false,false,6308,5920,388,218,00:00:30.000,2025-04-15 11:20:31.568
false,false,6311,5923,388,309,00:00:30.000,2025-04-15 11:20:34.572
false,false,6316,5928,388,466,00:00:32.000,2025-04-15 11:20:39.578
false,false,6323,5934,389,685,00:00:33.000,2025-04-15 11:20:46.583
false,false,6324,5935,389,715,00:00:30.000,2025-04-15 11:20:47.583
false,false,6338,5948,390,94,00:00:31.000,2025-04-15 11:21:07.606
false,false,6340,5950,390,154,00:00:30.000,2025-04-15 11:21:09.607
false,false,6360,5969,391,783,00:00:31.000,2025-04-15 11:21:29.626
false,false,6368,5977,391,1033,00:00:30.000,2025-04-15 11:21:37.636
false,false,6586,6181,405,564,00:00:31.000,2025-04-15 11:26:57.977
false,true,6588,6183,405,0,00:00:00.000,2025-04-15 11:27:06.985
false,false,6595,6190,405,32,00:00:32.000,2025-04-15 11:27:25.002
false,false,6601,6196,405,63,00:00:32.000,2025-04-15 11:27:37.013
false,false,6604,6198,406,158,00:00:32.000,2025-04-15 11:27:40.016
false,false,6605,6199,406,188,00:00:30.000,2025-04-15 11:27:41.016
false,false,6628,6221,407,345,00:00:31.000,2025-04-15 11:28:16.050
false,true,6631,6224,407,0,00:00:00.000,2025-04-15 11:28:25.056
false,false,6517,6118,399,608,00:00:31.000,2025-04-15 11:25:36.892
false,false,6541,6141,400,1365,00:00:33.000,2025-04-15 11:26:00.916
false,false,6554,6151,403,92,00:00:32.000,2025-04-15 11:26:19.940
false,false,6563,6160,403,373,00:00:33.000,2025-04-15 11:26:28.950
false,false,6574,6170,404,187,00:00:33.000,2025-04-15 11:26:45.964
false,true,6380,5989,391,0,00:00:00.000,2025-04-15 11:21:56.651
false,true,6380,5989,391,0,00:00:00.000,2025-04-15 11:21:57.652
false,true,6391,6000,391,0,00:00:00.000,2025-04-15 11:22:14.670
false,true,6391,6000,391,0,00:00:00.000,2025-04-15 11:22:18.676
false,true,6399,6007,392,0,00:00:00.000,2025-04-15 11:22:35.696
false,false,6403,6011,392,126,00:00:32.000,2025-04-15 11:22:42.705
false,true,6425,6032,393,0,00:00:00.000,2025-04-15 11:23:21.745
false,true,6428,6035,393,0,00:00:00.000,2025-04-15 11:23:30.755
false,false,6442,6048,394,410,00:00:33.000,2025-04-15 11:23:57.787
false,false,6450,6056,394,96,00:00:32.000,2025-04-15 11:24:11.801
false,false,6454,6060,394,222,00:00:31.000,2025-04-15 11:24:15.806
false,false,6458,6063,395,346,00:00:32.000,2025-04-15 11:24:19.812
false,false,6465,6070,395,64,00:00:31.000,2025-04-15 11:24:32.827
false,false,6474,6078,396,191,00:00:33.000,2025-04-15 11:24:47.840
false,false,6482,6085,397,440,00:00:31.000,2025-04-15 11:24:55.849
false,false,6489,6091,398,664,00:00:31.000,2025-04-15 11:25:02.855
false,false,6682,6269,413,320,00:00:33.000,2025-04-15 11:29:52.142
false,false,6687,6273,414,473,00:00:31.000,2025-04-15 11:29:57.148
false,true,6838,6419,419,0,00:00:00.000,2025-04-15 11:33:31.355
false,true,6838,6419,419,0,00:00:00.000,2025-04-15 11:33:33.357
false,false,6865,6445,420,313,00:00:30.000,2025-04-15 11:34:25.414
false,false,6872,6451,421,539,00:00:33.000,2025-04-15 11:34:32.422
false,false,6873,6452,421,570,00:00:31.000,2025-04-15 11:34:33.423
false,true,6882,6460,422,0,00:00:00.000,2025-04-15 11:34:50.443
false,false,6697,6283,414,33,00:00:33.000,2025-04-15 11:30:19.165
false,false,6717,6302,415,660,00:00:32.000,2025-04-15 11:30:39.184
false,false,6733,6318,415,1166,00:00:32.000,2025-04-15 11:30:55.199
false,false,6751,6336,415,1738,00:00:33.000,2025-04-15 11:31:13.220
false,false,6783,6364,419,2748,00:00:31.000,2025-04-15 11:31:45.247
false,false,6915,6493,422,377,00:00:33.000,2025-04-15 11:35:45.500
false,false,6963,6537,426,95,00:00:32.000,2025-04-15 11:36:39.553
false,true,6964,6538,426,0,00:00:00.000,2025-04-15 11:36:42.556
false,false,7051,6621,430,95,00:00:31.000,2025-04-15 11:38:37.676
false,false,7063,6632,431,473,00:00:32.000,2025-04-15 11:38:49.683
false,false,7077,6646,431,65,00:00:33.000,2025-04-15 11:39:09.700
false,false,7081,6650,431,192,00:00:30.000,2025-04-15 11:39:13.706
false,false,7082,6651,431,222,00:00:30.000,2025-04-15 11:39:14.708
false,false,7097,6665,432,696,00:00:33.000,2025-04-15 11:39:29.731
false,false,7103,6671,432,882,00:00:30.000,2025-04-15 11:39:35.739
false,false,7128,6696,432,1674,00:00:31.000,2025-04-15 11:40:00.767
false,false,7129,6697,432,1705,00:00:31.000,2025-04-15 11:40:01.769
false,false,6792,6373,419,186,00:00:31.000,2025-04-15 11:32:00.262
false,true,6802,6383,419,0,00:00:00.000,2025-04-15 11:32:17.276
false,false,6803,6384,419,31,00:00:31.000,2025-04-15 11:32:23.282
false,true,6808,6389,419,0,00:00:00.000,2025-04-15 11:32:35.295
false,false,6809,6390,419,33,00:00:33.000,2025-04-15 11:32:41.299
false,true,6819,6400,419,0,00:00:00.000,2025-04-15 11:32:54.317
false,true,6820,6401,419,0,00:00:00.000,2025-04-15 11:33:00.322
false,false,6990,6564,426,695,00:00:32.000,2025-04-15 11:37:24.598
false,false,6995,6568,427,98,00:00:32.000,2025-04-15 11:37:35.607
false,false,7008,6581,427,506,00:00:31.000,2025-04-15 11:37:48.619
false,false,7016,6589,427,764,00:00:32.000,2025-04-15 11:37:56.628
false,false,7170,6730,440,125,00:00:30.000,2025-04-15 11:40:54.827
false,false,7171,6731,440,155,00:00:30.000,2025-04-15 11:40:55.828
false,false,7175,6735,440,128,00:00:33.000,2025-04-15 11:41:05.839
false,false,7181,6741,440,319,00:00:32.000,2025-04-15 11:41:11.846
false,false,7192,6751,441,664,00:00:31.000,2025-04-15 11:41:22.858
false,false,7209,6766,443,221,00:00:32.000,2025-04-15 11:41:45.882
false,false,7211,6767,444,284,00:00:31.000,2025-04-15 11:41:47.885
false,false,7377,6921,456,696,00:00:30.000,2025-04-15 11:45:40.128
false,false,7381,6925,456,63,00:00:30.000,2025-04-15 11:45:50.138
false,false,7394,6936,458,471,00:00:33.000,2025-04-15 11:46:03.151
false,false,7399,6941,458,627,00:00:31.000,2025-04-15 11:46:08.156
false,false,7403,6945,458,753,00:00:33.000,2025-04-15 11:46:12.159
false,true,7404,6946,458,0,00:00:00.000,2025-04-15 11:46:18.166
false,true,7404,6946,458,0,00:00:00.000,2025-04-15 11:46:21.172
false,false,7414,6955,459,249,00:00:33.000,2025-04-15 11:46:41.192
false,false,7219,6774,445,94,00:00:30.000,2025-04-15 11:42:07.906
false,false,7228,6783,445,283,00:00:31.000,2025-04-15 11:42:22.925
false,false,7236,6790,446,529,00:00:31.000,2025-04-15 11:42:30.935
false,false,7264,6817,447,313,00:00:31.000,2025-04-15 11:43:10.972
false,false,7268,6821,447,439,00:00:33.000,2025-04-15 11:43:14.977
false,false,7270,6823,447,500,00:00:31.000,2025-04-15 11:43:16.979
false,true,7273,6825,448,0,00:00:00.000,2025-04-15 11:43:21.985
false,true,7273,6825,448,0,00:00:00.000,2025-04-15 11:43:24.990
false,false,7438,6979,459,505,00:00:31.000,2025-04-15 11:47:17.230
false,false,7460,7000,460,572,00:00:32.000,2025-04-15 11:47:45.265
false,true,7464,7004,460,0,00:00:00.000,2025-04-15 11:47:51.274
false,true,7466,7006,460,0,00:00:00.000,2025-04-15 11:48:00.283
false,false,7491,7028,463,65,00:00:33.000,2025-04-15 11:48:34.319
false,false,7503,7040,463,252,00:00:32.000,2025-04-15 11:48:52.345
false,false,7516,7051,465,661,00:00:30.000,2025-04-15 11:49:05.357
false,false,7523,7058,465,886,00:00:32.000,2025-04-15 11:49:12.365
false,false,7538,7073,465,319,00:00:32.000,2025-04-15 11:49:33.382
false,false,7557,7091,466,380,00:00:31.000,2025-04-15 11:50:04.412
false,true,7559,7093,466,0,00:00:00.000,2025-04-15 11:50:08.416
false,true,7317,6868,449,0,00:00:00.000,2025-04-15 11:44:28.053
false,true,7329,6880,449,0,00:00:00.000,2025-04-15 11:44:45.069
false,false,7336,6887,449,220,00:00:31.000,2025-04-15 11:44:53.082
false,true,7570,7104,466,0,00:00:00.000,2025-04-15 11:50:29.434
false,false,7572,7106,466,64,00:00:32.000,2025-04-15 11:50:31.436
false,false,7574,7108,466,125,00:00:30.000,2025-04-15 11:50:33.438
false,true,7580,7114,466,0,00:00:00.000,2025-04-15 11:50:40.443
false,false,7616,7149,467,1130,00:00:33.000,2025-04-15 11:51:21.480
false,false,7717,7249,468,30,00:00:30.000,2025-04-15 11:53:32.622
false,false,7721,7253,468,154,00:00:30.000,2025-04-15 11:53:36.626
false,false,7733,7265,468,532,00:00:32.000,2025-04-15 11:53:48.641
false,false,7736,7268,468,630,00:00:33.000,2025-04-15 11:53:51.647
false,false,7742,7274,468,821,00:00:31.000,2025-04-15 11:53:57.653
false,true,7774,7304,470,0,00:00:00.000,2025-04-15 11:54:53.714
false,false,7779,7309,470,151,00:00:30.000,2025-04-15 11:54:58.719
false,true,7666,7199,467,0,00:00:00.000,2025-04-15 11:52:16.537
false,false,7672,7204,468,195,00:00:32.000,2025-04-15 11:52:23.546
false,true,7683,7215,468,0,00:00:00.000,2025-04-15 11:52:36.561
false,false,7811,7341,470,315,00:00:32.000,2025-04-15 11:55:42.770
false,false,7826,7353,473,66,00:00:33.000,2025-04-15 11:56:21.811
false,false,7831,7358,473,62,00:00:30.000,2025-04-15 11:56:38.828
false,true,7844,7371,473,0,00:00:00.000,2025-04-15 11:56:57.847
false,false,7847,7374,473,91,00:00:30.000,2025-04-15 11:57:00.852
false,false,7849,7376,473,154,00:00:33.000,2025-04-15 11:57:02.853
false,false,7863,7389,474,589,00:00:31.000,2025-04-15 11:57:16.867
false,true,7870,7396,474,0,00:00:00.000,2025-04-15 11:57:25.882
false,true,7870,7396,474,0,00:00:00.000,2025-04-15 11:57:33.896
false,false,7882,7408,474,380,00:00:33.000,2025-04-15 11:57:47.910
false,false,7883,7409,474,411,00:00:31.000,2025-04-15 11:57:48.911
false,false,7891,7417,474,669,00:00:33.000,2025-04-15 11:57:56.921
false,false,7904,7430,474,1079,00:00:30.000,2025-04-15 11:58:09.935
false,false,7906,7432,474,1142,00:00:31.000,2025-04-15 11:58:11.938
false,false,7918,7443,475,1519,00:00:30.000,2025-04-15 11:58:23.947
false,false,7924,7449,475,1706,00:00:30.000,2025-04-15 11:58:29.951
false,false,8003,7525,478,310,00:00:31.000,2025-04-15 12:00:19.064
false,true,8017,7538,479,0,00:00:00.000,2025-04-15 12:00:44.087
false,false,8023,7544,479,183,00:00:31.000,2025-04-15 12:00:51.096
false,true,8035,7556,479,0,00:00:00.000,2025-04-15 12:01:06.110
false,false,8037,7558,479,62,00:00:31.000,2025-04-15 12:01:11.113
false,false,8042,7563,479,219,00:00:31.000,2025-04-15 12:01:16.118
false,false,5154,4833,321,188,00:00:32.000,2025-04-15 10:53:15.922
false,false,5157,4836,321,283,00:00:33.000,2025-04-15 10:53:18.925
false,false,5163,4842,321,474,00:00:32.000,2025-04-15 10:53:24.931
false,false,5242,4916,326,346,00:00:32.000,2025-04-15 10:55:08.031
false,false,5245,4918,327,439,00:00:30.000,2025-04-15 10:55:11.035
false,false,5255,4928,327,754,00:00:30.000,2025-04-15 10:55:21.047
false,true,5264,4937,327,0,00:00:00.000,2025-04-15 10:55:33.056
false,false,5275,4946,329,347,00:00:32.000,2025-04-15 10:55:47.072
false,false,5287,4958,329,726,00:00:32.000,2025-04-15 10:55:59.083
false,false,5293,4963,330,919,00:00:33.000,2025-04-15 10:56:05.089
false,false,5319,4984,335,505,00:00:31.000,2025-04-15 10:56:43.124
false,false,4942,4638,304,125,00:00:30.000,2025-04-15 10:48:31.628
false,false,4943,4639,304,155,00:00:30.000,2025-04-15 10:48:32.629
false,false,4952,4648,304,434,00:00:30.000,2025-04-15 10:48:41.635
false,false,4956,4652,304,556,00:00:30.000,2025-04-15 10:48:45.640
false,true,4958,4654,304,0,00:00:00.000,2025-04-15 10:48:49.643
false,true,4962,4657,305,0,00:00:00.000,2025-04-15 10:48:58.652
false,false,4972,4667,305,318,00:00:32.000,2025-04-15 10:49:13.670
false,true,4975,4670,305,0,00:00:00.000,2025-04-15 10:49:22.679
false,false,5012,4703,309,61,00:00:30.000,2025-04-15 10:50:11.742
false,true,5014,4705,309,0,00:00:00.000,2025-04-15 10:50:18.748
false,false,5054,4742,312,1254,00:00:31.000,2025-04-15 10:50:59.789
false,false,5056,4744,312,1317,00:00:30.000,2025-04-15 10:51:01.791
false,false,5064,4750,314,1566,00:00:32.000,2025-04-15 10:51:09.802
false,false,5071,4757,314,1784,00:00:30.000,2025-04-15 10:51:16.810
false,false,5072,4758,314,1814,00:00:30.000,2025-04-15 10:51:17.811
false,false,5076,4760,316,1939,00:00:30.000,2025-04-15 10:51:21.814
false,true,5079,4763,316,0,00:00:00.000,2025-04-15 10:51:28.821
false,false,5080,4764,316,30,00:00:30.000,2025-04-15 10:51:31.824
false,false,5172,4851,321,750,00:00:30.000,2025-04-15 10:53:33.941
false,false,5188,4865,323,30,00:00:30.000,2025-04-15 10:53:55.960
false,true,5206,4882,324,0,00:00:00.000,2025-04-15 10:54:14.979
false,false,5208,4884,324,63,00:00:31.000,2025-04-15 10:54:21.986
false,false,5215,4891,324,126,00:00:31.000,2025-04-15 10:54:34.999
false,false,5216,4891,325,158,00:00:32.000,2025-04-15 10:54:36.000
false,false,5231,4905,326,627,00:00:33.000,2025-04-15 10:54:51.014
false,false,5237,4911,326,191,00:00:31.000,2025-04-15 10:55:03.026
false,false,5478,5134,344,152,00:00:30.000,2025-04-15 11:00:16.336
false,false,5483,5139,344,311,00:00:30.000,2025-04-15 11:00:21.340
false,true,5540,5191,349,0,00:00:00.000,2025-04-15 11:01:39.422
false,false,5541,5192,349,31,00:00:31.000,2025-04-15 11:01:43.425
false,false,5548,5199,349,258,00:00:32.000,2025-04-15 11:01:50.431
false,false,5555,5205,350,476,00:00:30.000,2025-04-15 11:01:57.438
false,true,5582,5232,350,0,00:00:00.000,2025-04-15 11:02:25.464
false,false,5588,5238,350,193,00:00:30.000,2025-04-15 11:02:36.473
false,false,5593,5243,350,95,00:00:30.000,2025-04-15 11:02:47.484
false,true,5595,5245,350,0,00:00:00.000,2025-04-15 11:02:57.496
false,true,5595,5245,350,0,00:00:00.000,2025-04-15 11:02:59.497
false,false,5600,5250,350,159,00:00:31.000,2025-04-15 11:03:06.505
false,false,5691,5335,356,126,00:00:32.000,2025-04-15 11:05:19.647
false,false,5708,5351,357,221,00:00:30.000,2025-04-15 11:05:48.676
false,true,5712,5355,357,0,00:00:00.000,2025-04-15 11:06:02.692
false,false,5724,5367,357,372,00:00:33.000,2025-04-15 11:06:16.705
false,false,5735,5375,360,725,00:00:33.000,2025-04-15 11:06:27.716
false,false,5624,5274,350,659,00:00:30.000,2025-04-15 11:03:36.537
false,true,5650,5297,353,0,00:00:00.000,2025-04-15 11:04:08.571
false,true,5655,5302,353,0,00:00:00.000,2025-04-15 11:04:14.577
false,false,5657,5304,353,63,00:00:31.000,2025-04-15 11:04:21.585
false,true,5663,5308,355,0,00:00:00.000,2025-04-15 11:04:35.598
false,true,5663,5308,355,0,00:00:00.000,2025-04-15 11:04:39.604
false,false,5415,5074,341,282,00:00:32.000,2025-04-15 10:58:43.243
false,false,5417,5076,341,344,00:00:32.000,2025-04-15 10:58:45.246
false,false,5443,5100,343,253,00:00:33.000,2025-04-15 10:59:23.283
false,false,5459,5115,344,382,00:00:33.000,2025-04-15 10:59:45.304
false,true,5470,5126,344,0,00:00:00.000,2025-04-15 10:59:57.316
false,false,5471,5127,344,31,00:00:31.000,2025-04-15 11:00:03.321
false,true,5888,5518,370,0,00:00:00.000,2025-04-15 11:10:34.969
false,false,5893,5523,370,163,00:00:33.000,2025-04-15 11:10:41.975
false,false,5913,5542,371,250,00:00:32.000,2025-04-15 11:11:20.014
false,false,5829,5461,368,315,00:00:31.000,2025-04-15 11:09:07.884
false,false,5832,5464,368,410,00:00:33.000,2025-04-15 11:09:10.887
false,false,5835,5467,368,504,00:00:33.000,2025-04-15 11:09:13.890
false,false,5838,5470,368,598,00:00:31.000,2025-04-15 11:09:16.894
false,true,5842,5474,368,0,00:00:00.000,2025-04-15 11:09:22.899
false,false,5854,5486,368,378,00:00:33.000,2025-04-15 11:09:38.915
false,false,5938,5566,372,31,00:00:31.000,2025-04-15 11:11:57.047
false,false,5955,5583,372,567,00:00:33.000,2025-04-15 11:12:14.059
false,false,5959,5587,372,696,00:00:32.000,2025-04-15 11:12:18.063
false,false,5966,5593,373,910,00:00:30.000,2025-04-15 11:12:25.073
false,false,5967,5594,373,943,00:00:33.000,2025-04-15 11:12:26.072
false,false,5968,5595,373,974,00:00:31.000,2025-04-15 11:12:27.073
false,true,5968,5595,373,0,00:00:00.000,2025-04-15 11:12:29.073
false,false,5988,5612,376,628,00:00:31.000,2025-04-15 11:12:53.103
false,true,5997,5621,376,0,00:00:00.000,2025-04-15 11:13:13.122
false,true,5764,5402,362,0,00:00:00.000,2025-04-15 11:07:15.762
false,true,5764,5402,362,0,00:00:00.000,2025-04-15 11:07:18.766
false,true,5764,5402,362,0,00:00:00.000,2025-04-15 11:07:20.769
false,false,5769,5407,362,161,00:00:32.000,2025-04-15 11:07:31.782
false,false,5773,5410,363,287,00:00:32.000,2025-04-15 11:07:35.784
false,true,5774,5411,363,0,00:00:00.000,2025-04-15 11:07:39.789
false,false,5806,5440,366,347,00:00:31.000,2025-04-15 11:08:20.833
false,true,6006,5630,376,0,00:00:00.000,2025-04-15 11:13:32.139
false,true,6006,5630,376,0,00:00:00.000,2025-04-15 11:13:33.140
false,true,6008,5632,376,0,00:00:00.000,2025-04-15 11:13:38.145
false,true,6008,5632,376,0,00:00:00.000,2025-04-15 11:13:40.146
false,true,6035,5657,378,0,00:00:00.000,2025-04-15 11:14:22.191
false,true,6041,5663,378,0,00:00:00.000,2025-04-15 11:14:30.198
false,false,6045,5667,378,125,00:00:33.000,2025-04-15 11:14:38.204
false,false,6049,5671,378,250,00:00:31.000,2025-04-15 11:14:42.209
false,false,6066,5688,378,32,00:00:32.000,2025-04-15 11:15:05.233
false,false,6245,5858,387,410,00:00:32.000,2025-04-15 11:18:52.472
false,false,6248,5861,387,507,00:00:32.000,2025-04-15 11:18:55.475
false,false,6256,5869,387,752,00:00:30.000,2025-04-15 11:19:03.483
false,false,6265,5878,387,158,00:00:32.000,2025-04-15 11:19:18.497
false,true,6273,5886,387,0,00:00:00.000,2025-04-15 11:19:31.512
false,true,6280,5893,387,0,00:00:00.000,2025-04-15 11:19:43.523
false,false,6076,5697,379,349,00:00:31.000,2025-04-15 11:15:15.244
false,false,6080,5701,379,65,00:00:32.000,2025-04-15 11:15:31.262
false,false,6092,5713,379,449,00:00:33.000,2025-04-15 11:15:43.277
false,true,6093,5714,379,0,00:00:00.000,2025-04-15 11:15:46.280
false,true,6093,5714,379,0,00:00:00.000,2025-04-15 11:15:48.282
false,false,6096,5717,379,94,00:00:30.000,2025-04-15 11:15:53.287
false,false,6103,5724,379,316,00:00:31.000,2025-04-15 11:16:00.293
false,false,6131,5751,380,636,00:00:33.000,2025-04-15 11:16:34.329
false,false,6136,5755,381,795,00:00:32.000,2025-04-15 11:16:39.334
false,false,6137,5756,381,826,00:00:31.000,2025-04-15 11:16:40.335
false,false,6138,5757,381,856,00:00:30.000,2025-04-15 11:16:41.338
false,false,6162,5781,381,1614,00:00:32.000,2025-04-15 11:17:05.358
false,false,6180,5796,384,2176,00:00:31.000,2025-04-15 11:17:23.374
false,false,6182,5798,384,2241,00:00:33.000,2025-04-15 11:17:25.377
false,true,6223,5836,387,0,00:00:00.000,2025-04-15 11:18:24.439
false,false,6325,5936,389,747,00:00:32.000,2025-04-15 11:20:48.585
false,true,6335,5945,390,0,00:00:00.000,2025-04-15 11:21:02.604
false,false,6354,5963,391,592,00:00:31.000,2025-04-15 11:21:23.621
false,false,6361,5970,391,815,00:00:32.000,2025-04-15 11:21:30.628
false,false,6581,6177,404,407,00:00:31.000,2025-04-15 11:26:52.971
false,false,6593,6188,405,155,00:00:32.000,2025-04-15 11:27:16.994
false,true,6599,6194,405,0,00:00:00.000,2025-04-15 11:27:35.011
false,true,6611,6205,406,0,00:00:00.000,2025-04-15 11:27:48.021
false,false,6616,6210,406,158,00:00:30.000,2025-04-15 11:27:58.032
false,false,6618,6212,406,32,00:00:32.000,2025-04-15 11:28:06.039
false,true,6498,6100,398,0,00:00:00.000,2025-04-15 11:25:17.873
false,false,6511,6113,398,415,00:00:32.000,2025-04-15 11:25:30.886
false,false,6515,6116,399,545,00:00:33.000,2025-04-15 11:25:34.889
false,false,6521,6122,399,733,00:00:32.000,2025-04-15 11:25:40.897
false,false,6540,6140,400,1332,00:00:33.000,2025-04-15 11:25:59.915
false,false,6553,6150,403,60,00:00:30.000,2025-04-15 11:26:18.939
false,false,6566,6162,404,467,00:00:32.000,2025-04-15 11:26:31.951
false,false,6567,6163,404,500,00:00:33.000,2025-04-15 11:26:32.952
false,false,6569,6165,404,30,00:00:30.000,2025-04-15 11:26:40.957
false,false,6377,5986,391,125,00:00:31.000,2025-04-15 11:21:52.645
false,false,6384,5993,391,131,00:00:32.000,2025-04-15 11:22:05.658
false,false,6386,5995,391,193,00:00:30.000,2025-04-15 11:22:07.661
false,false,6396,6005,391,62,00:00:32.000,2025-04-15 11:22:29.689
false,false,6397,6005,392,95,00:00:33.000,2025-04-15 11:22:30.690
false,false,6405,6012,393,188,00:00:31.000,2025-04-15 11:22:44.708
false,false,6414,6021,393,470,00:00:31.000,2025-04-15 11:22:53.718
false,false,6433,6039,394,125,00:00:30.000,2025-04-15 11:23:48.777
false,false,6446,6052,394,535,00:00:33.000,2025-04-15 11:24:01.790
false,false,6455,6061,394,253,00:00:31.000,2025-04-15 11:24:16.808
false,false,6642,6233,409,284,00:00:32.000,2025-04-15 11:28:42.073
false,true,6672,6260,412,0,00:00:00.000,2025-04-15 11:29:39.130
false,false,6674,6262,412,63,00:00:32.000,2025-04-15 11:29:44.135
false,false,6681,6268,413,287,00:00:31.000,2025-04-15 11:29:51.142
false,false,6852,6432,420,33,00:00:33.000,2025-04-15 11:34:06.390
false,false,6853,6433,420,63,00:00:30.000,2025-04-15 11:34:07.392
false,true,6855,6435,420,0,00:00:00.000,2025-04-15 11:34:11.397
false,true,6855,6435,420,0,00:00:00.000,2025-04-15 11:34:14.400
false,true,6882,6460,422,0,00:00:00.000,2025-04-15 11:34:52.445
false,false,6728,6313,415,1006,00:00:32.000,2025-04-15 11:30:50.192
false,false,6731,6316,415,1101,00:00:31.000,2025-04-15 11:30:53.195
false,false,6734,6319,415,1198,00:00:32.000,2025-04-15 11:30:56.200
false,false,6782,6363,419,2717,00:00:30.000,2025-04-15 11:31:44.247
false,true,6893,6471,422,0,00:00:00.000,2025-04-15 11:35:12.464
false,true,6893,6471,422,0,00:00:00.000,2025-04-15 11:35:17.469
false,false,6922,6500,422,600,00:00:33.000,2025-04-15 11:35:52.507
false,false,6929,6507,422,823,00:00:30.000,2025-04-15 11:35:59.514
false,false,6959,6534,425,1770,00:00:33.000,2025-04-15 11:36:29.543
false,false,7084,6653,431,284,00:00:32.000,2025-04-15 11:39:16.712
false,false,7100,6668,432,789,00:00:33.000,2025-04-15 11:39:32.735
false,false,7107,6675,432,1008,00:00:33.000,2025-04-15 11:39:39.743
false,false,7122,6690,432,1483,00:00:30.000,2025-04-15 11:39:54.761
false,false,7123,6691,432,1514,00:00:31.000,2025-04-15 11:39:55.762
false,false,7131,6698,433,1769,00:00:32.000,2025-04-15 11:40:03.771
false,false,7136,6702,434,1924,00:00:30.000,2025-04-15 11:40:08.776
false,false,6795,6376,419,280,00:00:31.000,2025-04-15 11:32:03.263
false,true,6808,6389,419,0,00:00:00.000,2025-04-15 11:32:29.287
false,false,6815,6396,419,217,00:00:31.000,2025-04-15 11:32:47.306
false,false,6816,6397,419,248,00:00:31.000,2025-04-15 11:32:48.308
false,false,6967,6541,426,63,00:00:30.000,2025-04-15 11:36:55.567
false,false,6975,6549,426,222,00:00:33.000,2025-04-15 11:37:09.585
false,false,6991,6565,426,728,00:00:33.000,2025-04-15 11:37:25.598
false,true,6992,6566,426,0,00:00:00.000,2025-04-15 11:37:27.601
false,true,6992,6566,426,0,00:00:00.000,2025-04-15 11:37:29.602
false,false,7033,6603,430,1299,00:00:31.000,2025-04-15 11:38:13.649
false,false,7140,6705,435,2051,00:00:31.000,2025-04-15 11:40:12.781
false,true,7145,6710,435,0,00:00:00.000,2025-04-15 11:40:22.789
false,false,7155,6718,437,314,00:00:31.000,2025-04-15 11:40:33.804
false,false,7163,6725,438,568,00:00:33.000,2025-04-15 11:40:41.813
false,false,7167,6728,439,33,00:00:33.000,2025-04-15 11:40:51.823
false,true,7202,6760,442,0,00:00:00.000,2025-04-15 11:41:38.875
false,false,7356,6903,453,33,00:00:33.000,2025-04-15 11:45:19.108
false,false,7379,6923,456,759,00:00:30.000,2025-04-15 11:45:42.131
false,true,7404,6946,458,0,00:00:00.000,2025-04-15 11:46:23.174
false,false,7405,6947,458,32,00:00:32.000,2025-04-15 11:46:26.177
false,false,7408,6950,458,62,00:00:30.000,2025-04-15 11:46:35.187
false,false,7417,6958,459,342,00:00:30.000,2025-04-15 11:46:44.194
false,true,7213,6768,445,0,00:00:00.000,2025-04-15 11:41:52.889
false,true,7213,6768,445,0,00:00:00.000,2025-04-15 11:41:55.893
false,true,7216,6771,445,0,00:00:00.000,2025-04-15 11:42:01.899
false,true,7219,6774,445,0,00:00:00.000,2025-04-15 11:42:11.911
false,false,7253,6806,447,344,00:00:33.000,2025-04-15 11:42:53.953
false,true,7254,6807,447,0,00:00:00.000,2025-04-15 11:43:00.962
false,false,7271,6823,448,533,00:00:33.000,2025-04-15 11:43:17.981
false,true,7273,6825,448,0,00:00:00.000,2025-04-15 11:43:25.991
false,true,7422,6963,459,0,00:00:00.000,2025-04-15 11:46:58.208
false,false,7441,6981,460,599,00:00:33.000,2025-04-15 11:47:20.234
false,true,7442,6982,460,0,00:00:00.000,2025-04-15 11:47:22.237
false,false,7448,6988,460,188,00:00:33.000,2025-04-15 11:47:33.248
false,false,7475,7013,462,277,00:00:31.000,2025-04-15 11:48:12.294
false,false,7476,7014,462,307,00:00:30.000,2025-04-15 11:48:13.295
false,true,7489,7026,463,0,00:00:00.000,2025-04-15 11:48:27.312
false,true,7489,7026,463,0,00:00:00.000,2025-04-15 11:48:32.318
false,true,7495,7032,463,0,00:00:00.000,2025-04-15 11:48:39.326
false,true,7495,7032,463,0,00:00:00.000,2025-04-15 11:48:40.329
false,false,7531,7066,465,97,00:00:32.000,2025-04-15 11:49:26.373
false,false,7532,7067,465,130,00:00:33.000,2025-04-15 11:49:27.373
false,false,7542,7077,465,60,00:00:30.000,2025-04-15 11:49:43.394
false,false,7555,7089,466,316,00:00:30.000,2025-04-15 11:50:02.409
false,false,7283,6835,448,94,00:00:32.000,2025-04-15 11:43:48.012
false,false,7296,6847,449,499,00:00:31.000,2025-04-15 11:44:01.021
false,false,7305,6856,449,782,00:00:32.000,2025-04-15 11:44:10.031
false,false,7326,6877,449,280,00:00:31.000,2025-04-15 11:44:37.063
false,false,7331,6882,449,63,00:00:32.000,2025-04-15 11:44:48.072
false,false,7348,6896,452,601,00:00:31.000,2025-04-15 11:45:05.094
false,false,7578,7112,466,252,00:00:31.000,2025-04-15 11:50:37.441
false,true,7580,7114,466,0,00:00:00.000,2025-04-15 11:50:42.444
false,true,7580,7114,466,0,00:00:00.000,2025-04-15 11:50:45.446
false,false,7627,7160,467,1473,00:00:31.000,2025-04-15 11:51:32.491
false,false,7634,7167,467,1694,00:00:31.000,2025-04-15 11:51:39.497
false,true,7716,7248,468,0,00:00:00.000,2025-04-15 11:53:30.621
false,false,7753,7283,470,1165,00:00:31.000,2025-04-15 11:54:08.668
false,false,7754,7284,470,1198,00:00:33.000,2025-04-15 11:54:09.669
false,false,7756,7286,470,1258,00:00:30.000,2025-04-15 11:54:11.670
false,false,7757,7287,470,1291,00:00:33.000,2025-04-15 11:54:12.672
false,false,7782,7312,470,247,00:00:32.000,2025-04-15 11:55:01.722
false,false,7654,7187,467,2325,00:00:33.000,2025-04-15 11:51:59.515
false,false,7659,7192,467,2485,00:00:31.000,2025-04-15 11:52:04.522
false,false,7671,7203,468,163,00:00:33.000,2025-04-15 11:52:22.545
false,false,7682,7214,468,506,00:00:30.000,2025-04-15 11:52:33.559
false,false,7684,7216,468,32,00:00:32.000,2025-04-15 11:52:41.565
false,true,7690,7222,468,0,00:00:00.000,2025-04-15 11:52:53.579
false,false,7696,7228,468,189,00:00:33.000,2025-04-15 11:52:59.590
false,true,7700,7232,468,0,00:00:00.000,2025-04-15 11:53:07.597
false,false,7705,7237,468,162,00:00:32.000,2025-04-15 11:53:14.603
false,false,7714,7246,468,451,00:00:33.000,2025-04-15 11:53:23.611
false,true,7789,7319,470,0,00:00:00.000,2025-04-15 11:55:14.737
false,false,7796,7326,470,220,00:00:32.000,2025-04-15 11:55:21.745
false,true,7801,7331,470,0,00:00:00.000,2025-04-15 11:55:31.757
false,false,7807,7337,470,190,00:00:32.000,2025-04-15 11:55:38.764
false,false,7824,7351,473,32,00:00:32.000,2025-04-15 11:56:13.803
false,false,7834,7361,473,156,00:00:32.000,2025-04-15 11:56:41.831
false,false,7835,7362,473,189,00:00:33.000,2025-04-15 11:56:42.832
false,false,7838,7365,473,286,00:00:33.000,2025-04-15 11:56:45.835
false,true,7844,7371,473,0,00:00:00.000,2025-04-15 11:56:52.843
false,false,7855,7382,473,339,00:00:31.000,2025-04-15 11:57:08.859
false,false,7884,7410,474,444,00:00:33.000,2025-04-15 11:57:49.913
false,false,7913,7438,475,1363,00:00:32.000,2025-04-15 11:58:18.944
false,false,7917,7442,475,1489,00:00:32.000,2025-04-15 11:58:22.946
false,true,8017,7538,479,0,00:00:00.000,2025-04-15 12:00:40.084
false,false,8029,7550,479,375,00:00:31.000,2025-04-15 12:00:57.100
false,false,8030,7551,479,407,00:00:32.000,2025-04-15 12:00:58.101
false,false,8032,7553,479,472,00:00:32.000,2025-04-15 12:01:00.102
false,false,8047,7568,479,381,00:00:31.000,2025-04-15 12:01:21.123
false,true,5148,4828,320,0,00:00:00.000,2025-04-15 10:53:06.915
false,true,5148,4828,320,0,00:00:00.000,2025-04-15 10:53:08.917
false,false,5153,4832,321,156,00:00:33.000,2025-04-15 10:53:14.921
false,false,5162,4841,321,442,00:00:30.000,2025-04-15 10:53:23.929
false,false,5256,4929,327,784,00:00:30.000,2025-04-15 10:55:22.048
false,false,5290,4960,330,822,00:00:33.000,2025-04-15 10:56:02.086
false,false,5296,4966,330,1011,00:00:30.000,2025-04-15 10:56:08.093
false,false,5316,4982,334,412,00:00:33.000,2025-04-15 10:56:40.122
false,false,4950,4646,304,374,00:00:31.000,2025-04-15 10:48:39.635
false,true,4958,4654,304,0,00:00:00.000,2025-04-15 10:48:48.643
false,true,4958,4654,304,0,00:00:00.000,2025-04-15 10:48:52.646
false,false,4963,4658,305,32,00:00:32.000,2025-04-15 10:49:04.660
false,false,4969,4664,305,221,00:00:31.000,2025-04-15 10:49:10.666
false,false,4971,4666,305,286,00:00:32.000,2025-04-15 10:49:12.668
false,false,4973,4668,305,350,00:00:32.000,2025-04-15 10:49:14.671
false,true,4975,4670,305,0,00:00:00.000,2025-04-15 10:49:20.678
false,true,4975,4670,305,0,00:00:00.000,2025-04-15 10:49:21.679
false,false,4982,4675,307,224,00:00:32.000,2025-04-15 10:49:29.689
false,true,4995,4687,308,0,00:00:00.000,2025-04-15 10:49:44.707
false,true,5014,4705,309,0,00:00:00.000,2025-04-15 10:50:17.748
false,false,5015,4706,309,31,00:00:31.000,2025-04-15 10:50:20.751
false,false,5018,4709,309,125,00:00:31.000,2025-04-15 10:50:23.754
false,false,5022,4713,309,252,00:00:33.000,2025-04-15 10:50:27.759
false,false,5042,4730,312,874,00:00:30.000,2025-04-15 10:50:47.777
false,false,5060,4747,313,1441,00:00:32.000,2025-04-15 10:51:05.796
false,false,5062,4749,313,1504,00:00:32.000,2025-04-15 10:51:07.798
false,false,5068,4754,314,1691,00:00:31.000,2025-04-15 10:51:13.808
false,false,5070,4756,314,1754,00:00:31.000,2025-04-15 10:51:15.809
false,false,5088,4772,316,158,00:00:33.000,2025-04-15 10:51:45.841
false,false,5166,4845,321,566,00:00:31.000,2025-04-15 10:53:27.935
false,false,5168,4847,321,627,00:00:31.000,2025-04-15 10:53:29.935
false,false,5195,4871,324,252,00:00:33.000,2025-04-15 10:54:02.965
false,false,5220,4894,326,279,00:00:30.000,2025-04-15 10:54:40.004
false,true,5231,4905,326,0,00:00:00.000,2025-04-15 10:54:52.015
false,true,5473,5129,344,0,00:00:00.000,2025-04-15 11:00:08.324
false,false,5505,5158,347,539,00:00:31.000,2025-04-15 11:00:49.370
false,false,5509,5162,347,664,00:00:31.000,2025-04-15 11:00:53.374
false,true,5516,5168,348,0,00:00:00.000,2025-04-15 11:01:07.390
false,false,5519,5171,348,95,00:00:32.000,2025-04-15 11:01:15.396
false,false,5524,5176,348,254,00:00:30.000,2025-04-15 11:01:20.402
false,true,5540,5191,349,0,00:00:00.000,2025-04-15 11:01:37.421
false,false,5557,5207,350,540,00:00:33.000,2025-04-15 11:01:59.440
false,false,5563,5213,350,727,00:00:30.000,2025-04-15 11:02:05.448
false,true,5701,5345,356,0,00:00:00.000,2025-04-15 11:05:35.662
false,false,5709,5352,357,252,00:00:31.000,2025-04-15 11:05:49.677
false,false,5730,5370,360,564,00:00:32.000,2025-04-15 11:06:22.709
false,false,5742,5382,360,32,00:00:32.000,2025-04-15 11:06:46.734
false,false,5622,5272,350,597,00:00:33.000,2025-04-15 11:03:34.535
false,false,5634,5282,352,971,00:00:30.000,2025-04-15 11:03:46.546
false,true,5655,5302,353,0,00:00:00.000,2025-04-15 11:04:15.579
false,true,5655,5302,353,0,00:00:00.000,2025-04-15 11:04:16.580
false,false,5660,5306,354,157,00:00:33.000,2025-04-15 11:04:24.588
false,true,5663,5308,355,0,00:00:00.000,2025-04-15 11:04:36.600
false,true,5663,5308,355,0,00:00:00.000,2025-04-15 11:04:37.601
false,false,5681,5325,356,573,00:00:33.000,2025-04-15 11:04:57.625
false,true,5685,5329,356,0,00:00:00.000,2025-04-15 11:05:04.633
false,true,5685,5329,356,0,00:00:00.000,2025-04-15 11:05:05.634
false,false,5405,5065,340,1304,00:00:33.000,2025-04-15 10:58:27.222
false,true,5406,5066,340,0,00:00:00.000,2025-04-15 10:58:32.229
false,false,5420,5078,342,440,00:00:33.000,2025-04-15 10:58:48.249
false,false,5421,5079,342,470,00:00:30.000,2025-04-15 10:58:49.249
false,false,5438,5095,343,92,00:00:30.000,2025-04-15 10:59:18.278
false,false,5447,5104,343,379,00:00:31.000,2025-04-15 10:59:27.285
false,false,5462,5118,344,477,00:00:31.000,2025-04-15 10:59:48.306
false,false,5882,5513,369,754,00:00:33.000,2025-04-15 11:10:12.950
false,true,5884,5515,369,0,00:00:00.000,2025-04-15 11:10:23.959
false,false,5885,5516,369,33,00:00:33.000,2025-04-15 11:10:27.962
false,false,5899,5529,370,127,00:00:30.000,2025-04-15 11:10:53.988
false,true,5905,5535,370,0,00:00:00.000,2025-04-15 11:11:10.003
false,false,5917,5546,371,374,00:00:31.000,2025-04-15 11:11:24.019
false,true,5807,5441,366,0,00:00:00.000,2025-04-15 11:08:27.841
false,true,5808,5442,366,0,00:00:00.000,2025-04-15 11:08:31.846
false,false,5810,5444,366,63,00:00:31.000,2025-04-15 11:08:36.852
false,true,5819,5452,367,0,00:00:00.000,2025-04-15 11:08:53.871
false,false,5827,5459,368,253,00:00:31.000,2025-04-15 11:09:05.882
false,true,5842,5474,368,0,00:00:00.000,2025-04-15 11:09:26.905
false,false,5846,5478,368,126,00:00:30.000,2025-04-15 11:09:30.909
false,true,5858,5489,369,0,00:00:00.000,2025-04-15 11:09:43.917
false,false,5866,5497,369,252,00:00:31.000,2025-04-15 11:09:56.937
false,false,5869,5500,369,345,00:00:30.000,2025-04-15 11:09:59.940
false,false,5941,5569,372,126,00:00:31.000,2025-04-15 11:12:00.048
false,false,5943,5571,372,186,00:00:30.000,2025-04-15 11:12:02.048
false,false,5958,5586,372,664,00:00:31.000,2025-04-15 11:12:17.062
false,false,5965,5593,372,880,00:00:30.000,2025-04-15 11:12:24.071
false,true,5968,5595,373,0,00:00:00.000,2025-04-15 11:12:32.078
false,true,5996,5620,376,0,00:00:00.000,2025-04-15 11:13:07.116
false,false,6003,5627,376,188,00:00:32.000,2025-04-15 11:13:20.130
false,true,6004,5628,376,0,00:00:00.000,2025-04-15 11:13:26.135
false,false,5752,5392,360,347,00:00:30.000,2025-04-15 11:06:56.741
false,false,5761,5400,361,632,00:00:33.000,2025-04-15 11:07:05.752
false,true,5761,5400,361,0,00:00:00.000,2025-04-15 11:07:06.753
false,true,5764,5402,362,0,00:00:00.000,2025-04-15 11:07:19.767
false,false,5767,5405,362,97,00:00:33.000,2025-04-15 11:07:29.780
false,false,5774,5411,363,318,00:00:31.000,2025-04-15 11:07:36.786
false,true,5774,5411,363,0,00:00:00.000,2025-04-15 11:07:42.794
false,true,6006,5630,376,0,00:00:00.000,2025-04-15 11:13:35.142
false,true,6008,5632,376,0,00:00:00.000,2025-04-15 11:13:42.150
false,false,6032,5654,378,760,00:00:32.000,2025-04-15 11:14:07.177
false,true,6041,5663,378,0,00:00:00.000,2025-04-15 11:14:29.196
false,false,6062,5684,378,659,00:00:33.000,2025-04-15 11:14:55.223
false,false,6063,5685,378,692,00:00:33.000,2025-04-15 11:14:56.225
false,false,6231,5844,387,253,00:00:30.000,2025-04-15 11:18:32.447
false,true,6260,5873,387,0,00:00:00.000,2025-04-15 11:19:10.491
false,false,6270,5883,387,314,00:00:31.000,2025-04-15 11:19:23.504
false,false,6275,5888,387,61,00:00:30.000,2025-04-15 11:19:34.516
false,false,6286,5899,387,190,00:00:30.000,2025-04-15 11:19:51.533
false,false,6290,5903,387,316,00:00:31.000,2025-04-15 11:19:55.537
false,false,6079,5700,379,33,00:00:33.000,2025-04-15 11:15:30.260
false,false,6083,5704,379,160,00:00:33.000,2025-04-15 11:15:34.265
false,false,6087,5708,379,289,00:00:33.000,2025-04-15 11:15:38.272
false,false,6104,5725,379,347,00:00:31.000,2025-04-15 11:16:01.294
false,false,6106,5727,379,408,00:00:30.000,2025-04-15 11:16:03.297
false,false,6110,5731,379,535,00:00:32.000,2025-04-15 11:16:07.303
false,true,6111,5732,379,0,00:00:00.000,2025-04-15 11:16:10.306
false,true,6111,5732,379,0,00:00:00.000,2025-04-15 11:16:13.309
false,false,6141,5760,381,949,00:00:31.000,2025-04-15 11:16:44.340
false,false,6144,5763,381,1045,00:00:32.000,2025-04-15 11:16:47.341
false,false,6151,5770,381,1267,00:00:32.000,2025-04-15 11:16:54.347
false,true,6185,5801,384,0,00:00:00.000,2025-04-15 11:17:29.381
false,false,6187,5803,384,62,00:00:30.000,2025-04-15 11:17:36.388
false,false,6196,5811,385,347,00:00:30.000,2025-04-15 11:17:45.400
false,true,6196,5811,385,0,00:00:00.000,2025-04-15 11:17:48.402
false,false,6212,5825,387,505,00:00:30.000,2025-04-15 11:18:07.422
false,true,6223,5836,387,0,00:00:00.000,2025-04-15 11:18:20.435
false,false,6226,5839,387,95,00:00:32.000,2025-04-15 11:18:27.442
false,true,6335,5945,390,0,00:00:00.000,2025-04-15 11:21:00.600
false,false,6343,5952,391,250,00:00:30.000,2025-04-15 11:21:12.613
false,false,6366,5975,391,973,00:00:31.000,2025-04-15 11:21:35.634
false,true,6373,5982,391,0,00:00:00.000,2025-04-15 11:21:44.640
false,false,6590,6185,405,60,00:00:30.000,2025-04-15 11:27:13.991
false,false,6512,6114,398,447,00:00:32.000,2025-04-15 11:25:31.886
false,false,6520,6121,399,701,00:00:30.000,2025-04-15 11:25:39.896
false,false,6530,6131,399,1013,00:00:31.000,2025-04-15 11:25:49.910
false,false,6543,6141,402,1430,00:00:32.000,2025-04-15 11:26:02.917
false,true,6568,6164,404,0,00:00:00.000,2025-04-15 11:26:34.953
false,true,6373,5982,391,0,00:00:00.000,2025-04-15 11:21:48.644
false,true,6380,5989,391,0,00:00:00.000,2025-04-15 11:22:01.655
false,true,6399,6007,392,0,00:00:00.000,2025-04-15 11:22:38.700
false,true,6415,6022,393,0,00:00:00.000,2025-04-15 11:22:57.724
false,false,6423,6030,393,216,00:00:31.000,2025-04-15 11:23:14.736
false,true,6428,6035,393,0,00:00:00.000,2025-04-15 11:23:36.765
false,false,6452,6058,394,159,00:00:33.000,2025-04-15 11:24:13.803
false,false,6457,6062,395,314,00:00:31.000,2025-04-15 11:24:18.811
false,false,6459,6064,395,377,00:00:31.000,2025-04-15 11:24:20.814
false,false,6460,6065,395,407,00:00:30.000,2025-04-15 11:24:21.815
false,false,6463,6068,395,499,00:00:31.000,2025-04-15 11:24:24.819
false,false,6468,6072,396,160,00:00:31.000,2025-04-15 11:24:35.830
false,false,6469,6073,396,32,00:00:32.000,2025-04-15 11:24:42.834
false,false,6473,6077,396,158,00:00:32.000,2025-04-15 11:24:46.838
false,false,6476,6080,396,254,00:00:33.000,2025-04-15 11:24:49.841
false,false,6644,6235,409,346,00:00:31.000,2025-04-15 11:28:44.075
false,false,6645,6236,409,376,00:00:30.000,2025-04-15 11:28:45.075
false,false,6649,6239,410,506,00:00:32.000,2025-04-15 11:28:49.077
false,false,6652,6242,410,597,00:00:30.000,2025-04-15 11:28:52.079
false,true,6659,6248,411,0,00:00:00.000,2025-04-15 11:29:07.097
false,true,6659,6248,411,0,00:00:00.000,2025-04-15 11:29:08.098
false,false,6677,6264,413,159,00:00:32.000,2025-04-15 11:29:47.138
false,false,6851,6431,420,281,00:00:33.000,2025-04-15 11:33:59.384
false,true,6855,6435,420,0,00:00:00.000,2025-04-15 11:34:10.396
false,false,6859,6439,420,125,00:00:30.000,2025-04-15 11:34:19.407
false,false,6871,6450,421,506,00:00:33.000,2025-04-15 11:34:31.422
false,true,6882,6460,422,0,00:00:00.000,2025-04-15 11:34:51.444
false,false,6883,6461,422,31,00:00:31.000,2025-04-15 11:34:55.449
false,true,6891,6469,422,0,00:00:00.000,2025-04-15 11:35:05.456
false,false,6721,6306,415,785,00:00:30.000,2025-04-15 11:30:43.188
false,false,6730,6315,415,1070,00:00:31.000,2025-04-15 11:30:52.194
false,false,6739,6324,415,1357,00:00:31.000,2025-04-15 11:31:01.205
false,false,6755,6340,415,1865,00:00:33.000,2025-04-15 11:31:17.222
false,false,6766,6349,417,2212,00:00:31.000,2025-04-15 11:31:28.233
false,false,6780,6362,418,2657,00:00:33.000,2025-04-15 11:31:42.246
false,false,6785,6366,419,2811,00:00:31.000,2025-04-15 11:31:47.249
false,true,6893,6471,422,0,00:00:00.000,2025-04-15 11:35:15.467
false,false,6897,6475,422,125,00:00:31.000,2025-04-15 11:35:21.472
false,false,6904,6482,422,33,00:00:33.000,2025-04-15 11:35:34.486
false,false,6914,6492,422,344,00:00:33.000,2025-04-15 11:35:44.499
false,false,6938,6516,422,1108,00:00:32.000,2025-04-15 11:36:08.524
false,true,6960,6535,425,0,00:00:00.000,2025-04-15 11:36:33.545
false,true,7075,6644,431,0,00:00:00.000,2025-04-15 11:39:04.698
false,false,7106,6674,432,975,00:00:30.000,2025-04-15 11:39:38.742
false,false,7110,6678,432,1104,00:00:30.000,2025-04-15 11:39:42.748
false,false,7119,6687,432,1391,00:00:31.000,2025-04-15 11:39:51.758
false,true,6786,6367,419,0,00:00:00.000,2025-04-15 11:31:54.255
false,false,6787,6368,419,32,00:00:32.000,2025-04-15 11:31:55.257
false,false,6791,6372,419,155,00:00:33.000,2025-04-15 11:31:59.260
false,false,6810,6391,419,64,00:00:31.000,2025-04-15 11:32:42.301
false,true,6819,6400,419,0,00:00:00.000,2025-04-15 11:32:56.318
false,true,6820,6401,419,0,00:00:00.000,2025-04-15 11:33:01.324
false,true,6965,6539,426,0,00:00:00.000,2025-04-15 11:36:50.563
false,true,6965,6539,426,0,00:00:00.000,2025-04-15 11:36:52.564
false,false,6966,6540,426,33,00:00:33.000,2025-04-15 11:36:54.566
false,false,6968,6542,426,95,00:00:32.000,2025-04-15 11:36:56.568
false,true,6968,6542,426,0,00:00:00.000,2025-04-15 11:36:57.569
false,true,6968,6542,426,0,00:00:00.000,2025-04-15 11:37:02.575
false,false,6970,6544,426,62,00:00:32.000,2025-04-15 11:37:04.578
false,false,6976,6550,426,255,00:00:33.000,2025-04-15 11:37:10.586
false,false,7003,6576,427,348,00:00:32.000,2025-04-15 11:37:43.616
false,false,7009,6582,427,539,00:00:33.000,2025-04-15 11:37:49.621
false,false,7015,6588,427,732,00:00:33.000,2025-04-15 11:37:55.627
false,false,7046,6616,430,1707,00:00:32.000,2025-04-15 11:38:26.663
false,false,7143,6708,435,2146,00:00:32.000,2025-04-15 11:40:15.784
false,false,7172,6732,440,33,00:00:33.000,2025-04-15 11:41:02.838
false,false,7190,6749,441,600,00:00:30.000,2025-04-15 11:41:20.857
false,false,7191,6750,441,633,00:00:33.000,2025-04-15 11:41:21.858
false,false,7199,6758,441,889,00:00:32.000,2025-04-15 11:41:29.866
false,false,7200,6759,441,920,00:00:31.000,2025-04-15 11:41:30.868
false,true,7355,6902,453,0,00:00:00.000,2025-04-15 11:45:13.102
false,false,7401,6943,458,690,00:00:33.000,2025-04-15 11:46:10.158
false,true,7216,6771,445,0,00:00:00.000,2025-04-15 11:41:59.898
false,true,7216,6771,445,0,00:00:00.000,2025-04-15 11:42:04.902
false,false,7217,6772,445,32,00:00:32.000,2025-04-15 11:42:05.904
false,false,7233,6787,446,437,00:00:32.000,2025-04-15 11:42:27.931
false,false,7248,6801,447,187,00:00:33.000,2025-04-15 11:42:48.949
false,false,7254,6807,447,374,00:00:30.000,2025-04-15 11:42:54.955
false,false,7261,6814,447,219,00:00:31.000,2025-04-15 11:43:07.970
false,false,7276,6828,448,94,00:00:31.000,2025-04-15 11:43:28.993
false,true,7417,6958,459,0,00:00:00.000,2025-04-15 11:46:50.200
false,true,7422,6963,459,0,00:00:00.000,2025-04-15 11:46:57.208
false,false,7424,6965,459,64,00:00:33.000,2025-04-15 11:47:03.211
false,false,7455,6995,460,415,00:00:33.000,2025-04-15 11:47:40.257
false,false,7461,7001,460,605,00:00:33.000,2025-04-15 11:47:46.266
false,false,7462,7002,460,638,00:00:33.000,2025-04-15 11:47:47.267
false,false,7471,7010,461,154,00:00:30.000,2025-04-15 11:48:08.289
false,false,7481,7018,463,467,00:00:31.000,2025-04-15 11:48:18.302
false,false,7486,7023,463,626,00:00:33.000,2025-04-15 11:48:23.306
false,false,7495,7032,463,192,00:00:33.000,2025-04-15 11:48:38.325
false,false,7501,7038,463,189,00:00:31.000,2025-04-15 11:48:50.342
false,false,7513,7049,464,566,00:00:32.000,2025-04-15 11:49:02.355
false,true,7528,7063,465,0,00:00:00.000,2025-04-15 11:49:18.366
false,false,7546,7081,465,30,00:00:30.000,2025-04-15 11:49:53.403
false,false,7550,7084,466,158,00:00:33.000,2025-04-15 11:49:57.405
false,false,7552,7086,466,223,00:00:32.000,2025-04-15 11:49:59.406
false,false,7322,6873,449,156,00:00:30.000,2025-04-15 11:44:33.057
false,false,7570,7104,466,342,00:00:30.000,2025-04-15 11:50:23.430
false,false,7575,7109,466,158,00:00:33.000,2025-04-15 11:50:34.439
false,false,7580,7114,466,312,00:00:30.000,2025-04-15 11:50:39.443
false,false,7596,7129,467,504,00:00:33.000,2025-04-15 11:51:01.458
false,false,7623,7156,467,1348,00:00:30.000,2025-04-15 11:51:28.487
false,false,7630,7163,467,1566,00:00:30.000,2025-04-15 11:51:35.493
false,false,7741,7273,468,790,00:00:33.000,2025-04-15 11:53:56.652
false,false,7762,7292,470,1450,00:00:31.000,2025-04-15 11:54:17.678
false,true,7763,7293,470,0,00:00:00.000,2025-04-15 11:54:21.682
false,false,7764,7294,470,33,00:00:33.000,2025-04-15 11:54:31.692
false,false,7772,7302,470,95,00:00:31.000,2025-04-15 11:54:45.707
false,false,7650,7183,467,2197,00:00:32.000,2025-04-15 11:51:55.512
false,true,7690,7222,468,0,00:00:00.000,2025-04-15 11:52:49.575
false,false,7699,7231,468,284,00:00:31.000,2025-04-15 11:53:02.592
false,false,7702,7234,468,65,00:00:32.000,2025-04-15 11:53:11.599
false,false,7795,7325,470,188,00:00:31.000,2025-04-15 11:55:20.744
false,false,7800,7330,470,348,00:00:33.000,2025-04-15 11:55:25.750
false,false,7808,7338,470,220,00:00:30.000,2025-04-15 11:55:39.766
false,false,7810,7340,470,283,00:00:33.000,2025-04-15 11:55:41.769
false,true,7811,7341,470,0,00:00:00.000,2025-04-15 11:55:47.776
false,false,7817,7347,470,187,00:00:32.000,2025-04-15 11:55:54.782
false,false,7821,7349,472,129,00:00:32.000,2025-04-15 11:56:04.791
false,true,7824,7351,473,0,00:00:00.000,2025-04-15 11:56:16.804
false,true,7828,7355,473,0,00:00:00.000,2025-04-15 11:56:24.814
false,true,7829,7356,473,0,00:00:00.000,2025-04-15 11:56:31.821
false,false,7843,7370,473,446,00:00:32.000,2025-04-15 11:56:50.842
false,true,7870,7396,474,0,00:00:00.000,2025-04-15 11:57:28.888
false,false,7900,7426,474,957,00:00:32.000,2025-04-15 11:58:05.930
false,false,7920,7445,475,1582,00:00:33.000,2025-04-15 11:58:25.948
false,true,8016,7538,478,0,00:00:00.000,2025-04-15 12:00:34.079
false,true,8016,7538,478,0,00:00:00.000,2025-04-15 12:00:38.083
false,true,8017,7538,479,0,00:00:00.000,2025-04-15 12:00:45.088
false,false,8026,7547,479,279,00:00:33.000,2025-04-15 12:00:54.097
false,true,8035,7556,479,0,00:00:00.000,2025-04-15 12:01:08.112
false,false,8041,7562,479,188,00:00:31.000,2025-04-15 12:01:15.116
false,false,5250,4923,327,599,00:00:33.000,2025-04-15 10:55:16.039
false,false,5263,4936,327,1005,00:00:30.000,2025-04-15 10:55:29.053
false,true,5264,4937,327,0,00:00:00.000,2025-04-15 10:55:31.055
false,false,5273,4945,328,284,00:00:32.000,2025-04-15 10:55:45.070
false,false,5284,4955,329,632,00:00:33.000,2025-04-15 10:55:56.081
false,true,5303,4972,331,0,00:00:00.000,2025-04-15 10:56:22.103
false,false,5320,4985,335,538,00:00:33.000,2025-04-15 10:56:44.124
false,false,4961,4656,305,96,00:00:33.000,2025-04-15 10:48:56.650
false,false,4965,4660,305,95,00:00:31.000,2025-04-15 10:49:06.662
false,true,4975,4670,305,0,00:00:00.000,2025-04-15 10:49:17.674
false,false,4988,4681,307,415,00:00:32.000,2025-04-15 10:49:35.693
false,false,5005,4696,309,310,00:00:32.000,2025-04-15 10:49:58.722
false,false,5007,4698,309,372,00:00:30.000,2025-04-15 10:50:00.724
false,true,5010,4701,309,0,00:00:00.000,2025-04-15 10:50:07.734
false,false,5030,4721,309,502,00:00:31.000,2025-04-15 10:50:35.767
false,false,5038,4729,309,752,00:00:33.000,2025-04-15 10:50:43.774
false,false,5039,4729,310,784,00:00:32.000,2025-04-15 10:50:44.774
false,false,5045,4733,312,969,00:00:32.000,2025-04-15 10:50:50.780
false,false,5082,4766,316,91,00:00:31.000,2025-04-15 10:51:33.829
false,true,5083,4767,316,0,00:00:00.000,2025-04-15 10:51:40.835
false,false,5181,4859,322,1038,00:00:33.000,2025-04-15 10:53:42.949
false,false,5196,4872,324,283,00:00:31.000,2025-04-15 10:54:03.967
false,false,5211,4887,324,160,00:00:33.000,2025-04-15 10:54:24.990
false,false,5221,4895,326,312,00:00:33.000,2025-04-15 10:54:41.005
false,false,5230,4904,326,594,00:00:33.000,2025-04-15 10:54:50.014
false,true,5231,4905,326,0,00:00:00.000,2025-04-15 10:54:56.020
false,false,5479,5135,344,184,00:00:32.000,2025-04-15 11:00:17.337
false,true,5488,5144,344,0,00:00:00.000,2025-04-15 11:00:28.346
false,false,5490,5146,344,63,00:00:30.000,2025-04-15 11:00:34.355
false,true,5511,5163,348,0,00:00:00.000,2025-04-15 11:01:00.380
false,false,5529,5181,348,411,00:00:33.000,2025-04-15 11:01:25.407
false,true,5540,5191,349,0,00:00:00.000,2025-04-15 11:01:41.424
false,false,5553,5203,350,415,00:00:30.000,2025-04-15 11:01:55.437
false,false,5565,5215,350,787,00:00:30.000,2025-04-15 11:02:07.451
false,false,5573,5223,350,1041,00:00:33.000,2025-04-15 11:02:15.459
false,true,5595,5245,350,0,00:00:00.000,2025-04-15 11:02:51.488
false,true,5687,5331,356,0,00:00:00.000,2025-04-15 11:05:11.640
false,false,5688,5332,356,31,00:00:31.000,2025-04-15 11:05:16.644
false,false,5701,5345,356,440,00:00:30.000,2025-04-15 11:05:29.658
false,true,5701,5345,356,0,00:00:00.000,2025-04-15 11:05:37.663
false,true,5710,5353,357,0,00:00:00.000,2025-04-15 11:05:56.685
false,true,5712,5355,357,0,00:00:00.000,2025-04-15 11:06:03.692
false,true,5712,5355,357,0,00:00:00.000,2025-04-15 11:06:04.693
false,true,5741,5381,360,0,00:00:00.000,2025-04-15 11:06:42.730
false,false,5618,5268,350,474,00:00:31.000,2025-04-15 11:03:30.532
false,false,5627,5277,350,752,00:00:31.000,2025-04-15 11:03:39.541
false,false,5629,5279,350,814,00:00:32.000,2025-04-15 11:03:41.542
false,false,5648,5295,353,1415,00:00:31.000,2025-04-15 11:04:00.561
false,false,5664,5309,355,32,00:00:32.000,2025-04-15 11:04:40.605
false,false,5679,5323,356,509,00:00:30.000,2025-04-15 11:04:55.623
false,true,5424,5082,342,0,00:00:00.000,2025-04-15 10:58:58.260
false,false,5433,5090,343,280,00:00:31.000,2025-04-15 10:59:07.269
false,false,5435,5092,343,342,00:00:31.000,2025-04-15 10:59:09.270
false,true,5435,5092,343,0,00:00:00.000,2025-04-15 10:59:11.271
false,false,5469,5125,344,695,00:00:32.000,2025-04-15 10:59:55.315
false,true,5470,5126,344,0,00:00:00.000,2025-04-15 11:00:02.319
false,true,5884,5515,369,0,00:00:00.000,2025-04-15 11:10:26.962
false,false,5888,5518,370,126,00:00:30.000,2025-04-15 11:10:30.965
false,true,5888,5518,370,0,00:00:00.000,2025-04-15 11:10:32.967
false,false,5932,5560,372,848,00:00:30.000,2025-04-15 11:11:39.028
false,true,5813,5447,366,0,00:00:00.000,2025-04-15 11:08:40.856
false,false,5848,5480,368,189,00:00:31.000,2025-04-15 11:09:32.912
false,false,5849,5481,368,221,00:00:32.000,2025-04-15 11:09:33.913
false,false,5856,5488,368,441,00:00:32.000,2025-04-15 11:09:40.916
false,true,5858,5489,369,0,00:00:00.000,2025-04-15 11:09:45.921
false,false,5873,5504,369,471,00:00:30.000,2025-04-15 11:10:03.943
false,true,5937,5565,372,0,00:00:00.000,2025-04-15 11:11:55.045
false,false,5960,5588,372,728,00:00:32.000,2025-04-15 11:12:19.065
false,true,5996,5620,376,0,00:00:00.000,2025-04-15 11:13:02.110
false,true,5997,5621,376,0,00:00:00.000,2025-04-15 11:13:11.120
false,true,6004,5628,376,0,00:00:00.000,2025-04-15 11:13:25.134
false,false,5748,5388,360,223,00:00:33.000,2025-04-15 11:06:52.739
false,false,5763,5401,362,60,00:00:30.000,2025-04-15 11:07:13.760
false,false,5764,5402,362,91,00:00:31.000,2025-04-15 11:07:14.761
false,true,5764,5402,362,0,00:00:00.000,2025-04-15 11:07:25.776
false,false,5776,5412,364,62,00:00:31.000,2025-04-15 11:07:44.796
false,true,6006,5630,376,0,00:00:00.000,2025-04-15 11:13:30.137
false,false,6017,5639,378,291,00:00:33.000,2025-04-15 11:13:52.162
false,false,6030,5652,378,695,00:00:31.000,2025-04-15 11:14:05.175
false,true,6041,5663,378,0,00:00:00.000,2025-04-15 11:14:33.199
false,false,6057,5679,378,499,00:00:30.000,2025-04-15 11:14:50.217
false,false,6060,5682,378,595,00:00:33.000,2025-04-15 11:14:53.220
false,true,6232,5845,387,0,00:00:00.000,2025-04-15 11:18:34.449
false,false,6234,5847,387,60,00:00:30.000,2025-04-15 11:18:41.456
false,true,6273,5886,387,0,00:00:00.000,2025-04-15 11:19:29.510
false,false,6285,5898,387,160,00:00:33.000,2025-04-15 11:19:50.532
false,true,6292,5904,388,0,00:00:00.000,2025-04-15 11:20:00.540
false,true,6078,5699,379,0,00:00:00.000,2025-04-15 11:15:26.256
false,false,6089,5710,379,354,00:00:32.000,2025-04-15 11:15:40.274
false,true,6111,5732,379,0,00:00:00.000,2025-04-15 11:16:14.310
false,false,6143,5762,381,1013,00:00:33.000,2025-04-15 11:16:46.341
false,false,6153,5772,381,1332,00:00:33.000,2025-04-15 11:16:56.350
false,false,6155,5774,381,1393,00:00:31.000,2025-04-15 11:16:58.351
false,false,6176,5792,384,2049,00:00:31.000,2025-04-15 11:17:19.370
false,true,6185,5801,384,0,00:00:00.000,2025-04-15 11:17:33.385
false,false,6192,5807,385,222,00:00:32.000,2025-04-15 11:17:41.396
false,false,6209,5824,385,410,00:00:30.000,2025-04-15 11:18:04.419
false,false,6214,5827,387,568,00:00:32.000,2025-04-15 11:18:09.424
false,true,6223,5836,387,0,00:00:00.000,2025-04-15 11:18:22.437
false,true,6299,5911,388,0,00:00:00.000,2025-04-15 11:20:15.554
false,false,6317,5928,389,497,00:00:31.000,2025-04-15 11:20:40.579
false,false,6318,5929,389,528,00:00:31.000,2025-04-15 11:20:41.580
false,false,6337,5947,390,63,00:00:33.000,2025-04-15 11:21:06.606
false,false,6341,5951,390,187,00:00:33.000,2025-04-15 11:21:10.610
false,false,6349,5958,391,437,00:00:31.000,2025-04-15 11:21:18.618
false,false,6353,5962,391,561,00:00:33.000,2025-04-15 11:21:22.620
false,false,6589,6184,405,30,00:00:30.000,2025-04-15 11:27:12.991
false,true,6611,6205,406,0,00:00:00.000,2025-04-15 11:27:50.023
false,true,6611,6205,406,0,00:00:00.000,2025-04-15 11:27:52.026
false,true,6631,6224,407,0,00:00:00.000,2025-04-15 11:28:20.053
false,true,6631,6224,407,0,00:00:00.000,2025-04-15 11:28:21.053
false,false,6497,6099,398,918,00:00:32.000,2025-04-15 11:25:10.865
false,false,6523,6124,399,796,00:00:33.000,2025-04-15 11:25:42.901
false,false,6536,6137,399,1204,00:00:30.000,2025-04-15 11:25:55.913
false,false,6542,6141,401,1398,00:00:33.000,2025-04-15 11:26:01.917
false,false,6576,6172,404,249,00:00:31.000,2025-04-15 11:26:47.967
false,false,6375,5984,391,64,00:00:31.000,2025-04-15 11:21:50.645
false,false,6379,5988,391,189,00:00:31.000,2025-04-15 11:21:54.648
false,false,6387,5996,391,226,00:00:33.000,2025-04-15 11:22:08.663
false,true,6394,6003,391,0,00:00:00.000,2025-04-15 11:22:27.687
false,false,6398,6006,392,127,00:00:32.000,2025-04-15 11:22:31.692
false,false,6421,6028,393,154,00:00:30.000,2025-04-15 11:23:12.734
false,true,6425,6032,393,0,00:00:00.000,2025-04-15 11:23:20.743
false,true,6428,6035,393,0,00:00:00.000,2025-04-15 11:23:32.758
false,false,6429,6036,393,31,00:00:31.000,2025-04-15 11:23:38.767
false,false,6431,6037,394,65,00:00:32.000,2025-04-15 11:23:46.773
false,false,6443,6049,394,441,00:00:31.000,2025-04-15 11:23:58.788
false,true,6463,6068,395,0,00:00:00.000,2025-04-15 11:24:26.821
false,true,6463,6068,395,0,00:00:00.000,2025-04-15 11:24:29.824
false,true,6633,6225,408,0,00:00:00.000,2025-04-15 11:28:31.061
false,false,6635,6227,408,65,00:00:33.000,2025-04-15 11:28:35.064
false,false,6658,6247,411,784,00:00:30.000,2025-04-15 11:28:58.090
false,false,6659,6248,411,814,00:00:30.000,2025-04-15 11:28:59.090
false,true,6659,6248,411,0,00:00:00.000,2025-04-15 11:29:00.091
false,false,6666,6254,412,218,00:00:30.000,2025-04-15 11:29:18.111
false,true,6667,6255,412,0,00:00:00.000,2025-04-15 11:29:24.117
false,true,6668,6256,412,0,00:00:00.000,2025-04-15 11:29:29.118
false,false,6678,6265,413,191,00:00:32.000,2025-04-15 11:29:48.139
false,true,6692,6278,414,0,00:00:00.000,2025-04-15 11:30:05.157
false,true,6838,6419,419,0,00:00:00.000,2025-04-15 11:33:40.366
false,false,6840,6421,419,63,00:00:33.000,2025-04-15 11:33:42.369
false,false,6845,6425,420,92,00:00:30.000,2025-04-15 11:33:53.378
false,false,6849,6429,420,218,00:00:31.000,2025-04-15 11:33:57.382
false,false,6857,6437,420,62,00:00:31.000,2025-04-15 11:34:17.405
false,false,6858,6438,420,95,00:00:33.000,2025-04-15 11:34:18.406
false,false,6861,6441,420,189,00:00:31.000,2025-04-15 11:34:21.409
false,false,6877,6455,422,699,00:00:32.000,2025-04-15 11:34:37.427
false,false,6740,6325,415,1388,00:00:31.000,2025-04-15 11:31:02.205
false,false,6760,6344,416,2024,00:00:32.000,2025-04-15 11:31:22.226
false,false,6920,6498,422,535,00:00:32.000,2025-04-15 11:35:50.506
false,false,6949,6526,423,1454,00:00:31.000,2025-04-15 11:36:19.532
false,true,6960,6535,425,0,00:00:00.000,2025-04-15 11:36:35.547
false,true,6964,6538,426,0,00:00:00.000,2025-04-15 11:36:44.558
false,false,7055,6625,430,219,00:00:30.000,2025-04-15 11:38:41.677
false,false,7073,6642,431,792,00:00:32.000,2025-04-15 11:38:59.693
false,true,7075,6644,431,0,00:00:00.000,2025-04-15 11:39:03.698
false,true,7075,6644,431,0,00:00:00.000,2025-04-15 11:39:06.698
false,false,7083,6652,431,252,00:00:30.000,2025-04-15 11:39:15.709
false,false,7098,6666,432,726,00:00:30.000,2025-04-15 11:39:30.733
false,false,7114,6682,432,1235,00:00:32.000,2025-04-15 11:39:46.754
false,false,6807,6388,419,154,00:00:32.000,2025-04-15 11:32:27.285
false,false,6830,6411,419,314,00:00:33.000,2025-04-15 11:33:14.341
false,true,6833,6414,419,0,00:00:00.000,2025-04-15 11:33:20.345
false,true,6833,6414,419,0,00:00:00.000,2025-04-15 11:33:22.347
false,false,6972,6546,426,127,00:00:33.000,2025-04-15 11:37:06.580
false,false,6988,6562,426,631,00:00:33.000,2025-04-15 11:37:22.596
false,false,6996,6569,427,128,00:00:30.000,2025-04-15 11:37:36.608
false,false,7012,6585,427,637,00:00:33.000,2025-04-15 11:37:52.624
false,false,7021,6593,428,920,00:00:30.000,2025-04-15 11:38:01.635
false,false,7025,6597,428,1045,00:00:33.000,2025-04-15 11:38:05.641
false,false,7036,6606,430,1392,00:00:32.000,2025-04-15 11:38:16.651
false,false,7138,6703,435,1988,00:00:31.000,2025-04-15 11:40:10.778
false,false,7144,6709,435,2177,00:00:31.000,2025-04-15 11:40:16.785
false,true,7145,6710,435,0,00:00:00.000,2025-04-15 11:40:19.787
false,false,7174,6734,440,95,00:00:30.000,2025-04-15 11:41:04.839
false,false,7197,6756,441,825,00:00:33.000,2025-04-15 11:41:27.863
false,true,7202,6760,442,0,00:00:00.000,2025-04-15 11:41:35.872
false,true,7355,6902,453,0,00:00:00.000,2025-04-15 11:45:17.105
false,false,7371,6916,455,508,00:00:31.000,2025-04-15 11:45:34.122
false,false,7373,6918,455,572,00:00:33.000,2025-04-15 11:45:36.123
false,false,7398,6940,458,596,00:00:31.000,2025-04-15 11:46:07.154
false,true,7406,6948,458,0,00:00:00.000,2025-04-15 11:46:29.180
false,false,7416,6957,459,312,00:00:32.000,2025-04-15 11:46:43.194
false,true,7219,6774,445,0,00:00:00.000,2025-04-15 11:42:12.912
false,false,7259,6812,447,156,00:00:31.000,2025-04-15 11:43:05.969
false,false,7260,6813,447,188,00:00:32.000,2025-04-15 11:43:06.969
false,true,7273,6825,448,0,00:00:00.000,2025-04-15 11:43:22.986
false,true,7273,6825,448,0,00:00:00.000,2025-04-15 11:43:23.989
false,false,7275,6827,448,63,00:00:30.000,2025-04-15 11:43:27.992
false,true,7422,6963,459,0,00:00:00.000,2025-04-15 11:46:56.207
false,true,7422,6963,459,0,00:00:00.000,2025-04-15 11:47:00.209
false,false,7437,6978,459,474,00:00:32.000,2025-04-15 11:47:16.230
false,false,7442,6982,460,629,00:00:30.000,2025-04-15 11:47:21.236
false,false,7445,6985,460,93,00:00:31.000,2025-04-15 11:47:30.244
false,false,7465,7005,460,31,00:00:31.000,2025-04-15 11:47:56.277
false,false,7478,7016,462,371,00:00:32.000,2025-04-15 11:48:15.297
false,false,7488,7025,463,692,00:00:33.000,2025-04-15 11:48:25.309
false,true,7528,7063,465,0,00:00:00.000,2025-04-15 11:49:21.369
false,true,7528,7063,465,0,00:00:00.000,2025-04-15 11:49:23.371
false,false,7540,7075,465,379,00:00:30.000,2025-04-15 11:49:35.383
false,true,7540,7075,465,0,00:00:00.000,2025-04-15 11:49:37.387
false,true,7540,7075,465,0,00:00:00.000,2025-04-15 11:49:40.390
false,true,7280,6832,448,0,00:00:00.000,2025-04-15 11:43:41.007
false,false,7295,6846,449,468,00:00:32.000,2025-04-15 11:44:00.020
false,false,7299,6850,449,595,00:00:33.000,2025-04-15 11:44:04.024
false,false,7303,6854,449,718,00:00:31.000,2025-04-15 11:44:08.029
false,true,7329,6880,449,0,00:00:00.000,2025-04-15 11:44:44.068
false,false,7349,6897,452,633,00:00:32.000,2025-04-15 11:45:06.095
false,false,7351,6898,453,697,00:00:33.000,2025-04-15 11:45:08.097
false,false,7579,7113,466,282,00:00:30.000,2025-04-15 11:50:38.441
false,false,7581,7115,466,33,00:00:33.000,2025-04-15 11:50:46.447
false,false,7582,7116,466,64,00:00:31.000,2025-04-15 11:50:47.448
false,false,7622,7155,467,1318,00:00:33.000,2025-04-15 11:51:27.486
false,false,7639,7172,467,1852,00:00:31.000,2025-04-15 11:51:44.501
false,false,7640,7173,467,1883,00:00:31.000,2025-04-15 11:51:45.502
false,false,7729,7261,468,407,00:00:33.000,2025-04-15 11:53:44.637
false,false,7735,7267,468,597,00:00:32.000,2025-04-15 11:53:50.644
false,false,7752,7283,469,1134,00:00:33.000,2025-04-15 11:54:07.667
false,false,7767,7297,470,130,00:00:32.000,2025-04-15 11:54:34.695
false,false,7770,7300,470,31,00:00:31.000,2025-04-15 11:54:43.706
false,false,7774,7304,470,158,00:00:31.000,2025-04-15 11:54:47.709
false,true,7774,7304,470,0,00:00:00.000,2025-04-15 11:54:50.711
false,false,7787,7317,470,403,00:00:31.000,2025-04-15 11:55:06.727
false,false,7788,7318,470,435,00:00:32.000,2025-04-15 11:55:07.729
false,false,7655,7188,467,2358,00:00:33.000,2025-04-15 11:52:00.516
false,false,7823,7350,473,191,00:00:31.000,2025-04-15 11:56:06.792
false,false,7836,7363,473,221,00:00:32.000,2025-04-15 11:56:43.832
false,false,7845,7372,473,31,00:00:31.000,2025-04-15 11:56:58.849
false,false,7852,7379,473,248,00:00:30.000,2025-04-15 11:57:05.856
false,false,7861,7387,474,525,00:00:32.000,2025-04-15 11:57:14.866
false,false,7869,7395,474,782,00:00:30.000,2025-04-15 11:57:22.877
false,false,7876,7402,474,192,00:00:33.000,2025-04-15 11:57:41.904
false,false,7878,7404,474,256,00:00:31.000,2025-04-15 11:57:43.906
false,false,7907,7433,474,1172,00:00:30.000,2025-04-15 11:58:12.938
false,false,7922,7447,475,1645,00:00:33.000,2025-04-15 11:58:27.949
false,true,8016,7538,478,0,00:00:00.000,2025-04-15 12:00:35.081
false,true,8017,7538,479,0,00:00:00.000,2025-04-15 12:00:41.084
false,false,8021,7542,479,121,00:00:31.000,2025-04-15 12:00:49.093
false,false,5262,4935,327,975,00:00:32.000,2025-04-15 10:55:28.053
false,false,5266,4939,327,64,00:00:33.000,2025-04-15 10:55:38.060
false,false,5277,4948,329,410,00:00:31.000,2025-04-15 10:55:49.072
false,false,5286,4957,329,694,00:00:30.000,2025-04-15 10:55:58.083
false,false,5302,4971,331,122,00:00:31.000,2025-04-15 10:56:20.101
false,false,4947,4643,304,279,00:00:30.000,2025-04-15 10:48:36.633
false,false,4953,4649,304,466,00:00:32.000,2025-04-15 10:48:42.637
false,false,4957,4653,304,588,00:00:32.000,2025-04-15 10:48:46.641
false,false,4978,4673,305,94,00:00:31.000,2025-04-15 10:49:25.684
false,false,4983,4676,307,257,00:00:33.000,2025-04-15 10:49:30.690
false,false,5016,4707,309,61,00:00:30.000,2025-04-15 10:50:21.752
false,false,5020,4711,309,187,00:00:31.000,2025-04-15 10:50:25.757
false,false,5057,4745,312,1347,00:00:30.000,2025-04-15 10:51:02.792
false,false,5079,4763,316,2036,00:00:31.000,2025-04-15 10:51:24.817
false,false,5083,4767,316,122,00:00:31.000,2025-04-15 10:51:34.829
false,true,5083,4767,316,0,00:00:00.000,2025-04-15 10:51:36.831
false,false,5185,4862,323,1166,00:00:32.000,2025-04-15 10:53:46.953
false,true,5187,4864,323,0,00:00:00.000,2025-04-15 10:53:51.957
false,false,5238,4912,326,221,00:00:30.000,2025-04-15 10:55:04.028
false,true,5488,5144,344,0,00:00:00.000,2025-04-15 11:00:29.348
false,false,5525,5177,348,285,00:00:31.000,2025-04-15 11:01:21.403
false,false,5532,5184,348,510,00:00:33.000,2025-04-15 11:01:28.411
false,false,5554,5204,350,446,00:00:31.000,2025-04-15 11:01:56.437
false,false,5575,5225,350,1103,00:00:32.000,2025-04-15 11:02:17.460
false,true,5590,5240,350,0,00:00:00.000,2025-04-15 11:02:39.476
false,true,5590,5240,350,0,00:00:00.000,2025-04-15 11:02:40.477
false,false,5592,5242,350,65,00:00:32.000,2025-04-15 11:02:46.483
false,true,5701,5345,356,0,00:00:00.000,2025-04-15 11:05:34.662
false,false,5741,5381,360,917,00:00:32.000,2025-04-15 11:06:33.720
false,true,5741,5381,360,0,00:00:00.000,2025-04-15 11:06:38.727
false,false,5637,5285,352,1068,00:00:32.000,2025-04-15 11:03:49.550
false,false,5668,5312,356,160,00:00:33.000,2025-04-15 11:04:44.609
false,false,5677,5321,356,447,00:00:30.000,2025-04-15 11:04:53.621
false,true,5406,5066,340,0,00:00:00.000,2025-04-15 10:58:33.230
false,false,5414,5073,341,250,00:00:30.000,2025-04-15 10:58:42.242
false,false,5424,5082,342,564,00:00:32.000,2025-04-15 10:58:52.253
false,true,5424,5082,342,0,00:00:00.000,2025-04-15 10:58:54.256
false,false,5452,5108,344,158,00:00:30.000,2025-04-15 10:59:38.297
false,false,5877,5508,369,595,00:00:30.000,2025-04-15 11:10:07.946
false,false,5890,5520,370,66,00:00:33.000,2025-04-15 11:10:38.972
false,false,5905,5535,370,63,00:00:33.000,2025-04-15 11:11:05.999
false,true,5935,5563,372,0,00:00:00.000,2025-04-15 11:11:45.033
false,true,5808,5442,366,0,00:00:00.000,2025-04-15 11:08:29.843
false,false,5811,5445,366,95,00:00:32.000,2025-04-15 11:08:37.853
false,true,5842,5474,368,0,00:00:00.000,2025-04-15 11:09:21.898
false,true,5937,5565,372,0,00:00:00.000,2025-04-15 11:11:51.041
false,false,5951,5579,372,438,00:00:31.000,2025-04-15 11:12:10.055
false,false,5952,5580,372,469,00:00:31.000,2025-04-15 11:12:11.057
false,false,5961,5589,372,758,00:00:30.000,2025-04-15 11:12:20.066
false,true,5968,5595,373,0,00:00:00.000,2025-04-15 11:12:33.080
false,false,5970,5596,374,63,00:00:33.000,2025-04-15 11:12:35.081
false,false,5983,5607,376,468,00:00:31.000,2025-04-15 11:12:48.097
false,true,5997,5621,376,0,00:00:00.000,2025-04-15 11:13:10.120
false,false,6002,5626,376,156,00:00:32.000,2025-04-15 11:13:19.128
false,false,5751,5391,360,317,00:00:30.000,2025-04-15 11:06:55.741
false,false,5754,5394,360,412,00:00:32.000,2025-04-15 11:06:58.743
false,true,5764,5402,362,0,00:00:00.000,2025-04-15 11:07:23.773
false,false,5765,5403,362,32,00:00:32.000,2025-04-15 11:07:27.778
false,true,5795,5430,365,0,00:00:00.000,2025-04-15 11:08:04.816
false,false,5805,5439,366,316,00:00:30.000,2025-04-15 11:08:19.831
false,false,6019,5641,378,353,00:00:32.000,2025-04-15 11:13:54.165
false,false,6028,5650,378,633,00:00:31.000,2025-04-15 11:14:03.172
false,false,6053,5675,378,375,00:00:32.000,2025-04-15 11:14:46.215
false,true,6065,5687,378,0,00:00:00.000,2025-04-15 11:15:03.232
false,false,6246,5859,387,443,00:00:33.000,2025-04-15 11:18:53.473
false,false,6268,5881,387,251,00:00:31.000,2025-04-15 11:19:21.501
false,false,6277,5890,387,127,00:00:33.000,2025-04-15 11:19:36.518
false,true,6280,5893,387,0,00:00:00.000,2025-04-15 11:19:45.525
false,false,6072,5694,378,223,00:00:32.000,2025-04-15 11:15:11.238
false,true,6077,5698,379,0,00:00:00.000,2025-04-15 11:15:21.252
false,true,6078,5699,379,0,00:00:00.000,2025-04-15 11:15:28.258
false,false,6105,5726,379,378,00:00:31.000,2025-04-15 11:16:02.295
false,false,6111,5732,379,567,00:00:32.000,2025-04-15 11:16:08.305
false,false,6154,5773,381,1362,00:00:30.000,2025-04-15 11:16:57.351
false,false,6159,5778,381,1518,00:00:33.000,2025-04-15 11:17:02.353
false,true,6185,5801,384,0,00:00:00.000,2025-04-15 11:17:30.381
false,false,6207,5822,385,349,00:00:33.000,2025-04-15 11:18:02.416
false,false,6218,5831,387,692,00:00:31.000,2025-04-15 11:18:13.428
false,false,6302,5914,388,31,00:00:31.000,2025-04-15 11:20:25.562
false,false,6322,5933,389,652,00:00:31.000,2025-04-15 11:20:45.583
false,true,6335,5945,390,0,00:00:00.000,2025-04-15 11:20:59.600
false,false,6597,6192,405,94,00:00:32.000,2025-04-15 11:27:27.005
false,true,6617,6211,406,0,00:00:00.000,2025-04-15 11:28:04.037
false,false,6629,6222,407,378,00:00:33.000,2025-04-15 11:28:17.051
false,false,6495,6097,398,853,00:00:30.000,2025-04-15 11:25:08.862
false,false,6509,6111,398,350,00:00:32.000,2025-04-15 11:25:28.884
false,false,6519,6120,399,671,00:00:31.000,2025-04-15 11:25:38.895
false,false,6534,6135,399,1142,00:00:31.000,2025-04-15 11:25:53.912
false,false,6388,5997,391,258,00:00:32.000,2025-04-15 11:22:09.664
false,true,6391,6000,391,0,00:00:00.000,2025-04-15 11:22:13.670
false,false,6394,6003,391,93,00:00:31.000,2025-04-15 11:22:21.681
false,false,6400,6008,392,32,00:00:32.000,2025-04-15 11:22:39.702
false,false,6411,6018,393,377,00:00:33.000,2025-04-15 11:22:50.715
false,false,6422,6029,393,185,00:00:31.000,2025-04-15 11:23:13.734
false,false,6425,6032,393,282,00:00:33.000,2025-04-15 11:23:16.738
false,true,6429,6036,393,0,00:00:00.000,2025-04-15 11:23:43.771
false,false,6447,6053,394,568,00:00:33.000,2025-04-15 11:24:02.792
false,true,6447,6053,394,0,00:00:00.000,2025-04-15 11:24:04.794
false,true,6447,6053,394,0,00:00:00.000,2025-04-15 11:24:06.797
false,false,6448,6054,394,33,00:00:33.000,2025-04-15 11:24:09.800
false,false,6490,6092,398,696,00:00:32.000,2025-04-15 11:25:03.857
false,false,6493,6095,398,790,00:00:32.000,2025-04-15 11:25:06.859
false,false,6650,6240,410,536,00:00:30.000,2025-04-15 11:28:50.078
false,false,6668,6256,412,31,00:00:31.000,2025-04-15 11:29:26.117
false,true,6672,6260,412,0,00:00:00.000,2025-04-15 11:29:37.126
false,true,6672,6260,412,0,00:00:00.000,2025-04-15 11:29:40.131
false,true,6838,6419,419,0,00:00:00.000,2025-04-15 11:33:34.358
false,true,6838,6419,419,0,00:00:00.000,2025-04-15 11:33:35.360
false,false,6844,6424,420,62,00:00:32.000,2025-04-15 11:33:52.377
false,false,6846,6426,420,125,00:00:33.000,2025-04-15 11:33:54.379
false,true,6851,6431,420,0,00:00:00.000,2025-04-15 11:34:05.389
false,false,6854,6434,420,95,00:00:32.000,2025-04-15 11:34:08.393
false,false,6869,6448,421,441,00:00:30.000,2025-04-15 11:34:29.420
false,false,6881,6459,422,828,00:00:33.000,2025-04-15 11:34:41.433
false,true,6882,6460,422,0,00:00:00.000,2025-04-15 11:34:48.440
false,false,6885,6463,422,96,00:00:33.000,2025-04-15 11:34:57.449
false,true,6696,6282,414,0,00:00:00.000,2025-04-15 11:30:18.165
false,false,6712,6297,415,500,00:00:33.000,2025-04-15 11:30:34.182
false,false,6723,6308,415,850,00:00:32.000,2025-04-15 11:30:45.189
false,false,6727,6312,415,974,00:00:30.000,2025-04-15 11:30:49.191
false,false,6741,6326,415,1421,00:00:33.000,2025-04-15 11:31:03.207
false,false,6743,6328,415,1481,00:00:30.000,2025-04-15 11:31:05.210
false,false,6749,6334,415,1672,00:00:31.000,2025-04-15 11:31:11.217
false,false,6752,6337,415,1769,00:00:31.000,2025-04-15 11:31:14.220
false,false,6765,6348,417,2181,00:00:32.000,2025-04-15 11:31:27.232
false,false,6776,6359,417,2528,00:00:30.000,2025-04-15 11:31:38.243
false,false,6916,6494,422,409,00:00:32.000,2025-04-15 11:35:46.501
false,false,6944,6522,422,1298,00:00:32.000,2025-04-15 11:36:14.529
false,false,6952,6529,423,1548,00:00:31.000,2025-04-15 11:36:22.536
false,true,6960,6535,425,0,00:00:00.000,2025-04-15 11:36:34.546
false,true,7048,6618,430,0,00:00:00.000,2025-04-15 11:38:30.669
false,false,7065,6634,431,536,00:00:31.000,2025-04-15 11:38:51.684
false,false,7092,6661,431,538,00:00:33.000,2025-04-15 11:39:24.721
false,false,7099,6667,432,756,00:00:30.000,2025-04-15 11:39:31.734
false,false,7117,6685,432,1329,00:00:33.000,2025-04-15 11:39:49.756
false,false,6798,6379,419,374,00:00:31.000,2025-04-15 11:32:06.268
false,true,6801,6382,419,0,00:00:00.000,2025-04-15 11:32:14.273
false,true,6802,6383,419,0,00:00:00.000,2025-04-15 11:32:21.280
false,true,6820,6401,419,0,00:00:00.000,2025-04-15 11:32:59.321
false,true,6833,6414,419,0,00:00:00.000,2025-04-15 11:33:19.343
false,false,7032,6602,430,1268,00:00:30.000,2025-04-15 11:38:12.648
false,true,7166,6727,439,0,00:00:00.000,2025-04-15 11:40:49.823
false,true,7166,6727,439,0,00:00:00.000,2025-04-15 11:40:50.823
false,true,7202,6760,442,0,00:00:00.000,2025-04-15 11:41:36.873
false,false,7206,6763,443,123,00:00:31.000,2025-04-15 11:41:42.878
false,false,7353,6900,453,760,00:00:33.000,2025-04-15 11:45:10.099
false,false,7370,6916,454,477,00:00:32.000,2025-04-15 11:45:33.121
false,false,7385,6929,456,190,00:00:33.000,2025-04-15 11:45:54.143
false,false,7402,6944,458,720,00:00:30.000,2025-04-15 11:46:11.158
false,true,7417,6958,459,0,00:00:00.000,2025-04-15 11:46:48.199
false,false,7216,6771,445,91,00:00:31.000,2025-04-15 11:41:58.897
false,false,7227,6782,445,252,00:00:32.000,2025-04-15 11:42:21.924
false,false,7230,6785,445,344,00:00:30.000,2025-04-15 11:42:24.928
false,false,7250,6803,447,249,00:00:31.000,2025-04-15 11:42:50.950
false,false,7436,6977,459,442,00:00:32.000,2025-04-15 11:47:15.228
false,false,7452,6992,460,318,00:00:33.000,2025-04-15 11:47:37.253
false,false,7458,6998,460,508,00:00:32.000,2025-04-15 11:47:43.262
false,false,7459,6999,460,540,00:00:32.000,2025-04-15 11:47:44.263
false,true,7464,7004,460,0,00:00:00.000,2025-04-15 11:47:52.275
false,false,7466,7006,460,61,00:00:30.000,2025-04-15 11:47:57.279
false,false,7470,7009,461,124,00:00:33.000,2025-04-15 11:48:07.289
false,false,7472,7011,461,184,00:00:30.000,2025-04-15 11:48:09.289
false,false,7487,7024,463,659,00:00:33.000,2025-04-15 11:48:24.308
false,false,7489,7026,463,725,00:00:33.000,2025-04-15 11:48:26.310
false,true,7495,7032,463,0,00:00:00.000,2025-04-15 11:48:44.334
false,false,7512,7048,464,534,00:00:32.000,2025-04-15 11:49:01.353
false,false,7515,7050,465,631,00:00:33.000,2025-04-15 11:49:04.358
false,false,7536,7071,465,256,00:00:30.000,2025-04-15 11:49:31.378
false,false,7537,7072,465,287,00:00:31.000,2025-04-15 11:49:32.381
false,false,7311,6862,449,969,00:00:30.000,2025-04-15 11:44:16.037
false,false,7313,6864,449,1032,00:00:32.000,2025-04-15 11:44:18.039
false,false,7330,6881,449,31,00:00:31.000,2025-04-15 11:44:47.072
false,false,7337,6888,449,253,00:00:33.000,2025-04-15 11:44:54.083
false,false,7583,7117,466,96,00:00:32.000,2025-04-15 11:50:48.449
false,false,7594,7127,467,439,00:00:30.000,2025-04-15 11:50:59.457
false,false,7598,7131,467,566,00:00:30.000,2025-04-15 11:51:03.461
false,false,7637,7170,467,1789,00:00:32.000,2025-04-15 11:51:42.499
false,false,7642,7175,467,1948,00:00:33.000,2025-04-15 11:51:47.504
false,false,7643,7176,467,1980,00:00:32.000,2025-04-15 11:51:48.505
false,false,7739,7271,468,727,00:00:33.000,2025-04-15 11:53:54.650
false,false,7747,7278,469,974,00:00:30.000,2025-04-15 11:54:02.659
false,false,7765,7295,470,65,00:00:32.000,2025-04-15 11:54:32.693
false,true,7769,7299,470,0,00:00:00.000,2025-04-15 11:54:39.702
false,false,7783,7313,470,277,00:00:30.000,2025-04-15 11:55:02.722
false,false,7660,7193,467,2515,00:00:30.000,2025-04-15 11:52:05.524
false,false,7668,7201,467,66,00:00:33.000,2025-04-15 11:52:19.541
false,false,7680,7212,468,445,00:00:33.000,2025-04-15 11:52:31.557
false,true,7683,7215,468,0,00:00:00.000,2025-04-15 11:52:37.563
false,false,7687,7219,468,131,00:00:33.000,2025-04-15 11:52:44.569
false,false,7688,7220,468,164,00:00:33.000,2025-04-15 11:52:45.571
false,false,7700,7232,468,316,00:00:32.000,2025-04-15 11:53:03.593
false,false,7704,7236,468,130,00:00:33.000,2025-04-15 11:53:13.602
false,false,7716,7248,468,514,00:00:33.000,2025-04-15 11:53:25.614
false,true,7716,7248,468,0,00:00:00.000,2025-04-15 11:53:26.615
false,true,7789,7319,470,0,00:00:00.000,2025-04-15 11:55:11.733
false,false,7803,7333,470,62,00:00:31.000,2025-04-15 11:55:34.761
false,false,7812,7342,470,31,00:00:31.000,2025-04-15 11:55:49.777
false,true,7823,7350,473,0,00:00:00.000,2025-04-15 11:56:08.796
false,false,7830,7357,473,32,00:00:32.000,2025-04-15 11:56:37.827
false,false,7844,7371,473,477,00:00:31.000,2025-04-15 11:56:51.843
false,false,7846,7373,473,61,00:00:30.000,2025-04-15 11:56:59.850
false,false,7854,7381,473,308,00:00:30.000,2025-04-15 11:57:07.858
false,false,7868,7394,474,752,00:00:32.000,2025-04-15 11:57:21.875
false,true,7870,7396,474,0,00:00:00.000,2025-04-15 11:57:34.897
false,false,7880,7406,474,316,00:00:30.000,2025-04-15 11:57:45.908
false,false,8004,7526,478,342,00:00:32.000,2025-04-15 12:00:20.065
false,false,8008,7530,478,469,00:00:31.000,2025-04-15 12:00:24.070
false,false,8009,7531,478,500,00:00:31.000,2025-04-15 12:00:25.071
false,false,8013,7535,478,626,00:00:31.000,2025-04-15 12:00:29.075
false,false,8015,7537,478,689,00:00:31.000,2025-04-15 12:00:31.077
false,false,8017,7538,479,31,00:00:31.000,2025-04-15 12:00:39.083
false,false,8025,7546,479,246,00:00:30.000,2025-04-15 12:00:53.097
false,true,8035,7556,479,0,00:00:00.000,2025-04-15 12:01:07.111
false,false,5156,4835,321,250,00:00:30.000,2025-04-15 10:53:17.924
false,false,5159,4838,321,348,00:00:32.000,2025-04-15 10:53:20.926
false,false,5241,4915,326,314,00:00:31.000,2025-04-15 10:55:07.031
false,false,5243,4916,327,379,00:00:33.000,2025-04-15 10:55:09.033
false,false,5244,4917,327,409,00:00:30.000,2025-04-15 10:55:10.034
false,false,5247,4920,327,505,00:00:33.000,2025-04-15 10:55:13.038
false,false,5264,4937,327,1036,00:00:31.000,2025-04-15 10:55:30.055
false,false,5269,4941,328,158,00:00:32.000,2025-04-15 10:55:41.065
false,false,5282,4953,329,567,00:00:31.000,2025-04-15 10:55:54.080
false,false,5295,4965,330,981,00:00:31.000,2025-04-15 10:56:07.092
false,true,5298,4968,330,0,00:00:00.000,2025-04-15 10:56:13.098
false,true,5298,4968,330,0,00:00:00.000,2025-04-15 10:56:16.098
false,false,4958,4654,304,619,00:00:31.000,2025-04-15 10:48:47.642
false,true,4962,4657,305,0,00:00:00.000,2025-04-15 10:49:02.658
false,false,4979,4674,305,127,00:00:33.000,2025-04-15 10:49:26.684
false,false,4984,4677,307,290,00:00:33.000,2025-04-15 10:49:31.690
false,false,4992,4685,307,539,00:00:31.000,2025-04-15 10:49:39.700
false,false,4996,4688,308,30,00:00:30.000,2025-04-15 10:49:49.712
false,false,5004,4695,309,278,00:00:33.000,2025-04-15 10:49:57.721
false,false,5009,4700,309,436,00:00:31.000,2025-04-15 10:50:02.727
false,false,5023,4714,309,283,00:00:31.000,2025-04-15 10:50:28.760
false,false,5043,4731,312,904,00:00:30.000,2025-04-15 10:50:48.779
false,false,5049,4737,312,1096,00:00:31.000,2025-04-15 10:50:54.783
false,false,5066,4752,314,1630,00:00:33.000,2025-04-15 10:51:11.805
false,true,5079,4763,316,0,00:00:00.000,2025-04-15 10:51:25.818
false,false,5199,4875,324,376,00:00:30.000,2025-04-15 10:54:06.970
false,false,5202,4878,324,470,00:00:30.000,2025-04-15 10:54:09.973
false,false,5204,4880,324,536,00:00:33.000,2025-04-15 10:54:11.976
false,false,5209,4885,324,95,00:00:32.000,2025-04-15 10:54:22.988
false,false,5223,4897,326,375,00:00:32.000,2025-04-15 10:54:43.007
false,true,5231,4905,326,0,00:00:00.000,2025-04-15 10:54:55.019
false,false,5235,4909,326,129,00:00:33.000,2025-04-15 10:55:01.023
false,false,5480,5136,344,217,00:00:33.000,2025-04-15 11:00:18.338
false,false,5489,5145,344,33,00:00:33.000,2025-04-15 11:00:33.352
false,false,5496,5152,344,253,00:00:31.000,2025-04-15 11:00:40.359
false,false,5501,5155,346,413,00:00:32.000,2025-04-15 11:00:45.365
false,false,5556,5206,350,507,00:00:31.000,2025-04-15 11:01:58.438
false,false,5559,5209,350,603,00:00:33.000,2025-04-15 11:02:01.442
false,true,5595,5245,350,0,00:00:00.000,2025-04-15 11:02:53.491
false,true,5603,5253,350,0,00:00:00.000,2025-04-15 11:03:11.508
false,false,5695,5339,356,253,00:00:33.000,2025-04-15 11:05:23.651
false,true,5701,5345,356,0,00:00:00.000,2025-04-15 11:05:41.668
false,false,5705,5349,356,125,00:00:32.000,2025-04-15 11:05:45.673
false,false,5706,5350,356,158,00:00:33.000,2025-04-15 11:05:46.674
false,true,5710,5353,357,0,00:00:00.000,2025-04-15 11:05:51.679
false,false,5717,5360,357,157,00:00:30.000,2025-04-15 11:06:09.697
false,false,5734,5374,360,692,00:00:32.000,2025-04-15 11:06:26.715
false,false,5633,5282,351,941,00:00:33.000,2025-04-15 11:03:45.545
false,false,5636,5284,352,1036,00:00:32.000,2025-04-15 11:03:48.549
false,false,5654,5301,353,120,00:00:30.000,2025-04-15 11:04:12.574
false,true,5655,5302,353,0,00:00:00.000,2025-04-15 11:04:18.582
false,true,5662,5307,355,0,00:00:00.000,2025-04-15 11:04:27.590
false,false,5418,5076,342,376,00:00:32.000,2025-04-15 10:58:46.246
false,false,5429,5087,342,154,00:00:31.000,2025-04-15 10:59:03.266
false,false,5440,5097,343,155,00:00:33.000,2025-04-15 10:59:20.280
false,false,5445,5102,343,315,00:00:32.000,2025-04-15 10:59:25.284
false,true,5447,5104,343,0,00:00:00.000,2025-04-15 10:59:29.287
false,false,5451,5107,344,128,00:00:32.000,2025-04-15 10:59:37.296
false,false,5454,5110,344,221,00:00:31.000,2025-04-15 10:59:40.299
false,false,5463,5119,344,510,00:00:33.000,2025-04-15 10:59:49.307
false,false,5467,5123,344,632,00:00:30.000,2025-04-15 10:59:53.313
false,true,5470,5126,344,0,00:00:00.000,2025-04-15 11:00:01.319
false,true,5895,5525,370,0,00:00:00.000,2025-04-15 11:10:45.978
false,true,5903,5533,370,0,00:00:00.000,2025-04-15 11:10:59.993
false,true,5903,5533,370,0,00:00:00.000,2025-04-15 11:11:02.995
false,false,5909,5538,371,124,00:00:31.000,2025-04-15 11:11:16.009
false,false,5912,5541,371,218,00:00:33.000,2025-04-15 11:11:19.014
false,false,5918,5547,371,405,00:00:31.000,2025-04-15 11:11:25.019
false,true,5813,5447,366,0,00:00:00.000,2025-04-15 11:08:42.857
false,false,5821,5454,367,64,00:00:31.000,2025-04-15 11:08:59.875
false,false,5826,5458,368,222,00:00:32.000,2025-04-15 11:09:04.881
false,false,5840,5472,368,658,00:00:30.000,2025-04-15 11:09:18.895
false,true,5858,5489,369,0,00:00:00.000,2025-04-15 11:09:48.926
false,false,5876,5507,369,565,00:00:32.000,2025-04-15 11:10:06.945
false,false,5937,5565,372,63,00:00:32.000,2025-04-15 11:11:50.039
false,false,5949,5577,372,375,00:00:30.000,2025-04-15 11:12:08.053
false,false,5956,5584,372,600,00:00:33.000,2025-04-15 11:12:15.060
false,false,5957,5585,372,633,00:00:33.000,2025-04-15 11:12:16.061
false,false,5963,5591,372,818,00:00:30.000,2025-04-15 11:12:22.068
false,false,5969,5596,373,30,00:00:30.000,2025-04-15 11:12:34.081
false,false,5986,5610,376,564,00:00:33.000,2025-04-15 11:12:51.100
false,false,5995,5619,376,846,00:00:30.000,2025-04-15 11:13:00.108
false,false,5791,5426,365,532,00:00:32.000,2025-04-15 11:07:59.811
false,false,6010,5634,376,65,00:00:32.000,2025-04-15 11:13:45.154
false,false,6022,5644,378,445,00:00:31.000,2025-04-15 11:13:57.167
false,false,6027,5649,378,602,00:00:30.000,2025-04-15 11:14:02.171
false,false,6042,5664,378,31,00:00:31.000,2025-04-15 11:14:35.201
false,false,6047,5669,378,188,00:00:33.000,2025-04-15 11:14:40.206
false,false,6067,5689,378,63,00:00:31.000,2025-04-15 11:15:06.235
false,false,6238,5851,387,186,00:00:33.000,2025-04-15 11:18:45.462
false,true,6273,5886,387,0,00:00:00.000,2025-04-15 11:19:32.514
false,false,6280,5893,387,217,00:00:30.000,2025-04-15 11:19:39.522
false,true,6280,5893,387,0,00:00:00.000,2025-04-15 11:19:42.522
false,false,6071,5693,378,191,00:00:32.000,2025-04-15 11:15:10.237
false,false,6081,5702,379,95,00:00:30.000,2025-04-15 11:15:32.263
false,false,6085,5706,379,223,00:00:31.000,2025-04-15 11:15:36.269
false,true,6093,5714,379,0,00:00:00.000,2025-04-15 11:15:47.281
false,false,6095,5716,379,64,00:00:32.000,2025-04-15 11:15:52.286
false,false,6100,5721,379,220,00:00:30.000,2025-04-15 11:15:57.291
false,false,6116,5737,379,161,00:00:32.000,2025-04-15 11:16:19.314
false,false,6117,5738,379,193,00:00:32.000,2025-04-15 11:16:20.315
false,false,6118,5739,379,226,00:00:33.000,2025-04-15 11:16:21.315
false,false,6122,5743,379,353,00:00:31.000,2025-04-15 11:16:25.321
false,false,6123,5743,380,386,00:00:33.000,2025-04-15 11:16:26.321
false,false,6135,5755,380,763,00:00:31.000,2025-04-15 11:16:38.333
false,false,6158,5777,381,1485,00:00:30.000,2025-04-15 11:17:01.352
false,false,6179,5795,384,2145,00:00:33.000,2025-04-15 11:17:22.374
false,false,6186,5802,384,32,00:00:32.000,2025-04-15 11:17:35.387
false,true,6196,5811,385,0,00:00:00.000,2025-04-15 11:17:51.405
false,false,6199,5814,385,92,00:00:30.000,2025-04-15 11:17:54.410
false,false,6211,5824,387,475,00:00:33.000,2025-04-15 11:18:06.421
false,true,6301,5913,388,0,00:00:00.000,2025-04-15 11:20:19.558
false,false,6303,5915,388,64,00:00:33.000,2025-04-15 11:20:26.564
false,false,6307,5919,388,188,00:00:31.000,2025-04-15 11:20:30.568
false,false,6313,5925,388,371,00:00:31.000,2025-04-15 11:20:36.574
false,false,6329,5940,389,875,00:00:31.000,2025-04-15 11:20:52.590
false,false,6333,5943,390,1003,00:00:30.000,2025-04-15 11:20:56.596
false,false,6348,5957,391,406,00:00:30.000,2025-04-15 11:21:17.618
false,false,6364,5973,391,909,00:00:33.000,2025-04-15 11:21:33.630
false,false,6372,5981,391,1157,00:00:31.000,2025-04-15 11:21:41.637
false,true,6588,6183,405,0,00:00:00.000,2025-04-15 11:27:05.983
false,true,6594,6189,405,0,00:00:00.000,2025-04-15 11:27:20.997
false,false,6599,6194,405,155,00:00:31.000,2025-04-15 11:27:29.005
false,true,6599,6194,405,0,00:00:00.000,2025-04-15 11:27:33.009
false,true,6617,6211,406,0,00:00:00.000,2025-04-15 11:28:05.038
false,true,6631,6224,407,0,00:00:00.000,2025-04-15 11:28:22.054
false,true,6631,6224,407,0,00:00:00.000,2025-04-15 11:28:24.054
false,true,6498,6100,398,0,00:00:00.000,2025-04-15 11:25:14.870
false,false,6503,6105,398,162,00:00:31.000,2025-04-15 11:25:22.878
false,false,6516,6117,399,577,00:00:32.000,2025-04-15 11:25:35.889
false,true,6551,6148,403,0,00:00:00.000,2025-04-15 11:26:12.931
false,true,6551,6148,403,0,00:00:00.000,2025-04-15 11:26:13.933
false,false,6570,6166,404,60,00:00:30.000,2025-04-15 11:26:41.960
false,false,6376,5985,391,94,00:00:30.000,2025-04-15 11:21:51.646
false,false,6381,5990,391,33,00:00:33.000,2025-04-15 11:22:02.656
false,false,6391,6000,391,356,00:00:32.000,2025-04-15 11:22:12.668
false,true,6394,6003,391,0,00:00:00.000,2025-04-15 11:22:24.683
false,false,6416,6023,393,31,00:00:31.000,2025-04-15 11:23:01.727
false,false,6424,6031,393,249,00:00:33.000,2025-04-15 11:23:15.737
false,true,6425,6032,393,0,00:00:00.000,2025-04-15 11:23:22.746
false,true,6428,6035,393,0,00:00:00.000,2025-04-15 11:23:33.763
false,true,6447,6053,394,0,00:00:00.000,2025-04-15 11:24:03.792
false,false,6464,6069,395,33,00:00:33.000,2025-04-15 11:24:31.826
false,true,6633,6225,408,0,00:00:00.000,2025-04-15 11:28:32.062
false,false,6647,6238,409,442,00:00:33.000,2025-04-15 11:28:47.076
false,true,6659,6248,411,0,00:00:00.000,2025-04-15 11:29:10.101
false,true,6667,6255,412,0,00:00:00.000,2025-04-15 11:29:20.113
false,true,6667,6255,412,0,00:00:00.000,2025-04-15 11:29:22.114
false,false,6679,6266,413,223,00:00:32.000,2025-04-15 11:29:49.139
false,false,6683,6270,413,352,00:00:32.000,2025-04-15 11:29:53.144
false,true,6692,6278,414,0,00:00:00.000,2025-04-15 11:30:06.158
false,true,6842,6422,420,0,00:00:00.000,2025-04-15 11:33:48.373
false,true,6842,6422,420,0,00:00:00.000,2025-04-15 11:33:49.374
false,false,6847,6427,420,156,00:00:31.000,2025-04-15 11:33:55.380
false,true,6851,6431,420,0,00:00:00.000,2025-04-15 11:34:02.386
false,false,6866,6445,421,345,00:00:32.000,2025-04-15 11:34:26.416
false,false,6880,6458,422,795,00:00:32.000,2025-04-15 11:34:40.431
false,true,6882,6460,422,0,00:00:00.000,2025-04-15 11:34:44.435
false,true,6882,6460,422,0,00:00:00.000,2025-04-15 11:34:47.438
false,true,6882,6460,422,0,00:00:00.000,2025-04-15 11:34:49.442
false,false,6698,6284,414,65,00:00:32.000,2025-04-15 11:30:20.166
false,false,6707,6292,415,345,00:00:31.000,2025-04-15 11:30:29.177
false,false,6715,6300,415,597,00:00:32.000,2025-04-15 11:30:37.184
false,false,6742,6327,415,1451,00:00:30.000,2025-04-15 11:31:04.209
false,false,6764,6347,417,2149,00:00:31.000,2025-04-15 11:31:26.231
false,false,6770,6353,417,2339,00:00:33.000,2025-04-15 11:31:32.238
false,false,6773,6356,417,2435,00:00:33.000,2025-04-15 11:31:35.239
false,false,6786,6367,419,2841,00:00:30.000,2025-04-15 11:31:48.251
false,true,6893,6471,422,0,00:00:00.000,2025-04-15 11:35:13.465
false,false,6900,6478,422,221,00:00:33.000,2025-04-15 11:35:24.475
false,true,6903,6481,422,0,00:00:00.000,2025-04-15 11:35:31.483
false,false,6909,6487,422,188,00:00:30.000,2025-04-15 11:35:39.493
false,false,6917,6495,422,441,00:00:32.000,2025-04-15 11:35:47.503
false,false,6937,6515,422,1076,00:00:32.000,2025-04-15 11:36:07.521
false,false,6945,6523,422,1328,00:00:30.000,2025-04-15 11:36:15.529
false,true,6964,6538,426,0,00:00:00.000,2025-04-15 11:36:41.556
false,false,7059,6629,430,348,00:00:33.000,2025-04-15 11:38:45.679
false,false,7085,6654,431,316,00:00:32.000,2025-04-15 11:39:17.713
false,false,7087,6656,431,381,00:00:33.000,2025-04-15 11:39:19.715
false,false,7115,6683,432,1266,00:00:31.000,2025-04-15 11:39:47.755
false,false,7118,6686,432,1360,00:00:31.000,2025-04-15 11:39:50.757
false,false,7130,6698,432,1737,00:00:32.000,2025-04-15 11:40:02.769
false,true,6786,6367,419,0,00:00:00.000,2025-04-15 11:31:49.251
false,true,6786,6367,419,0,00:00:00.000,2025-04-15 11:31:50.252
false,false,6789,6370,419,92,00:00:30.000,2025-04-15 11:31:57.259
false,false,6799,6380,419,405,00:00:31.000,2025-04-15 11:32:07.269
false,true,6801,6382,419,0,00:00:00.000,2025-04-15 11:32:10.270
false,false,6817,6398,419,279,00:00:31.000,2025-04-15 11:32:49.309
false,true,6820,6401,419,0,00:00:00.000,2025-04-15 11:33:03.326
false,false,6825,6406,419,159,00:00:32.000,2025-04-15 11:33:09.335
false,false,6837,6418,419,131,00:00:32.000,2025-04-15 11:33:27.352
false,true,6965,6539,426,0,00:00:00.000,2025-04-15 11:36:49.563
false,false,6981,6555,426,412,00:00:31.000,2025-04-15 11:37:15.590
false,true,6992,6566,426,0,00:00:00.000,2025-04-15 11:37:32.604
false,false,6997,6570,427,159,00:00:31.000,2025-04-15 11:37:37.609
false,false,7005,6578,427,412,00:00:31.000,2025-04-15 11:37:45.618
false,false,7028,6600,428,1141,00:00:30.000,2025-04-15 11:38:08.642
false,false,7034,6604,430,1330,00:00:31.000,2025-04-15 11:38:14.650
false,false,7048,6618,430,1768,00:00:30.000,2025-04-15 11:38:28.667
false,false,7147,6711,436,63,00:00:32.000,2025-04-15 11:40:25.793
false,false,7151,6715,436,190,00:00:32.000,2025-04-15 11:40:29.799
false,false,7157,6720,437,377,00:00:30.000,2025-04-15 11:40:35.806
false,false,7193,6752,441,694,00:00:30.000,2025-04-15 11:41:23.859
false,false,7378,6922,456,729,00:00:33.000,2025-04-15 11:45:41.130
false,true,7404,6946,458,0,00:00:00.000,2025-04-15 11:46:17.165
false,true,7406,6948,458,0,00:00:00.000,2025-04-15 11:46:30.181
false,false,7214,6769,445,30,00:00:30.000,2025-04-15 11:41:56.895
false,false,7221,6776,445,62,00:00:30.000,2025-04-15 11:42:15.916
false,false,7238,6792,446,594,00:00:32.000,2025-04-15 11:42:32.939
false,true,7242,6795,447,0,00:00:00.000,2025-04-15 11:42:38.941
false,true,7242,6795,447,0,00:00:00.000,2025-04-15 11:42:41.943
false,false,7251,6804,447,281,00:00:32.000,2025-04-15 11:42:51.950
false,false,7265,6818,447,343,00:00:30.000,2025-04-15 11:43:11.974
false,true,7422,6963,459,0,00:00:00.000,2025-04-15 11:46:59.209
false,false,7431,6972,459,282,00:00:33.000,2025-04-15 11:47:10.222
false,false,7432,6973,459,315,00:00:33.000,2025-04-15 11:47:11.223
false,false,7434,6975,459,378,00:00:33.000,2025-04-15 11:47:13.225
false,false,7439,6980,459,536,00:00:31.000,2025-04-15 11:47:18.231
false,false,7456,6996,460,446,00:00:31.000,2025-04-15 11:47:41.259
false,false,7468,7007,461,61,00:00:30.000,2025-04-15 11:48:05.288
false,false,7482,7019,463,500,00:00:33.000,2025-04-15 11:48:19.304
false,false,7484,7021,463,561,00:00:30.000,2025-04-15 11:48:21.305
false,true,7495,7032,463,0,00:00:00.000,2025-04-15 11:48:43.332
false,false,7498,7035,463,95,00:00:32.000,2025-04-15 11:48:47.339
false,false,7500,7037,463,158,00:00:32.000,2025-04-15 11:48:49.342
false,false,7514,7050,464,598,00:00:32.000,2025-04-15 11:49:03.356
false,false,7534,7069,465,195,00:00:32.000,2025-04-15 11:49:29.374
false,false,7545,7080,465,151,00:00:31.000,2025-04-15 11:49:46.398
false,false,7553,7087,466,253,00:00:30.000,2025-04-15 11:50:00.407
false,false,7556,7090,466,349,00:00:33.000,2025-04-15 11:50:03.411
false,true,7277,6829,448,0,00:00:00.000,2025-04-15 11:43:35.000
false,true,7280,6832,448,0,00:00:00.000,2025-04-15 11:43:40.006
false,true,7280,6832,448,0,00:00:00.000,2025-04-15 11:43:44.008
false,false,7289,6841,448,281,00:00:33.000,2025-04-15 11:43:54.017
false,false,7317,6868,449,1159,00:00:33.000,2025-04-15 11:44:22.043
false,false,7318,6869,449,30,00:00:30.000,2025-04-15 11:44:29.053
false,false,7328,6879,449,343,00:00:31.000,2025-04-15 11:44:39.066
false,true,7329,6880,449,0,00:00:00.000,2025-04-15 11:44:42.067
false,true,7559,7093,466,0,00:00:00.000,2025-04-15 11:50:11.419
false,false,7561,7095,466,63,00:00:32.000,2025-04-15 11:50:14.420
false,false,7563,7097,466,125,00:00:31.000,2025-04-15 11:50:16.423
false,true,7580,7114,466,0,00:00:00.000,2025-04-15 11:50:43.445
false,false,7586,7120,466,192,00:00:32.000,2025-04-15 11:50:51.452
false,false,7590,7123,467,317,00:00:31.000,2025-04-15 11:50:55.454
false,false,7597,7130,467,536,00:00:32.000,2025-04-15 11:51:02.461
false,false,7601,7134,467,661,00:00:30.000,2025-04-15 11:51:06.463
false,true,7716,7248,468,0,00:00:00.000,2025-04-15 11:53:31.621
false,false,7720,7252,468,124,00:00:30.000,2025-04-15 11:53:35.624
false,false,7738,7270,468,694,00:00:33.000,2025-04-15 11:53:53.649
false,false,7750,7281,469,1068,00:00:32.000,2025-04-15 11:54:05.664
false,true,7763,7293,470,0,00:00:00.000,2025-04-15 11:54:25.686
false,true,7763,7293,470,0,00:00:00.000,2025-04-15 11:54:27.689
false,true,7763,7293,470,0,00:00:00.000,2025-04-15 11:54:28.689
false,true,7763,7293,470,0,00:00:00.000,2025-04-15 11:54:29.690
false,false,7775,7305,470,31,00:00:31.000,2025-04-15 11:54:54.715
false,false,7786,7316,470,372,00:00:31.000,2025-04-15 11:55:05.726
false,true,7666,7199,467,0,00:00:00.000,2025-04-15 11:52:14.535
false,true,7690,7222,468,0,00:00:00.000,2025-04-15 11:52:50.575
false,true,7690,7222,468,0,00:00:00.000,2025-04-15 11:52:52.578
false,true,7789,7319,470,0,00:00:00.000,2025-04-15 11:55:12.734
false,false,7791,7321,470,62,00:00:32.000,2025-04-15 11:55:16.739
false,false,7797,7327,470,253,00:00:33.000,2025-04-15 11:55:22.746
false,false,7805,7335,470,126,00:00:31.000,2025-04-15 11:55:36.762
false,true,7811,7341,470,0,00:00:00.000,2025-04-15 11:55:44.774
false,false,7815,7345,470,124,00:00:30.000,2025-04-15 11:55:52.779
false,false,7820,7348,472,97,00:00:32.000,2025-04-15 11:56:03.790
false,false,7822,7349,473,160,00:00:31.000,2025-04-15 11:56:05.792
false,false,7828,7355,473,130,00:00:31.000,2025-04-15 11:56:23.813
false,false,7829,7356,473,33,00:00:33.000,2025-04-15 11:56:30.821
false,true,7829,7356,473,0,00:00:00.000,2025-04-15 11:56:36.826
false,true,7844,7371,473,0,00:00:00.000,2025-04-15 11:56:55.845
false,false,7848,7375,473,121,00:00:30.000,2025-04-15 11:57:01.853
false,false,7865,7391,474,654,00:00:32.000,2025-04-15 11:57:18.871
false,true,7870,7396,474,0,00:00:00.000,2025-04-15 11:57:35.898
false,false,7916,7441,475,1457,00:00:30.000,2025-04-15 11:58:21.945
false,false,8002,7524,478,279,00:00:30.000,2025-04-15 12:00:18.063
false,false,8040,7561,479,157,00:00:31.000,2025-04-15 12:01:14.115
false,false,5148,4828,320,1004,00:00:30.000,2025-04-15 10:53:03.911
false,false,5151,4830,321,92,00:00:30.000,2025-04-15 10:53:12.920
false,false,5164,4843,321,504,00:00:30.000,2025-04-15 10:53:25.933
false,false,5258,4931,327,845,00:00:31.000,2025-04-15 10:55:24.050
false,false,5267,4940,327,94,00:00:30.000,2025-04-15 10:55:39.062
false,false,5283,4954,329,599,00:00:32.000,2025-04-15 10:55:55.080
false,false,5297,4967,330,1041,00:00:30.000,2025-04-15 10:56:09.095
false,false,5304,4973,331,32,00:00:32.000,2025-04-15 10:56:28.110
false,false,5311,4978,333,251,00:00:33.000,2025-04-15 10:56:35.117
false,false,4946,4642,304,249,00:00:31.000,2025-04-15 10:48:35.632
false,false,4949,4645,304,343,00:00:33.000,2025-04-15 10:48:38.635
false,true,4958,4654,304,0,00:00:00.000,2025-04-15 10:48:51.645
false,true,4962,4657,305,0,00:00:00.000,2025-04-15 10:48:59.653
false,false,4986,4679,307,352,00:00:32.000,2025-04-15 10:49:33.691
false,false,4999,4690,309,125,00:00:33.000,2025-04-15 10:49:52.716
false,false,5013,4704,309,93,00:00:32.000,2025-04-15 10:50:12.743
false,false,5017,4708,309,94,00:00:33.000,2025-04-15 10:50:22.753
false,false,5035,4726,309,658,00:00:32.000,2025-04-15 10:50:40.771
false,false,5061,4748,313,1472,00:00:31.000,2025-04-15 10:51:06.797
false,false,5081,4765,316,60,00:00:30.000,2025-04-15 10:51:32.826
false,false,5174,4852,322,816,00:00:33.000,2025-04-15 10:53:35.942
false,false,5179,4857,322,973,00:00:30.000,2025-04-15 10:53:40.946
false,false,5189,4866,323,61,00:00:31.000,2025-04-15 10:53:56.961
false,false,5192,4869,323,157,00:00:32.000,2025-04-15 10:53:59.962
false,true,5206,4882,324,0,00:00:00.000,2025-04-15 10:54:15.980
false,false,5232,4906,326,30,00:00:30.000,2025-04-15 10:54:58.020
false,false,5481,5137,344,248,00:00:31.000,2025-04-15 11:00:19.340
false,false,5486,5142,344,405,00:00:31.000,2025-04-15 11:00:24.343
false,true,5488,5144,344,0,00:00:00.000,2025-04-15 11:00:30.349
false,false,5502,5156,346,446,00:00:33.000,2025-04-15 11:00:46.366
false,false,5546,5197,349,193,00:00:33.000,2025-04-15 11:01:48.428
false,false,5552,5203,349,385,00:00:33.000,2025-04-15 11:01:54.436
false,false,5578,5228,350,1197,00:00:31.000,2025-04-15 11:02:20.461
false,true,5603,5253,350,0,00:00:00.000,2025-04-15 11:03:12.509
false,false,5700,5344,356,410,00:00:31.000,2025-04-15 11:05:28.658
false,true,5701,5345,356,0,00:00:00.000,2025-04-15 11:05:30.660
false,true,5710,5353,357,0,00:00:00.000,2025-04-15 11:05:54.683
false,false,5725,5367,358,404,00:00:32.000,2025-04-15 11:06:17.706
false,false,5661,5307,354,189,00:00:32.000,2025-04-15 11:04:25.588
false,false,5666,5310,356,95,00:00:31.000,2025-04-15 11:04:42.607
false,false,5675,5319,356,385,00:00:33.000,2025-04-15 11:04:51.618
false,false,5685,5329,356,699,00:00:32.000,2025-04-15 11:05:01.630
false,true,5435,5092,343,0,00:00:00.000,2025-04-15 10:59:12.272
false,true,5435,5092,343,0,00:00:00.000,2025-04-15 10:59:14.273
false,true,5882,5513,369,0,00:00:00.000,2025-04-15 11:10:14.951
false,true,5882,5513,369,0,00:00:00.000,2025-04-15 11:10:16.953
false,true,5888,5518,370,0,00:00:00.000,2025-04-15 11:10:31.965
false,false,5892,5522,370,130,00:00:33.000,2025-04-15 11:10:40.974
false,true,5895,5525,370,0,00:00:00.000,2025-04-15 11:10:46.979
false,true,5895,5525,370,0,00:00:00.000,2025-04-15 11:10:47.980
false,false,5897,5527,370,65,00:00:33.000,2025-04-15 11:10:51.985
false,false,5898,5528,370,97,00:00:32.000,2025-04-15 11:10:52.987
false,false,5921,5550,371,501,00:00:33.000,2025-04-15 11:11:28.022
false,false,5923,5552,371,565,00:00:32.000,2025-04-15 11:11:30.023
false,true,5808,5442,366,0,00:00:00.000,2025-04-15 11:08:32.847
false,true,5813,5447,366,0,00:00:00.000,2025-04-15 11:08:44.860
false,false,5858,5489,369,504,00:00:32.000,2025-04-15 11:09:42.917
false,true,5858,5489,369,0,00:00:00.000,2025-04-15 11:09:44.919
false,true,5996,5620,376,0,00:00:00.000,2025-04-15 11:13:04.113
false,true,5997,5621,376,0,00:00:00.000,2025-04-15 11:13:12.121
false,true,5997,5621,376,0,00:00:00.000,2025-04-15 11:13:14.122
false,false,6000,5624,376,93,00:00:33.000,2025-04-15 11:13:17.127
false,false,5746,5386,360,160,00:00:32.000,2025-04-15 11:06:50.737
false,false,5757,5396,361,505,00:00:32.000,2025-04-15 11:07:01.747
false,true,5761,5400,361,0,00:00:00.000,2025-04-15 11:07:07.754
false,false,5771,5408,363,222,00:00:31.000,2025-04-15 11:07:33.783
false,false,5779,5415,364,157,00:00:32.000,2025-04-15 11:07:47.800
false,false,5801,5435,366,192,00:00:32.000,2025-04-15 11:08:15.826
false,true,6035,5657,378,0,00:00:00.000,2025-04-15 11:14:19.190
false,false,6052,5674,378,343,00:00:30.000,2025-04-15 11:14:45.214
false,false,6055,5677,378,439,00:00:33.000,2025-04-15 11:14:48.216
false,false,6236,5849,387,122,00:00:31.000,2025-04-15 11:18:43.459
false,false,6257,5870,387,782,00:00:30.000,2025-04-15 11:19:04.485
false,false,6267,5880,387,220,00:00:31.000,2025-04-15 11:19:20.500
false,false,6070,5692,378,159,00:00:33.000,2025-04-15 11:15:09.237
false,false,6075,5696,379,318,00:00:31.000,2025-04-15 11:15:14.242
false,true,6111,5732,379,0,00:00:00.000,2025-04-15 11:16:09.305
false,false,6121,5742,379,322,00:00:30.000,2025-04-15 11:16:24.319
false,false,6132,5752,380,667,00:00:31.000,2025-04-15 11:16:35.330
false,false,6134,5754,380,732,00:00:33.000,2025-04-15 11:16:37.332
false,false,6184,5800,384,2304,00:00:31.000,2025-04-15 11:17:27.379
false,true,6196,5811,385,0,00:00:00.000,2025-04-15 11:17:46.400
false,true,6196,5811,385,0,00:00:00.000,2025-04-15 11:17:49.403
false,false,6200,5815,385,125,00:00:33.000,2025-04-15 11:17:55.411
false,false,6201,5816,385,155,00:00:30.000,2025-04-15 11:17:56.411
false,false,6206,5821,385,316,00:00:32.000,2025-04-15 11:18:01.414
false,true,6223,5836,387,0,00:00:00.000,2025-04-15 11:18:21.437
false,false,6301,5913,388,66,00:00:33.000,2025-04-15 11:20:18.557
false,false,6305,5917,388,127,00:00:32.000,2025-04-15 11:20:28.566
false,false,6309,5921,388,249,00:00:31.000,2025-04-15 11:20:32.569
false,false,6326,5937,389,779,00:00:32.000,2025-04-15 11:20:49.587
false,false,6327,5938,389,812,00:00:33.000,2025-04-15 11:20:50.588
false,false,6331,5941,390,941,00:00:33.000,2025-04-15 11:20:54.593
false,false,6363,5972,391,876,00:00:30.000,2025-04-15 11:21:32.629
false,false,6365,5974,391,942,00:00:33.000,2025-04-15 11:21:34.632
false,false,6588,6183,405,626,00:00:32.000,2025-04-15 11:26:59.979
false,true,6588,6183,405,0,00:00:00.000,2025-04-15 11:27:03.981
false,true,6588,6183,405,0,00:00:00.000,2025-04-15 11:27:08.987
false,true,6594,6189,405,0,00:00:00.000,2025-04-15 11:27:19.997
false,true,6599,6194,405,0,00:00:00.000,2025-04-15 11:27:32.008
false,false,6606,6200,406,219,00:00:31.000,2025-04-15 11:27:42.017
false,false,6622,6215,407,156,00:00:33.000,2025-04-15 11:28:10.043
false,false,6568,6164,404,530,00:00:30.000,2025-04-15 11:26:33.952
false,true,6568,6164,404,0,00:00:00.000,2025-04-15 11:26:35.954
false,false,6571,6167,404,90,00:00:30.000,2025-04-15 11:26:42.961
false,false,6380,5989,391,222,00:00:33.000,2025-04-15 11:21:55.648
false,false,6385,5994,391,163,00:00:32.000,2025-04-15 11:22:06.659
false,false,6395,6004,391,30,00:00:30.000,2025-04-15 11:22:28.688
false,false,6413,6020,393,439,00:00:30.000,2025-04-15 11:22:52.717
false,true,6416,6023,393,0,00:00:00.000,2025-04-15 11:23:04.730
false,true,6428,6035,393,0,00:00:00.000,2025-04-15 11:23:29.755
false,false,6436,6042,394,219,00:00:31.000,2025-04-15 11:23:51.782
false,false,6444,6050,394,471,00:00:30.000,2025-04-15 11:23:59.789
false,false,6451,6057,394,126,00:00:30.000,2025-04-15 11:24:12.802
false,false,6461,6066,395,438,00:00:31.000,2025-04-15 11:24:22.816
false,true,6463,6068,395,0,00:00:00.000,2025-04-15 11:24:27.821
false,false,6466,6071,395,96,00:00:32.000,2025-04-15 11:24:33.827
false,true,6468,6072,396,0,00:00:00.000,2025-04-15 11:24:38.831
false,false,6472,6076,396,126,00:00:31.000,2025-04-15 11:24:45.837
false,false,6481,6084,397,409,00:00:31.000,2025-04-15 11:24:54.848
false,false,6485,6088,397,536,00:00:33.000,2025-04-15 11:24:58.851
false,false,6492,6094,398,758,00:00:32.000,2025-04-15 11:25:05.858
false,false,6643,6234,409,315,00:00:31.000,2025-04-15 11:28:43.074
false,false,6651,6241,410,567,00:00:31.000,2025-04-15 11:28:51.079
false,false,6653,6243,410,629,00:00:32.000,2025-04-15 11:28:53.081
false,false,6656,6246,410,721,00:00:31.000,2025-04-15 11:28:56.086
false,true,6659,6248,411,0,00:00:00.000,2025-04-15 11:29:06.096
false,false,6660,6248,412,30,00:00:30.000,2025-04-15 11:29:12.103
false,false,6665,6253,412,188,00:00:30.000,2025-04-15 11:29:17.109
false,true,6668,6256,412,0,00:00:00.000,2025-04-15 11:29:27.118
false,true,6672,6260,412,0,00:00:00.000,2025-04-15 11:29:41.132
false,false,6673,6261,412,31,00:00:31.000,2025-04-15 11:29:43.134
false,false,6690,6276,414,568,00:00:32.000,2025-04-15 11:30:00.151
false,true,6851,6431,420,0,00:00:00.000,2025-04-15 11:34:01.386
false,false,6876,6454,422,667,00:00:32.000,2025-04-15 11:34:36.426
false,false,6878,6456,422,731,00:00:32.000,2025-04-15 11:34:38.429
false,false,6704,6289,415,252,00:00:31.000,2025-04-15 11:30:26.173
false,false,6709,6294,415,406,00:00:30.000,2025-04-15 11:30:31.180
false,false,6722,6307,415,818,00:00:33.000,2025-04-15 11:30:44.188
false,false,6724,6309,415,880,00:00:30.000,2025-04-15 11:30:46.189
false,false,6750,6335,415,1705,00:00:33.000,2025-04-15 11:31:12.218
false,false,6768,6351,417,2276,00:00:31.000,2025-04-15 11:31:30.236
false,false,6911,6489,422,250,00:00:32.000,2025-04-15 11:35:41.495
false,false,7050,6620,430,64,00:00:33.000,2025-04-15 11:38:36.675
false,false,7054,6624,430,189,00:00:31.000,2025-04-15 11:38:40.677
false,false,7057,6627,430,283,00:00:31.000,2025-04-15 11:38:43.679
false,true,7075,6644,431,0,00:00:00.000,2025-04-15 11:39:07.699
false,false,7080,6649,431,162,00:00:32.000,2025-04-15 11:39:12.704
false,false,7089,6658,431,442,00:00:31.000,2025-04-15 11:39:21.715
false,false,7125,6693,432,1579,00:00:32.000,2025-04-15 11:39:57.763
false,false,7135,6702,433,1894,00:00:31.000,2025-04-15 11:40:07.775
false,true,6801,6382,419,0,00:00:00.000,2025-04-15 11:32:13.273
false,true,6808,6389,419,0,00:00:00.000,2025-04-15 11:32:31.290
false,true,6808,6389,419,0,00:00:00.000,2025-04-15 11:32:33.294
false,false,6826,6407,419,189,00:00:30.000,2025-04-15 11:33:10.337
false,true,6833,6414,419,0,00:00:00.000,2025-04-15 11:33:23.349
false,false,6973,6547,426,159,00:00:32.000,2025-04-15 11:37:07.582
false,false,6994,6567,427,66,00:00:33.000,2025-04-15 11:37:34.606
false,false,6999,6572,427,222,00:00:31.000,2025-04-15 11:37:39.612
false,false,7041,6611,430,1546,00:00:30.000,2025-04-15 11:38:21.657
false,false,7146,6710,436,31,00:00:31.000,2025-04-15 11:40:24.792
false,false,7152,6716,436,222,00:00:32.000,2025-04-15 11:40:30.800
false,false,7158,6721,437,408,00:00:31.000,2025-04-15 11:40:36.807
false,false,7189,6748,441,570,00:00:33.000,2025-04-15 11:41:19.855
false,false,7194,6753,441,726,00:00:32.000,2025-04-15 11:41:24.861
false,false,7357,6904,453,63,00:00:30.000,2025-04-15 11:45:20.109
false,false,7386,6930,456,220,00:00:30.000,2025-04-15 11:45:55.145
false,true,7404,6946,458,0,00:00:00.000,2025-04-15 11:46:24.174
false,true,7406,6948,458,0,00:00:00.000,2025-04-15 11:46:33.185
false,false,7407,6949,458,32,00:00:32.000,2025-04-15 11:46:34.186
false,false,7218,6773,445,64,00:00:32.000,2025-04-15 11:42:06.905
false,false,7225,6780,445,188,00:00:33.000,2025-04-15 11:42:19.921
false,false,7232,6787,445,405,00:00:30.000,2025-04-15 11:42:26.931
false,false,7249,6802,447,218,00:00:31.000,2025-04-15 11:42:49.949
false,true,7254,6807,447,0,00:00:00.000,2025-04-15 11:42:56.958
false,true,7254,6807,447,0,00:00:00.000,2025-04-15 11:42:59.962
false,false,7257,6810,447,94,00:00:33.000,2025-04-15 11:43:03.966
false,false,7433,6974,459,345,00:00:30.000,2025-04-15 11:47:12.224
false,false,7450,6990,460,253,00:00:33.000,2025-04-15 11:47:35.251
false,true,7489,7026,463,0,00:00:00.000,2025-04-15 11:48:31.317
false,false,7493,7030,463,128,00:00:31.000,2025-04-15 11:48:36.321
false,true,7495,7032,463,0,00:00:00.000,2025-04-15 11:48:41.328
false,false,7529,7064,465,33,00:00:33.000,2025-04-15 11:49:24.372
false,true,7540,7075,465,0,00:00:00.000,2025-04-15 11:49:41.391
false,false,7544,7079,465,120,00:00:30.000,2025-04-15 11:49:45.397
false,true,7545,7080,465,0,00:00:00.000,2025-04-15 11:49:52.402
false,false,7279,6831,448,64,00:00:33.000,2025-04-15 11:43:38.003
false,false,7290,6842,448,312,00:00:31.000,2025-04-15 11:43:55.017
false,false,7292,6843,449,373,00:00:31.000,2025-04-15 11:43:57.018
false,false,7297,6848,449,530,00:00:31.000,2025-04-15 11:44:02.022
false,false,7298,6849,449,562,00:00:32.000,2025-04-15 11:44:03.023
false,false,7306,6857,449,815,00:00:33.000,2025-04-15 11:44:11.032
false,false,7320,6871,449,94,00:00:31.000,2025-04-15 11:44:31.055
false,true,7559,7093,466,0,00:00:00.000,2025-04-15 11:50:12.420
false,false,7612,7145,467,1002,00:00:30.000,2025-04-15 11:51:17.475
false,false,7614,7147,467,1066,00:00:31.000,2025-04-15 11:51:19.477
false,false,7615,7148,467,1097,00:00:31.000,2025-04-15 11:51:20.478
false,false,7620,7153,467,1254,00:00:31.000,2025-04-15 11:51:25.484
false,false,7632,7165,467,1630,00:00:31.000,2025-04-15 11:51:37.494
false,false,7724,7256,468,248,00:00:30.000,2025-04-15 11:53:39.630
false,true,7763,7293,470,0,00:00:00.000,2025-04-15 11:54:30.691
false,true,7789,7319,470,0,00:00:00.000,2025-04-15 11:55:09.731
false,false,7656,7189,467,2391,00:00:33.000,2025-04-15 11:52:01.518
false,false,7658,7191,467,2454,00:00:33.000,2025-04-15 11:52:03.520
false,true,7683,7215,468,0,00:00:00.000,2025-04-15 11:52:40.565
false,false,7686,7218,468,98,00:00:33.000,2025-04-15 11:52:43.569
false,true,7690,7222,468,0,00:00:00.000,2025-04-15 11:52:48.575
false,false,7793,7323,470,125,00:00:30.000,2025-04-15 11:55:18.740
false,false,7813,7343,470,61,00:00:30.000,2025-04-15 11:55:50.777
false,false,7819,7347,472,65,00:00:32.000,2025-04-15 11:56:02.789
false,false,7841,7368,473,381,00:00:30.000,2025-04-15 11:56:48.840
false,true,7870,7396,474,0,00:00:00.000,2025-04-15 11:57:24.881
false,true,7870,7396,474,0,00:00:00.000,2025-04-15 11:57:27.886
false,true,7870,7396,474,0,00:00:00.000,2025-04-15 11:57:29.890
false,false,7874,7400,474,126,00:00:33.000,2025-04-15 11:57:39.902
false,false,7885,7411,474,475,00:00:31.000,2025-04-15 11:57:50.914
false,false,7886,7412,474,507,00:00:32.000,2025-04-15 11:57:51.915
false,false,7893,7419,474,731,00:00:32.000,2025-04-15 11:57:58.923
false,false,8000,7522,478,218,00:00:31.000,2025-04-15 12:00:16.063
false,true,8016,7538,478,0,00:00:00.000,2025-04-15 12:00:33.078
false,false,8033,7554,479,504,00:00:32.000,2025-04-15 12:01:01.105
false,true,8035,7556,479,0,00:00:00.000,2025-04-15 12:01:04.106
false,false,5158,4837,321,316,00:00:33.000,2025-04-15 10:53:19.926
false,false,5259,4932,327,877,00:00:32.000,2025-04-15 10:55:25.050
false,true,5303,4972,331,0,00:00:00.000,2025-04-15 10:56:25.107
false,false,5313,4980,333,315,00:00:31.000,2025-04-15 10:56:37.119
false,false,5322,4987,335,600,00:00:30.000,2025-04-15 10:56:46.126
false,false,4951,4647,304,404,00:00:30.000,2025-04-15 10:48:40.635
false,false,4959,4655,304,31,00:00:31.000,2025-04-15 10:48:54.648
false,false,4962,4657,305,126,00:00:30.000,2025-04-15 10:48:57.651
false,true,4962,4657,305,0,00:00:00.000,2025-04-15 10:49:00.655
false,false,4975,4670,305,414,00:00:33.000,2025-04-15 10:49:16.673
false,false,4987,4680,307,383,00:00:31.000,2025-04-15 10:49:34.692
false,false,4994,4687,307,602,00:00:31.000,2025-04-15 10:49:41.702
false,false,4995,4687,308,635,00:00:33.000,2025-04-15 10:49:42.704
false,false,4997,4688,309,61,00:00:31.000,2025-04-15 10:49:50.713
false,false,5006,4697,309,342,00:00:32.000,2025-04-15 10:49:59.723
false,false,5010,4701,309,466,00:00:30.000,2025-04-15 10:50:03.729
false,false,5026,4717,309,377,00:00:31.000,2025-04-15 10:50:31.763
false,false,5067,4753,314,1660,00:00:30.000,2025-04-15 10:51:12.807
false,false,5073,4758,315,1844,00:00:30.000,2025-04-15 10:51:18.812
false,false,5078,4762,316,2005,00:00:33.000,2025-04-15 10:51:23.816
false,true,5083,4767,316,0,00:00:00.000,2025-04-15 10:51:38.833
false,false,5177,4855,322,912,00:00:32.000,2025-04-15 10:53:38.944
false,false,5197,4873,324,313,00:00:30.000,2025-04-15 10:54:04.968
false,false,5206,4882,324,597,00:00:31.000,2025-04-15 10:54:13.978
false,true,5206,4882,324,0,00:00:00.000,2025-04-15 10:54:18.984
false,true,5211,4887,324,0,00:00:00.000,2025-04-15 10:54:30.996
false,false,5233,4907,326,63,00:00:33.000,2025-04-15 10:54:59.021
false,false,5240,4914,326,283,00:00:30.000,2025-04-15 10:55:06.029
false,false,5504,5158,346,508,00:00:32.000,2025-04-15 11:00:48.369
false,true,5516,5168,348,0,00:00:00.000,2025-04-15 11:01:12.394
false,false,5517,5169,348,32,00:00:32.000,2025-04-15 11:01:13.395
false,false,5527,5179,348,348,00:00:32.000,2025-04-15 11:01:23.405
false,false,5568,5218,350,881,00:00:32.000,2025-04-15 11:02:10.455
false,false,5571,5221,350,977,00:00:33.000,2025-04-15 11:02:13.457
false,true,5595,5245,350,0,00:00:00.000,2025-04-15 11:03:00.498
false,false,5604,5254,350,33,00:00:33.000,2025-04-15 11:03:16.513
false,false,5611,5261,350,253,00:00:33.000,2025-04-15 11:03:23.520
false,false,5613,5263,350,315,00:00:32.000,2025-04-15 11:03:25.524
false,false,5686,5330,356,33,00:00:33.000,2025-04-15 11:05:08.638
false,false,5720,5363,357,248,00:00:30.000,2025-04-15 11:06:12.701
false,false,5732,5372,360,627,00:00:31.000,2025-04-15 11:06:24.712
false,true,5650,5297,353,0,00:00:00.000,2025-04-15 11:04:03.564
false,false,5408,5067,341,63,00:00:30.000,2025-04-15 10:58:36.233
false,false,5432,5089,343,249,00:00:31.000,2025-04-15 10:59:06.268
false,true,5435,5092,343,0,00:00:00.000,2025-04-15 10:59:15.275
false,false,5460,5116,344,415,00:00:33.000,2025-04-15 10:59:46.306
false,false,5468,5124,344,663,00:00:31.000,2025-04-15 10:59:54.314
false,true,5470,5126,344,0,00:00:00.000,2025-04-15 11:00:00.318
false,true,5473,5129,344,0,00:00:00.000,2025-04-15 11:00:06.323
false,false,5887,5518,369,96,00:00:30.000,2025-04-15 11:10:29.963
false,true,5895,5525,370,0,00:00:00.000,2025-04-15 11:10:48.981
false,false,5922,5551,371,533,00:00:32.000,2025-04-15 11:11:29.022
false,false,5930,5558,372,785,00:00:32.000,2025-04-15 11:11:37.026
false,true,5935,5563,372,0,00:00:00.000,2025-04-15 11:11:46.035
false,true,5808,5442,366,0,00:00:00.000,2025-04-15 11:08:33.849
false,false,5813,5447,366,156,00:00:30.000,2025-04-15 11:08:39.854
false,false,5815,5449,366,63,00:00:32.000,2025-04-15 11:08:47.863
false,false,5855,5487,368,409,00:00:31.000,2025-04-15 11:09:39.916
false,false,5868,5499,369,315,00:00:30.000,2025-04-15 11:09:58.937
false,true,5937,5565,372,0,00:00:00.000,2025-04-15 11:11:54.045
false,false,5944,5572,372,219,00:00:33.000,2025-04-15 11:12:03.049
false,false,5985,5609,376,531,00:00:31.000,2025-04-15 11:12:50.099
false,true,6004,5628,376,0,00:00:00.000,2025-04-15 11:13:23.132
false,false,5744,5384,360,95,00:00:30.000,2025-04-15 11:06:48.736
false,true,5764,5402,362,0,00:00:00.000,2025-04-15 11:07:16.763
false,true,5764,5402,362,0,00:00:00.000,2025-04-15 11:07:24.774
false,false,5766,5404,362,64,00:00:32.000,2025-04-15 11:07:28.779
false,false,5768,5406,362,129,00:00:32.000,2025-04-15 11:07:30.782
false,false,5780,5416,364,188,00:00:31.000,2025-04-15 11:07:48.800
false,false,5794,5429,365,628,00:00:33.000,2025-04-15 11:08:02.814
false,true,5807,5441,366,0,00:00:00.000,2025-04-15 11:08:25.838
false,true,6008,5632,376,0,00:00:00.000,2025-04-15 11:13:39.146
false,false,6031,5653,378,728,00:00:33.000,2025-04-15 11:14:06.176
false,false,6036,5658,378,32,00:00:32.000,2025-04-15 11:14:23.192
false,false,6037,5659,378,64,00:00:32.000,2025-04-15 11:14:24.194
false,false,6054,5676,378,406,00:00:31.000,2025-04-15 11:14:47.216
false,false,6058,5680,378,531,00:00:32.000,2025-04-15 11:14:51.217
false,false,6068,5690,378,93,00:00:30.000,2025-04-15 11:15:07.236
false,false,6282,5895,387,61,00:00:30.000,2025-04-15 11:19:47.528
false,true,6292,5904,388,0,00:00:00.000,2025-04-15 11:19:59.539
false,false,6293,5905,388,31,00:00:31.000,2025-04-15 11:20:04.542
false,false,6126,5746,380,480,00:00:33.000,2025-04-15 11:16:29.323
false,false,6217,5830,387,661,00:00:30.000,2025-04-15 11:18:12.427
false,false,6306,5918,388,157,00:00:30.000,2025-04-15 11:20:29.567
false,false,6312,5924,388,340,00:00:31.000,2025-04-15 11:20:35.573
false,false,6314,5926,388,404,00:00:33.000,2025-04-15 11:20:37.576
false,false,6585,6180,405,533,00:00:31.000,2025-04-15 11:26:56.976
false,true,6588,6183,405,0,00:00:00.000,2025-04-15 11:27:04.981
false,true,6611,6205,406,0,00:00:00.000,2025-04-15 11:27:49.023
false,true,6611,6205,406,0,00:00:00.000,2025-04-15 11:27:53.027
false,false,6614,6208,406,96,00:00:32.000,2025-04-15 11:27:56.031
false,false,6621,6214,407,123,00:00:30.000,2025-04-15 11:28:09.042
false,true,6498,6100,398,0,00:00:00.000,2025-04-15 11:25:15.871
false,false,6510,6112,398,383,00:00:33.000,2025-04-15 11:25:29.885
false,false,6514,6115,399,512,00:00:32.000,2025-04-15 11:25:33.889
false,false,6549,6146,403,1612,00:00:30.000,2025-04-15 11:26:08.925
false,true,6551,6148,403,0,00:00:00.000,2025-04-15 11:26:15.936
false,true,6380,5989,391,0,00:00:00.000,2025-04-15 11:21:59.653
false,true,6380,5989,391,0,00:00:00.000,2025-04-15 11:22:00.654
false,true,6391,6000,391,0,00:00:00.000,2025-04-15 11:22:15.672
false,false,6392,6001,391,31,00:00:31.000,2025-04-15 11:22:19.678
false,true,6415,6022,393,0,00:00:00.000,2025-04-15 11:22:56.723
false,true,6428,6035,393,0,00:00:00.000,2025-04-15 11:23:27.752
false,true,6429,6036,393,0,00:00:00.000,2025-04-15 11:23:41.770
false,false,6438,6044,394,282,00:00:30.000,2025-04-15 11:23:53.783
false,false,6441,6047,394,377,00:00:33.000,2025-04-15 11:23:56.787
false,true,6468,6072,396,0,00:00:00.000,2025-04-15 11:24:36.830
false,false,6470,6074,396,63,00:00:31.000,2025-04-15 11:24:43.835
false,false,6475,6079,396,221,00:00:30.000,2025-04-15 11:24:48.841
false,false,6487,6090,397,602,00:00:33.000,2025-04-15 11:25:00.853
false,false,6491,6093,398,726,00:00:30.000,2025-04-15 11:25:04.857
false,false,6654,6244,410,659,00:00:30.000,2025-04-15 11:28:54.082
false,false,6657,6247,410,754,00:00:33.000,2025-04-15 11:28:57.088
false,true,6659,6248,411,0,00:00:00.000,2025-04-15 11:29:02.092
false,false,6661,6249,412,63,00:00:33.000,2025-04-15 11:29:13.105
false,true,6668,6256,412,0,00:00:00.000,2025-04-15 11:29:28.118
false,true,6692,6278,414,0,00:00:00.000,2025-04-15 11:30:03.155
false,true,6692,6278,414,0,00:00:00.000,2025-04-15 11:30:07.159
false,true,6838,6419,419,0,00:00:00.000,2025-04-15 11:33:29.353
false,false,6890,6468,422,256,00:00:33.000,2025-04-15 11:35:02.452
false,true,6696,6282,414,0,00:00:00.000,2025-04-15 11:30:14.162
false,false,6703,6288,415,221,00:00:33.000,2025-04-15 11:30:25.173
false,false,6706,6291,415,314,00:00:32.000,2025-04-15 11:30:28.176
false,false,6713,6298,415,533,00:00:33.000,2025-04-15 11:30:35.182
false,false,6732,6317,415,1134,00:00:33.000,2025-04-15 11:30:54.198
false,false,6737,6322,415,1294,00:00:32.000,2025-04-15 11:30:59.202
false,false,6745,6330,415,1546,00:00:32.000,2025-04-15 11:31:07.213
false,false,6763,6346,417,2118,00:00:32.000,2025-04-15 11:31:25.230
false,false,6779,6361,418,2624,00:00:33.000,2025-04-15 11:31:41.245
false,false,6899,6477,422,188,00:00:33.000,2025-04-15 11:35:23.473
false,true,6903,6481,422,0,00:00:00.000,2025-04-15 11:35:30.482
false,false,6910,6488,422,218,00:00:30.000,2025-04-15 11:35:40.493
false,false,6912,6490,422,280,00:00:30.000,2025-04-15 11:35:42.497
false,false,6919,6497,422,503,00:00:30.000,2025-04-15 11:35:49.505
false,false,6924,6502,422,665,00:00:33.000,2025-04-15 11:35:54.509
false,false,6932,6510,422,917,00:00:32.000,2025-04-15 11:36:02.518
false,true,6960,6535,425,0,00:00:00.000,2025-04-15 11:36:32.545
false,true,7048,6618,430,0,00:00:00.000,2025-04-15 11:38:29.667
false,true,7048,6618,430,0,00:00:00.000,2025-04-15 11:38:32.671
false,false,7072,6641,431,760,00:00:31.000,2025-04-15 11:38:58.691
false,false,7090,6659,431,472,00:00:30.000,2025-04-15 11:39:22.718
false,false,7102,6670,432,852,00:00:30.000,2025-04-15 11:39:34.737
false,false,7132,6699,433,1800,00:00:31.000,2025-04-15 11:40:04.771
false,false,6797,6378,419,343,00:00:30.000,2025-04-15 11:32:05.265
false,false,6802,6383,419,30,00:00:30.000,2025-04-15 11:32:16.275
false,true,6802,6383,419,0,00:00:00.000,2025-04-15 11:32:18.278
false,true,6808,6389,419,0,00:00:00.000,2025-04-15 11:32:38.297
false,true,6819,6400,419,0,00:00:00.000,2025-04-15 11:32:52.312
false,false,6821,6402,419,32,00:00:32.000,2025-04-15 11:33:05.328
false,false,6822,6403,419,64,00:00:32.000,2025-04-15 11:33:06.330
false,false,6834,6415,419,33,00:00:33.000,2025-04-15 11:33:24.349
false,true,6965,6539,426,0,00:00:00.000,2025-04-15 11:36:53.564
false,true,6968,6542,426,0,00:00:00.000,2025-04-15 11:37:01.574
false,true,6992,6566,426,0,00:00:00.000,2025-04-15 11:37:31.604
false,false,7029,6601,428,1174,00:00:33.000,2025-04-15 11:38:09.645
false,false,7166,6727,439,664,00:00:33.000,2025-04-15 11:40:44.817
false,false,7169,6730,439,95,00:00:32.000,2025-04-15 11:40:53.825
false,false,7179,6739,440,255,00:00:33.000,2025-04-15 11:41:09.843
false,false,7185,6744,441,443,00:00:33.000,2025-04-15 11:41:15.850
false,false,7210,6767,443,253,00:00:32.000,2025-04-15 11:41:46.885
false,false,7361,6908,453,190,00:00:33.000,2025-04-15 11:45:24.113
false,false,7369,6915,454,445,00:00:33.000,2025-04-15 11:45:32.120
false,false,7374,6919,455,604,00:00:32.000,2025-04-15 11:45:37.125
false,false,7383,6927,456,126,00:00:31.000,2025-04-15 11:45:52.140
false,false,7390,6932,458,346,00:00:31.000,2025-04-15 11:45:59.149
false,true,7404,6946,458,0,00:00:00.000,2025-04-15 11:46:15.162
false,false,7222,6777,445,92,00:00:30.000,2025-04-15 11:42:16.918
false,false,7229,6784,445,314,00:00:31.000,2025-04-15 11:42:23.927
false,false,7246,6799,447,124,00:00:31.000,2025-04-15 11:42:46.947
false,false,7256,6809,447,61,00:00:30.000,2025-04-15 11:43:02.964
false,false,7422,6963,459,163,00:00:33.000,2025-04-15 11:46:55.205
false,false,7430,6971,459,249,00:00:31.000,2025-04-15 11:47:09.220
false,true,7466,7006,460,0,00:00:00.000,2025-04-15 11:47:59.280
false,false,7469,7008,461,91,00:00:30.000,2025-04-15 11:48:06.288
false,true,7489,7026,463,0,00:00:00.000,2025-04-15 11:48:30.314
false,false,7504,7040,464,283,00:00:31.000,2025-04-15 11:48:53.346
false,false,7506,7042,464,346,00:00:33.000,2025-04-15 11:48:55.347
false,true,7540,7075,465,0,00:00:00.000,2025-04-15 11:49:39.388
false,true,7559,7093,466,0,00:00:00.000,2025-04-15 11:50:09.418
false,false,7277,6829,448,127,00:00:33.000,2025-04-15 11:43:29.993
false,true,7277,6829,448,0,00:00:00.000,2025-04-15 11:43:32.997
false,true,7280,6832,448,0,00:00:00.000,2025-04-15 11:43:43.008
false,true,7329,6880,449,0,00:00:00.000,2025-04-15 11:44:43.068
false,false,7332,6883,449,96,00:00:33.000,2025-04-15 11:44:49.073
false,false,7339,6889,450,317,00:00:33.000,2025-04-15 11:44:56.085
false,false,7350,6897,453,664,00:00:31.000,2025-04-15 11:45:07.096
false,false,7352,6899,453,727,00:00:30.000,2025-04-15 11:45:09.098
false,false,7569,7103,466,312,00:00:30.000,2025-04-15 11:50:22.429
false,true,7580,7114,466,0,00:00:00.000,2025-04-15 11:50:41.444
false,false,7602,7135,467,694,00:00:33.000,2025-04-15 11:51:07.464
false,false,7619,7152,467,1223,00:00:30.000,2025-04-15 11:51:24.483
false,false,7624,7157,467,1380,00:00:32.000,2025-04-15 11:51:29.487
false,false,7633,7166,467,1663,00:00:33.000,2025-04-15 11:51:38.496
false,false,7644,7177,467,2010,00:00:30.000,2025-04-15 11:51:49.507
false,false,7725,7257,468,278,00:00:30.000,2025-04-15 11:53:40.631
false,false,7727,7259,468,344,00:00:33.000,2025-04-15 11:53:42.634
false,false,7743,7274,469,852,00:00:31.000,2025-04-15 11:53:58.654
false,true,7769,7299,470,0,00:00:00.000,2025-04-15 11:54:42.706
false,false,7645,7178,467,2040,00:00:30.000,2025-04-15 11:51:50.508
false,false,7646,7179,467,2070,00:00:30.000,2025-04-15 11:51:51.509
false,false,7652,7185,467,2260,00:00:30.000,2025-04-15 11:51:57.513
false,false,7678,7210,468,381,00:00:30.000,2025-04-15 11:52:29.553
false,false,7679,7211,468,412,00:00:31.000,2025-04-15 11:52:30.554
false,true,7700,7232,468,0,00:00:00.000,2025-04-15 11:53:04.595
false,true,7700,7232,468,0,00:00:00.000,2025-04-15 11:53:05.594
false,false,7790,7320,470,30,00:00:30.000,2025-04-15 11:55:15.738
false,false,7801,7331,470,379,00:00:31.000,2025-04-15 11:55:26.752
false,true,7823,7350,473,0,00:00:00.000,2025-04-15 11:56:09.797
false,true,7824,7351,473,0,00:00:00.000,2025-04-15 11:56:18.808
false,false,7858,7384,474,431,00:00:31.000,2025-04-15 11:57:11.863
false,false,7860,7386,474,493,00:00:31.000,2025-04-15 11:57:13.864
false,true,7870,7396,474,0,00:00:00.000,2025-04-15 11:57:30.891
false,true,7870,7396,474,0,00:00:00.000,2025-04-15 11:57:31.894
false,false,7887,7413,474,539,00:00:32.000,2025-04-15 11:57:52.917
false,false,7901,7427,474,987,00:00:30.000,2025-04-15 11:58:06.931
false,false,7915,7440,475,1427,00:00:33.000,2025-04-15 11:58:20.945
false,false,7923,7448,475,1676,00:00:31.000,2025-04-15 11:58:28.950
false,false,7995,7517,478,62,00:00:32.000,2025-04-15 12:00:11.057
false,false,7997,7519,478,124,00:00:32.000,2025-04-15 12:00:13.060
false,false,7999,7521,478,187,00:00:30.000,2025-04-15 12:00:15.061
false,false,8018,7539,479,30,00:00:30.000,2025-04-15 12:00:46.088
false,false,8044,7565,479,284,00:00:33.000,2025-04-15 12:01:18.120
false,false,8045,7566,479,317,00:00:33.000,2025-04-15 12:01:19.121
false,false,8048,7569,479,412,00:00:31.000,2025-04-15 12:01:22.124
false,true,5148,4828,320,0,00:00:00.000,2025-04-15 10:53:07.917
false,false,5152,4831,321,123,00:00:31.000,2025-04-15 10:53:13.920
false,false,5161,4840,321,412,00:00:32.000,2025-04-15 10:53:22.928
false,true,5264,4937,327,0,00:00:00.000,2025-04-15 10:55:35.058
false,true,5298,4968,330,0,00:00:00.000,2025-04-15 10:56:12.098
false,true,5303,4972,331,0,00:00:00.000,2025-04-15 10:56:23.104
false,false,5306,4974,332,94,00:00:30.000,2025-04-15 10:56:30.111
false,false,5307,4975,332,124,00:00:30.000,2025-04-15 10:56:31.112
false,false,5314,4980,334,348,00:00:33.000,2025-04-15 10:56:38.120
false,false,4941,4637,304,95,00:00:32.000,2025-04-15 10:48:30.627
false,false,4945,4641,304,218,00:00:32.000,2025-04-15 10:48:34.631
false,true,4958,4654,304,0,00:00:00.000,2025-04-15 10:48:50.645
false,true,4975,4670,305,0,00:00:00.000,2025-04-15 10:49:18.675
false,false,4981,4675,306,192,00:00:32.000,2025-04-15 10:49:28.688
false,false,4993,4686,307,571,00:00:32.000,2025-04-15 10:49:40.701
false,false,5008,4699,309,405,00:00:33.000,2025-04-15 10:50:01.725
false,false,5021,4712,309,219,00:00:32.000,2025-04-15 10:50:26.758
false,false,5029,4720,309,471,00:00:32.000,2025-04-15 10:50:34.767
false,false,5055,4743,312,1287,00:00:33.000,2025-04-15 10:51:00.790
false,false,5187,4864,323,1228,00:00:31.000,2025-04-15 10:53:48.955
false,true,5187,4864,323,0,00:00:00.000,2025-04-15 10:53:50.957
false,false,5222,4896,326,343,00:00:31.000,2025-04-15 10:54:42.005
false,false,5225,4899,326,435,00:00:30.000,2025-04-15 10:54:45.008
false,false,5227,4901,326,498,00:00:31.000,2025-04-15 10:54:47.011
false,true,5473,5129,344,0,00:00:00.000,2025-04-15 11:00:09.326
false,false,5508,5161,347,633,00:00:32.000,2025-04-15 11:00:52.373
false,true,5511,5163,348,0,00:00:00.000,2025-04-15 11:00:56.375
false,true,5516,5168,348,0,00:00:00.000,2025-04-15 11:01:10.393
false,false,5533,5184,349,541,00:00:31.000,2025-04-15 11:01:29.411
false,false,5537,5188,349,668,00:00:32.000,2025-04-15 11:01:33.417
false,false,5564,5214,350,757,00:00:30.000,2025-04-15 11:02:06.450
false,false,5576,5226,350,1133,00:00:30.000,2025-04-15 11:02:18.460
false,false,5580,5230,350,1257,00:00:30.000,2025-04-15 11:02:22.462
false,false,5587,5237,350,163,00:00:33.000,2025-04-15 11:02:35.472
false,true,5595,5245,350,0,00:00:00.000,2025-04-15 11:02:52.489
false,true,5595,5245,350,0,00:00:00.000,2025-04-15 11:02:58.497
false,true,5595,5245,350,0,00:00:00.000,2025-04-15 11:03:01.499
false,true,5603,5253,350,0,00:00:00.000,2025-04-15 11:03:14.510
false,false,5608,5258,350,159,00:00:33.000,2025-04-15 11:03:20.516
false,false,5687,5331,356,63,00:00:30.000,2025-04-15 11:05:09.639
false,true,5687,5331,356,0,00:00:00.000,2025-04-15 11:05:14.644
false,true,5701,5345,356,0,00:00:00.000,2025-04-15 11:05:36.662
false,false,5733,5373,360,660,00:00:33.000,2025-04-15 11:06:25.713
false,true,5741,5381,360,0,00:00:00.000,2025-04-15 11:06:35.723
false,true,5741,5381,360,0,00:00:00.000,2025-04-15 11:06:37.725
false,false,5638,5285,353,1099,00:00:31.000,2025-04-15 11:03:50.551
false,true,5655,5302,353,0,00:00:00.000,2025-04-15 11:04:19.584
false,false,5659,5305,354,124,00:00:30.000,2025-04-15 11:04:23.587
false,false,5665,5310,355,64,00:00:32.000,2025-04-15 11:04:41.606
false,false,5670,5314,356,225,00:00:32.000,2025-04-15 11:04:46.611
false,true,5685,5329,356,0,00:00:00.000,2025-04-15 11:05:02.631
false,false,5407,5066,341,33,00:00:33.000,2025-04-15 10:58:35.232
false,false,5412,5071,341,189,00:00:31.000,2025-04-15 10:58:40.240
false,false,5426,5084,342,61,00:00:31.000,2025-04-15 10:59:00.262
false,false,5437,5094,343,62,00:00:32.000,2025-04-15 10:59:17.277
false,false,5453,5109,344,190,00:00:32.000,2025-04-15 10:59:39.298
false,false,5455,5111,344,253,00:00:32.000,2025-04-15 10:59:41.301
false,false,5461,5117,344,446,00:00:31.000,2025-04-15 10:59:47.306
false,true,5882,5513,369,0,00:00:00.000,2025-04-15 11:10:13.950
false,false,5886,5517,369,66,00:00:33.000,2025-04-15 11:10:28.963
false,false,5891,5521,370,97,00:00:31.000,2025-04-15 11:10:39.973
false,true,5905,5535,370,0,00:00:00.000,2025-04-15 11:11:07.000
false,false,5911,5540,371,185,00:00:31.000,2025-04-15 11:11:18.013
false,false,5818,5452,366,158,00:00:32.000,2025-04-15 11:08:50.868
false,false,5836,5468,368,534,00:00:30.000,2025-04-15 11:09:14.892
false,false,5843,5475,368,30,00:00:30.000,2025-04-15 11:09:27.905
false,false,5853,5485,368,345,00:00:30.000,2025-04-15 11:09:37.915
false,false,5859,5490,369,33,00:00:33.000,2025-04-15 11:09:49.927
false,false,5860,5491,369,65,00:00:32.000,2025-04-15 11:09:50.928
false,false,5861,5492,369,96,00:00:31.000,2025-04-15 11:09:51.930
false,false,5864,5495,369,190,00:00:30.000,2025-04-15 11:09:54.934
false,false,5867,5498,369,285,00:00:33.000,2025-04-15 11:09:57.937
false,false,5945,5573,372,249,00:00:30.000,2025-04-15 11:12:04.049
false,false,5953,5581,372,502,00:00:33.000,2025-04-15 11:12:12.058
false,false,6004,5628,376,218,00:00:30.000,2025-04-15 11:13:21.130
false,true,6004,5628,376,0,00:00:00.000,2025-04-15 11:13:22.132
false,false,5743,5383,360,65,00:00:33.000,2025-04-15 11:06:47.735
false,false,5787,5423,364,405,00:00:30.000,2025-04-15 11:07:55.807
false,false,5788,5423,365,438,00:00:33.000,2025-04-15 11:07:56.807
false,false,5789,5424,365,468,00:00:30.000,2025-04-15 11:07:57.809
false,false,5797,5431,366,64,00:00:33.000,2025-04-15 11:08:11.822
false,false,5802,5436,366,223,00:00:31.000,2025-04-15 11:08:16.827
false,false,6012,5636,376,129,00:00:32.000,2025-04-15 11:13:47.156
false,false,6014,5637,377,192,00:00:31.000,2025-04-15 11:13:49.158
false,true,6034,5656,378,0,00:00:00.000,2025-04-15 11:14:13.183
false,false,6041,5663,378,190,00:00:31.000,2025-04-15 11:14:28.196
false,false,6050,5672,378,283,00:00:33.000,2025-04-15 11:14:43.212
false,true,6065,5687,378,0,00:00:00.000,2025-04-15 11:15:01.228
false,true,6065,5687,378,0,00:00:00.000,2025-04-15 11:15:04.233
false,true,6232,5845,387,0,00:00:00.000,2025-04-15 11:18:39.454
false,false,6243,5856,387,345,00:00:31.000,2025-04-15 11:18:50.468
false,false,6250,5863,387,568,00:00:31.000,2025-04-15 11:18:57.477
false,false,6252,5865,387,629,00:00:30.000,2025-04-15 11:18:59.478
false,false,6264,5877,387,126,00:00:33.000,2025-04-15 11:19:17.496
false,true,6280,5893,387,0,00:00:00.000,2025-04-15 11:19:44.524
false,true,6292,5904,388,0,00:00:00.000,2025-04-15 11:20:02.542
false,true,6077,5698,379,0,00:00:00.000,2025-04-15 11:15:17.247
false,true,6077,5698,379,0,00:00:00.000,2025-04-15 11:15:20.251
false,false,6094,5715,379,32,00:00:32.000,2025-04-15 11:15:51.286
false,false,6099,5720,379,190,00:00:33.000,2025-04-15 11:15:56.289
false,false,6146,5765,381,1109,00:00:31.000,2025-04-15 11:16:49.342
false,false,6173,5790,383,1956,00:00:31.000,2025-04-15 11:17:16.368
false,false,6191,5807,384,190,00:00:30.000,2025-04-15 11:17:40.395
false,false,6193,5808,385,255,00:00:33.000,2025-04-15 11:17:42.397
false,false,6198,5813,385,62,00:00:30.000,2025-04-15 11:17:53.409
false,true,6299,5911,388,0,00:00:00.000,2025-04-15 11:20:14.554
false,true,6335,5945,390,0,00:00:00.000,2025-04-15 11:21:03.605
false,true,6335,5945,390,0,00:00:00.000,2025-04-15 11:21:04.606
false,false,6345,5954,391,312,00:00:32.000,2025-04-15 11:21:14.615
false,false,6359,5968,391,752,00:00:30.000,2025-04-15 11:21:28.626
false,false,6370,5979,391,1093,00:00:30.000,2025-04-15 11:21:39.637
false,false,6577,6173,404,282,00:00:33.000,2025-04-15 11:26:48.968
false,false,6579,6175,404,345,00:00:30.000,2025-04-15 11:26:50.969
false,false,6583,6178,405,471,00:00:33.000,2025-04-15 11:26:54.972
false,false,6603,6198,405,126,00:00:31.000,2025-04-15 11:27:39.014
false,false,6610,6204,406,344,00:00:33.000,2025-04-15 11:27:46.020
false,false,6624,6217,407,218,00:00:31.000,2025-04-15 11:28:12.045
false,false,6504,6106,398,192,00:00:30.000,2025-04-15 11:25:23.879
false,false,6505,6107,398,225,00:00:33.000,2025-04-15 11:25:24.879
false,false,6506,6108,398,255,00:00:30.000,2025-04-15 11:25:25.881
false,false,6507,6109,398,287,00:00:32.000,2025-04-15 11:25:26.882
false,false,6539,6139,400,1299,00:00:32.000,2025-04-15 11:25:58.916
false,false,6557,6154,403,189,00:00:33.000,2025-04-15 11:26:22.944
false,false,6564,6161,403,405,00:00:32.000,2025-04-15 11:26:29.951
false,true,6394,6003,391,0,00:00:00.000,2025-04-15 11:22:22.681
false,false,6401,6009,392,63,00:00:31.000,2025-04-15 11:22:40.702
false,false,6404,6012,392,157,00:00:31.000,2025-04-15 11:22:43.707
false,false,6408,6015,393,279,00:00:30.000,2025-04-15 11:22:47.712
false,true,6415,6022,393,0,00:00:00.000,2025-04-15 11:22:58.726
false,true,6425,6032,393,0,00:00:00.000,2025-04-15 11:23:18.741
false,false,6462,6067,395,468,00:00:30.000,2025-04-15 11:24:23.817
false,true,6463,6068,395,0,00:00:00.000,2025-04-15 11:24:30.825
false,true,6468,6072,396,0,00:00:00.000,2025-04-15 11:24:39.831
false,false,6494,6096,398,823,00:00:33.000,2025-04-15 11:25:07.860
false,false,6640,6231,409,219,00:00:31.000,2025-04-15 11:28:40.071
false,false,6648,6238,410,474,00:00:32.000,2025-04-15 11:28:48.076
false,false,6663,6251,412,126,00:00:33.000,2025-04-15 11:29:15.105
false,false,6688,6274,414,503,00:00:30.000,2025-04-15 11:29:58.149
false,false,6692,6278,414,633,00:00:33.000,2025-04-15 11:30:02.153
false,true,6838,6419,419,0,00:00:00.000,2025-04-15 11:33:38.362
false,false,6839,6420,419,30,00:00:30.000,2025-04-15 11:33:41.368
false,false,6843,6423,420,30,00:00:30.000,2025-04-15 11:33:51.376
false,false,6862,6442,420,222,00:00:33.000,2025-04-15 11:34:22.410
false,false,6867,6446,421,378,00:00:33.000,2025-04-15 11:34:27.417
false,false,6874,6452,422,602,00:00:32.000,2025-04-15 11:34:34.424
false,false,6875,6453,422,635,00:00:33.000,2025-04-15 11:34:35.425
false,true,6882,6460,422,0,00:00:00.000,2025-04-15 11:34:53.446
false,true,6891,6469,422,0,00:00:00.000,2025-04-15 11:35:08.459
false,false,6705,6290,415,282,00:00:30.000,2025-04-15 11:30:27.175
false,false,6738,6323,415,1326,00:00:32.000,2025-04-15 11:31:00.205
false,false,6747,6332,415,1609,00:00:33.000,2025-04-15 11:31:09.216
false,false,6756,6340,416,1896,00:00:31.000,2025-04-15 11:31:18.223
false,false,6927,6505,422,761,00:00:33.000,2025-04-15 11:35:57.514
false,false,6930,6508,422,853,00:00:30.000,2025-04-15 11:36:00.516
false,false,6940,6518,422,1172,00:00:32.000,2025-04-15 11:36:10.525
false,false,6951,6528,423,1517,00:00:32.000,2025-04-15 11:36:21.534
false,false,6953,6529,424,1581,00:00:33.000,2025-04-15 11:36:23.537
false,false,6956,6531,425,1676,00:00:32.000,2025-04-15 11:36:26.541
false,false,6961,6535,426,33,00:00:33.000,2025-04-15 11:36:37.551
false,true,6965,6539,426,0,00:00:00.000,2025-04-15 11:36:48.561
false,false,7064,6633,431,505,00:00:32.000,2025-04-15 11:38:50.684
false,true,7075,6644,431,0,00:00:00.000,2025-04-15 11:39:02.697
false,true,7075,6644,431,0,00:00:00.000,2025-04-15 11:39:05.698
false,false,7078,6647,431,98,00:00:33.000,2025-04-15 11:39:10.703
false,false,7079,6648,431,130,00:00:32.000,2025-04-15 11:39:11.703
false,false,7126,6694,432,1611,00:00:32.000,2025-04-15 11:39:58.765
false,false,6804,6385,419,61,00:00:30.000,2025-04-15 11:32:24.283
false,true,6808,6389,419,0,00:00:00.000,2025-04-15 11:32:36.295
false,false,6818,6399,419,311,00:00:32.000,2025-04-15 11:32:50.310
false,true,6819,6400,419,0,00:00:00.000,2025-04-15 11:32:55.318
false,false,6829,6410,419,281,00:00:31.000,2025-04-15 11:33:13.339
false,true,6968,6542,426,0,00:00:00.000,2025-04-15 11:36:59.572
false,false,6979,6553,426,349,00:00:32.000,2025-04-15 11:37:13.589
false,false,6980,6554,426,381,00:00:32.000,2025-04-15 11:37:14.589
false,false,7044,6614,430,1643,00:00:33.000,2025-04-15 11:38:24.661
false,false,7153,6716,437,252,00:00:30.000,2025-04-15 11:40:31.801
false,false,7180,6740,440,287,00:00:32.000,2025-04-15 11:41:10.844
false,false,7188,6747,441,537,00:00:30.000,2025-04-15 11:41:18.854
false,false,7195,6754,441,759,00:00:33.000,2025-04-15 11:41:25.863
false,false,7208,6765,443,189,00:00:33.000,2025-04-15 11:41:44.880
false,true,7355,6902,453,0,00:00:00.000,2025-04-15 11:45:14.102
false,true,7355,6902,453,0,00:00:00.000,2025-04-15 11:45:15.102
false,false,7363,6910,453,253,00:00:30.000,2025-04-15 11:45:26.117
false,true,7379,6923,456,0,00:00:00.000,2025-04-15 11:45:43.131
false,true,7379,6923,456,0,00:00:00.000,2025-04-15 11:45:47.135
false,false,7397,6939,458,565,00:00:31.000,2025-04-15 11:46:06.154
false,true,7406,6948,458,0,00:00:00.000,2025-04-15 11:46:31.182
false,false,7411,6952,459,154,00:00:31.000,2025-04-15 11:46:38.190
false,true,7219,6774,445,0,00:00:00.000,2025-04-15 11:42:08.908
false,true,7242,6795,447,0,00:00:00.000,2025-04-15 11:42:39.942
false,false,7243,6796,447,33,00:00:33.000,2025-04-15 11:42:43.944
false,false,7269,6822,447,469,00:00:30.000,2025-04-15 11:43:15.977
false,false,7435,6976,459,410,00:00:32.000,2025-04-15 11:47:14.226
false,false,7446,6986,460,125,00:00:32.000,2025-04-15 11:47:31.246
false,false,7463,7003,460,668,00:00:30.000,2025-04-15 11:47:48.268
false,false,7507,7043,464,379,00:00:33.000,2025-04-15 11:48:56.348
false,false,7518,7053,465,727,00:00:33.000,2025-04-15 11:49:07.361
false,false,7520,7055,465,791,00:00:33.000,2025-04-15 11:49:09.362
false,true,7528,7063,465,0,00:00:00.000,2025-04-15 11:49:22.370
false,true,7559,7093,466,0,00:00:00.000,2025-04-15 11:50:07.414
false,false,7307,6858,449,845,00:00:30.000,2025-04-15 11:44:12.034
false,false,7312,6863,449,1000,00:00:31.000,2025-04-15 11:44:17.038
false,true,7317,6868,449,0,00:00:00.000,2025-04-15 11:44:25.048
false,false,7319,6870,449,63,00:00:33.000,2025-04-15 11:44:30.055
false,false,7333,6884,449,127,00:00:31.000,2025-04-15 11:44:50.076
false,false,7338,6889,449,284,00:00:31.000,2025-04-15 11:44:55.084
false,false,7346,6895,451,539,00:00:33.000,2025-04-15 11:45:03.092
false,false,7599,7132,467,599,00:00:33.000,2025-04-15 11:51:04.462
false,false,7758,7288,470,1324,00:00:33.000,2025-04-15 11:54:13.673
true,true,5010,4701,309,0,00:00:00.000,2025-04-15 10:50:08.736
true,false,5031,4722,309,534,00:00:32.000,2025-04-15 10:50:36.767
true,false,5946,5574,372,282,00:00:33.000,2025-04-15 11:12:05.050
true,true,6232,5845,387,0,00:00:00.000,2025-04-15 11:18:35.450
true,false,6288,5901,387,252,00:00:31.000,2025-04-15 11:19:53.535
true,true,6498,6100,398,0,00:00:00.000,2025-04-15 11:25:13.868
true,false,6440,6046,394,344,00:00:32.000,2025-04-15 11:23:55.785
true,false,6820,6401,419,30,00:00:30.000,2025-04-15 11:32:58.320
true,false,6835,6416,419,66,00:00:33.000,2025-04-15 11:33:25.351
true,false,7241,6794,447,693,00:00:33.000,2025-04-15 11:42:35.939
true,true,7422,6963,459,0,00:00:00.000,2025-04-15 11:47:01.210
true,false,7443,6983,460,31,00:00:31.000,2025-04-15 11:47:28.243
true,false,7308,6859,449,875,00:00:30.000,2025-04-15 11:44:13.035
true,false,7850,7377,473,186,00:00:32.000,2025-04-15 11:57:03.854
true,true,5582,5232,350,0,00:00:00.000,2025-04-15 11:02:27.465
true,false,5448,5104,344,32,00:00:32.000,2025-04-15 10:59:34.292
true,true,5905,5535,370,0,00:00:00.000,2025-04-15 11:11:09.001
true,false,5778,5414,364,125,00:00:33.000,2025-04-15 11:07:46.798
true,true,6260,5873,387,0,00:00:00.000,2025-04-15 11:19:12.492
true,false,6082,5703,379,127,00:00:32.000,2025-04-15 11:15:33.264
true,true,6551,6148,403,0,00:00:00.000,2025-04-15 11:26:14.935
true,true,6808,6389,419,0,00:00:00.000,2025-04-15 11:32:34.293
true,false,7387,6931,456,253,00:00:33.000,2025-04-15 11:45:56.147
true,false,7388,6931,457,285,00:00:32.000,2025-04-15 11:45:57.148
true,false,7676,7208,468,320,00:00:31.000,2025-04-15 11:52:27.551
true,true,7801,7331,470,0,00:00:00.000,2025-04-15 11:55:27.753
true,false,7870,7396,474,812,00:00:30.000,2025-04-15 11:57:23.879
true,false,5558,5208,350,570,00:00:30.000,2025-04-15 11:02:00.441
true,false,5411,5070,341,158,00:00:30.000,2025-04-15 10:58:39.238
true,false,5814,5448,366,31,00:00:31.000,2025-04-15 11:08:46.861
true,false,5992,5616,376,752,00:00:30.000,2025-04-15 11:12:57.104
true,false,6177,5793,384,2079,00:00:30.000,2025-04-15 11:17:20.372
true,true,6631,6224,407,0,00:00:00.000,2025-04-15 11:28:23.054
true,false,6484,6087,397,503,00:00:30.000,2025-04-15 11:24:57.850
true,false,6655,6245,410,690,00:00:31.000,2025-04-15 11:28:55.085
true,true,6893,6471,422,0,00:00:00.000,2025-04-15 11:35:16.468
true,true,6786,6367,419,0,00:00:00.000,2025-04-15 11:31:52.253
true,true,7171,6731,440,0,00:00:00.000,2025-04-15 11:40:59.833
true,true,7829,7356,473,0,00:00:00.000,2025-04-15 11:56:32.823
true,false,5175,4853,322,847,00:00:31.000,2025-04-15 10:53:36.942
true,true,5488,5144,344,0,00:00:00.000,2025-04-15 11:00:32.351
true,false,5698,5342,356,347,00:00:31.000,2025-04-15 11:05:26.655
true,true,5884,5515,369,0,00:00:00.000,2025-04-15 11:10:21.958
true,false,5770,5407,363,191,00:00:30.000,2025-04-15 11:07:32.782
true,false,6686,6272,414,442,00:00:30.000,2025-04-15 11:29:56.147
true,true,6965,6539,426,0,00:00:00.000,2025-04-15 11:36:51.563
true,false,7258,6811,447,125,00:00:31.000,2025-04-15 11:43:04.967
true,true,7489,7026,463,0,00:00:00.000,2025-04-15 11:48:29.313
true,false,5312,4979,333,284,00:00:33.000,2025-04-15 10:56:36.118
true,false,4977,4672,305,63,00:00:33.000,2025-04-15 10:49:24.682
true,false,5728,5369,359,499,00:00:32.000,2025-04-15 11:06:20.707
true,false,5439,5096,343,122,00:00:30.000,2025-04-15 10:59:19.279
true,true,5795,5430,365,0,00:00:00.000,2025-04-15 11:08:09.820
true,false,6330,5941,389,908,00:00:33.000,2025-04-15 11:20:53.592
true,true,6568,6164,404,0,00:00:00.000,2025-04-15 11:26:39.956
true,true,7442,6982,460,0,00:00:00.000,2025-04-15 11:47:23.238
true,false,7334,6885,449,158,00:00:31.000,2025-04-15 11:44:51.077
true,false,7562,7096,466,94,00:00:31.000,2025-04-15 11:50:15.422
true,true,7870,7396,474,0,00:00:00.000,2025-04-15 11:57:32.895
true,false,4980,4675,305,160,00:00:33.000,2025-04-15 10:49:27.686
true,false,5003,4694,309,245,00:00:30.000,2025-04-15 10:49:56.721
true,false,5737,5377,360,787,00:00:32.000,2025-04-15 11:06:29.717
true,true,5741,5381,360,0,00:00:00.000,2025-04-15 11:06:36.725
true,false,5616,5266,350,412,00:00:33.000,2025-04-15 11:03:28.529
true,false,5850,5482,368,251,00:00:30.000,2025-04-15 11:09:34.913
true,false,6077,5698,379,381,00:00:32.000,2025-04-15 11:15:16.246
true,false,6163,5782,381,1646,00:00:32.000,2025-04-15 11:17:06.359
true,true,6617,6211,406,0,00:00:00.000,2025-04-15 11:28:01.034
true,false,7607,7140,467,847,00:00:30.000,2025-04-15 11:51:12.469
true,true,5211,4887,324,0,00:00:00.000,2025-04-15 10:54:27.993
true,false,5916,5545,371,343,00:00:30.000,2025-04-15 11:11:23.019
true,true,6299,5911,388,0,00:00:00.000,2025-04-15 11:20:16.555
true,true,6373,5982,391,0,00:00:00.000,2025-04-15 11:21:43.640
true,false,6613,6207,406,64,00:00:33.000,2025-04-15 11:27:55.029
true,false,6664,6252,412,158,00:00:32.000,2025-04-15 11:29:16.106
true,true,6842,6422,420,0,00:00:00.000,2025-04-15 11:33:46.371
true,false,7162,6724,438,535,00:00:32.000,2025-04-15 11:40:40.812
true,true,7417,6958,459,0,00:00:00.000,2025-04-15 11:46:47.199
true,false,5191,4868,323,125,00:00:32.000,2025-04-15 10:53:58.961
true,false,6229,5842,387,191,00:00:32.000,2025-04-15 11:18:30.444
true,false,6244,5857,387,378,00:00:33.000,2025-04-15 11:18:51.471
true,true,7379,6923,456,0,00:00:00.000,2025-04-15 11:45:45.132
true,true,7404,6946,458,0,00:00:00.000,2025-04-15 11:46:14.160
true,false,7781,7311,470,215,00:00:33.000,2025-04-15 11:55:00.720
true,true,7844,7371,473,0,00:00:00.000,2025-04-15 11:56:54.844
true,false,4944,4640,304,186,00:00:31.000,2025-04-15 10:48:33.629
true,true,4975,4670,305,0,00:00:00.000,2025-04-15 10:49:19.677
true,false,5410,5069,341,128,00:00:33.000,2025-04-15 10:58:38.236
true,false,5894,5524,370,193,00:00:30.000,2025-04-15 11:10:42.975
true,false,5895,5525,370,224,00:00:31.000,2025-04-15 11:10:43.976
true,false,5851,5483,368,284,00:00:33.000,2025-04-15 11:09:35.914
true,true,6006,5630,376,0,00:00:00.000,2025-04-15 11:13:31.138
true,false,6145,5764,381,1078,00:00:33.000,2025-04-15 11:16:48.342
true,false,6508,6110,398,318,00:00:31.000,2025-04-15 11:25:27.883
true,false,7412,6953,459,186,00:00:32.000,2025-04-15 11:46:39.189
true,false,8035,7556,479,567,00:00:33.000,2025-04-15 12:01:03.106
true,true,4995,4687,308,0,00:00:00.000,2025-04-15 10:49:45.711
true,false,5058,4745,313,1377,00:00:30.000,2025-04-15 10:51:03.793
true,false,5500,5154,346,381,00:00:32.000,2025-04-15 11:00:44.364
true,true,6260,5873,387,0,00:00:00.000,2025-04-15 11:19:08.489
true,true,6588,6183,405,0,00:00:00.000,2025-04-15 11:27:11.989
true,false,6430,6037,393,33,00:00:33.000,2025-04-15 11:23:45.772
true,false,6432,6038,394,95,00:00:30.000,2025-04-15 11:23:47.774
true,false,6667,6255,412,250,00:00:32.000,2025-04-15 11:29:19.112
true,true,6808,6389,419,0,00:00:00.000,2025-04-15 11:32:37.295
true,false,7201,6760,441,950,00:00:30.000,2025-04-15 11:41:31.868
true,false,7384,6928,456,157,00:00:31.000,2025-04-15 11:45:53.142
true,false,7421,6962,459,130,00:00:33.000,2025-04-15 11:46:54.205
true,false,7449,6989,460,220,00:00:32.000,2025-04-15 11:47:34.250
true,true,7545,7080,465,0,00:00:00.000,2025-04-15 11:49:49.399
true,false,4985,4678,307,320,00:00:30.000,2025-04-15 10:49:32.690
true,false,5048,4736,312,1065,00:00:31.000,2025-04-15 10:50:53.782
true,true,5590,5240,350,0,00:00:00.000,2025-04-15 11:02:41.479
true,true,5741,5381,360,0,00:00:00.000,2025-04-15 11:06:41.729
true,false,6213,5826,387,536,00:00:31.000,2025-04-15 11:18:08.423
true,false,6216,5829,387,631,00:00:33.000,2025-04-15 11:18:11.426
true,false,6319,5930,389,561,00:00:33.000,2025-04-15 11:20:42.580
true,true,6599,6194,405,0,00:00:00.000,2025-04-15 11:27:34.010
true,false,6548,6145,403,1582,00:00:30.000,2025-04-15 11:26:07.924
true,true,6468,6072,396,0,00:00:00.000,2025-04-15 11:24:40.830
true,true,6659,6248,411,0,00:00:00.000,2025-04-15 11:29:11.102
true,true,6692,6278,414,0,00:00:00.000,2025-04-15 11:30:04.155
true,false,6960,6535,425,1801,00:00:31.000,2025-04-15 11:36:30.544
true,true,6964,6538,426,0,00:00:00.000,2025-04-15 11:36:46.559
true,false,7013,6586,427,669,00:00:32.000,2025-04-15 11:37:53.625
true,false,5607,5257,350,126,00:00:30.000,2025-04-15 11:03:19.516
true,false,5693,5337,356,188,00:00:30.000,2025-04-15 11:05:21.649
true,false,5684,5328,356,667,00:00:31.000,2025-04-15 11:05:00.628
true,true,5882,5513,369,0,00:00:00.000,2025-04-15 11:10:18.956
true,false,5979,5603,376,340,00:00:30.000,2025-04-15 11:12:44.092
true,true,6041,5663,378,0,00:00:00.000,2025-04-15 11:14:32.198
true,false,6273,5886,387,406,00:00:31.000,2025-04-15 11:19:26.508
true,false,6278,5891,387,157,00:00:30.000,2025-04-15 11:19:37.519
true,false,6133,5753,380,699,00:00:32.000,2025-04-15 11:16:36.331
true,false,6784,6365,419,2780,00:00:32.000,2025-04-15 11:31:46.248
true,true,7355,6902,453,0,00:00:00.000,2025-04-15 11:45:16.104
true,false,7444,6984,460,62,00:00:31.000,2025-04-15 11:47:29.244
true,false,7565,7099,466,186,00:00:30.000,2025-04-15 11:50:18.425
true,false,7566,7100,466,219,00:00:33.000,2025-04-15 11:50:19.427
true,false,7587,7121,466,225,00:00:33.000,2025-04-15 11:50:52.453
true,true,7774,7304,470,0,00:00:00.000,2025-04-15 11:54:49.710
true,false,7666,7199,467,2706,00:00:30.000,2025-04-15 11:52:11.532
true,false,7875,7401,474,159,00:00:33.000,2025-04-15 11:57:40.903
true,false,5644,5291,353,1288,00:00:30.000,2025-04-15 11:03:56.556
true,true,6594,6189,405,0,00:00:00.000,2025-04-15 11:27:18.996
true,false,6602,6197,405,95,00:00:32.000,2025-04-15 11:27:38.014
true,true,6617,6211,406,0,00:00:00.000,2025-04-15 11:28:03.037
true,false,6445,6051,394,502,00:00:31.000,2025-04-15 11:24:00.789
true,true,6447,6053,394,0,00:00:00.000,2025-04-15 11:24:05.795
true,true,7048,6618,430,0,00:00:00.000,2025-04-15 11:38:33.673
true,true,7273,6825,448,0,00:00:00.000,2025-04-15 11:43:20.985
true,false,7464,7004,460,701,00:00:33.000,2025-04-15 11:47:49.269
true,false,7693,7225,468,94,00:00:30.000,2025-04-15 11:52:56.585
true,false,5441,5098,343,187,00:00:32.000,2025-04-15 10:59:21.281
true,false,6294,5906,388,63,00:00:32.000,2025-04-15 11:20:05.545
true,false,6210,5824,386,442,00:00:32.000,2025-04-15 11:18:05.419
true,false,6426,6033,393,33,00:00:33.000,2025-04-15 11:23:23.747
true,false,6701,6287,414,157,00:00:30.000,2025-04-15 11:30:23.171
true,false,6726,6311,415,944,00:00:33.000,2025-04-15 11:30:48.190
true,true,6968,6542,426,0,00:00:00.000,2025-04-15 11:37:00.574
true,true,7464,7004,460,0,00:00:00.000,2025-04-15 11:47:50.271
true,false,6059,5681,378,562,00:00:31.000,2025-04-15 11:14:52.219
true,false,6109,5730,379,503,00:00:32.000,2025-04-15 11:16:06.301
true,false,6171,5788,383,1894,00:00:30.000,2025-04-15 11:17:14.366
true,false,6410,6017,393,344,00:00:32.000,2025-04-15 11:22:49.714
true,true,6468,6072,396,0,00:00:00.000,2025-04-15 11:24:41.833
true,false,7467,7006,461,31,00:00:31.000,2025-04-15 11:48:04.287
true,false,7631,7164,467,1599,00:00:33.000,2025-04-15 11:51:36.494
true,false,5692,5336,356,158,00:00:32.000,2025-04-15 11:05:20.648
true,false,5473,5129,344,97,00:00:33.000,2025-04-15 11:00:05.322
true,false,5977,5601,376,280,00:00:31.000,2025-04-15 11:12:42.091
true,false,6600,6195,405,31,00:00:31.000,2025-04-15 11:27:36.011
true,true,6820,6401,419,0,00:00:00.000,2025-04-15 11:33:02.325
true,false,7002,6575,427,316,00:00:31.000,2025-04-15 11:37:42.616
true,false,7019,6591,428,857,00:00:32.000,2025-04-15 11:37:59.631
true,false,7524,7059,465,918,00:00:32.000,2025-04-15 11:49:13.365
true,false,7564,7098,466,156,00:00:31.000,2025-04-15 11:50:17.424
true,false,7588,7122,466,255,00:00:30.000,2025-04-15 11:50:53.454
true,false,7728,7260,468,374,00:00:30.000,2025-04-15 11:53:43.635
true,false,7766,7296,470,98,00:00:33.000,2025-04-15 11:54:33.694
false,true,7769,7299,470,0,00:00:00.000,2025-04-15 11:54:37.699
false,true,7769,7299,470,0,00:00:00.000,2025-04-15 11:54:38.701
false,true,7774,7304,470,0,00:00:00.000,2025-04-15 11:54:52.714
false,false,7777,7307,470,91,00:00:30.000,2025-04-15 11:54:56.717
false,false,7662,7195,467,2581,00:00:33.000,2025-04-15 11:52:07.528
false,false,7663,7196,467,2612,00:00:31.000,2025-04-15 11:52:08.528
false,true,7683,7215,468,0,00:00:00.000,2025-04-15 11:52:38.563
false,true,7683,7215,468,0,00:00:00.000,2025-04-15 11:52:39.563
false,false,7697,7229,468,220,00:00:31.000,2025-04-15 11:53:00.591
false,true,7817,7347,470,0,00:00:00.000,2025-04-15 11:55:56.783
false,false,7832,7359,473,92,00:00:30.000,2025-04-15 11:56:39.829
false,true,7844,7371,473,0,00:00:00.000,2025-04-15 11:56:56.847
false,false,7851,7378,473,218,00:00:32.000,2025-04-15 11:57:04.855
false,false,7867,7393,474,720,00:00:33.000,2025-04-15 11:57:20.874
false,false,7877,7403,474,225,00:00:33.000,2025-04-15 11:57:42.905
false,false,7881,7407,474,347,00:00:31.000,2025-04-15 11:57:46.909
false,false,7892,7418,474,699,00:00:30.000,2025-04-15 11:57:57.921
false,false,7908,7434,474,1202,00:00:30.000,2025-04-15 11:58:13.938
false,false,7910,7436,474,1266,00:00:32.000,2025-04-15 11:58:15.940
false,false,8001,7523,478,249,00:00:31.000,2025-04-15 12:00:17.063
false,false,8011,7533,478,565,00:00:32.000,2025-04-15 12:00:27.073
false,false,8031,7552,479,440,00:00:33.000,2025-04-15 12:00:59.101
false,false,8046,7567,479,350,00:00:33.000,2025-04-15 12:01:20.122
false,false,8049,7570,479,443,00:00:31.000,2025-04-15 12:01:23.125
false,false,8058,7578,480,724,00:00:32.000,2025-04-15 12:01:32.136
false,false,8130,7645,485,281,00:00:32.000,2025-04-15 12:03:44.269
false,false,8197,7710,487,65,00:00:33.000,2025-04-15 12:05:03.355
false,true,8071,7589,482,0,00:00:00.000,2025-04-15 12:01:55.156
false,false,8094,7610,484,96,00:00:32.000,2025-04-15 12:02:32.191
false,true,8108,7624,484,0,00:00:00.000,2025-04-15 12:02:55.215
false,true,8108,7624,484,0,00:00:00.000,2025-04-15 12:02:57.218
false,true,8121,7637,484,0,00:00:00.000,2025-04-15 12:03:18.239
false,true,8121,7637,484,0,00:00:00.000,2025-04-15 12:03:24.245
false,true,8121,7637,484,0,00:00:00.000,2025-04-15 12:03:29.253
false,true,7942,7467,475,0,00:00:00.000,2025-04-15 11:58:56.983
false,false,7949,7474,475,224,00:00:32.000,2025-04-15 11:59:06.991
false,false,7960,7485,475,348,00:00:32.000,2025-04-15 11:59:24.010
false,false,7975,7499,476,126,00:00:32.000,2025-04-15 11:59:45.033
false,true,7993,7515,478,0,00:00:00.000,2025-04-15 12:00:06.050
false,false,8298,7804,494,1563,00:00:31.000,2025-04-15 12:07:08.473
false,true,8304,7810,494,0,00:00:00.000,2025-04-15 12:07:18.482
false,false,8342,7846,496,30,00:00:30.000,2025-04-15 12:08:16.537
false,false,8349,7852,497,253,00:00:30.000,2025-04-15 12:08:23.542
false,false,8365,7868,497,278,00:00:32.000,2025-04-15 12:08:45.564
false,false,8369,7871,498,405,00:00:33.000,2025-04-15 12:08:49.567
false,true,8395,7895,500,0,00:00:00.000,2025-04-15 12:09:19.595
false,true,8409,7908,501,0,00:00:00.000,2025-04-15 12:09:38.612
false,true,8411,7910,501,0,00:00:00.000,2025-04-15 12:09:45.618
false,true,8428,7926,502,0,00:00:00.000,2025-04-15 12:10:18.650
false,false,8440,7938,502,379,00:00:33.000,2025-04-15 12:10:30.661
false,true,8442,7940,502,0,00:00:00.000,2025-04-15 12:10:36.666
false,true,8453,7951,502,0,00:00:00.000,2025-04-15 12:10:51.680
false,true,8453,7951,502,0,00:00:00.000,2025-04-15 12:10:53.681
false,true,8463,7961,502,0,00:00:00.000,2025-04-15 12:11:08.698
false,false,8216,7728,488,313,00:00:30.000,2025-04-15 12:05:28.375
false,false,8219,7730,489,405,00:00:30.000,2025-04-15 12:05:31.377
false,false,8232,7741,491,819,00:00:32.000,2025-04-15 12:05:44.391
false,true,8246,7754,492,0,00:00:00.000,2025-04-15 12:06:10.413
false,false,8581,8076,505,30,00:00:30.000,2025-04-15 12:13:45.852
false,true,8587,8081,506,0,00:00:00.000,2025-04-15 12:13:55.860
false,false,8593,8086,507,190,00:00:32.000,2025-04-15 12:14:03.869
false,false,8616,8107,509,686,00:00:31.000,2025-04-15 12:14:38.904
false,false,8620,8111,509,816,00:00:32.000,2025-04-15 12:14:42.908
false,false,8625,8115,510,974,00:00:33.000,2025-04-15 12:14:47.912
false,true,8625,8115,510,0,00:00:00.000,2025-04-15 12:14:50.913
false,false,8632,8121,511,224,00:00:32.000,2025-04-15 12:15:00.923
false,false,8699,8186,513,218,00:00:32.000,2025-04-15 12:16:56.036
false,false,8703,8190,513,343,00:00:31.000,2025-04-15 12:17:00.040
false,false,8737,8221,516,1006,00:00:30.000,2025-04-15 12:17:40.079
false,false,8740,8223,517,1104,00:00:33.000,2025-04-15 12:17:43.080
false,true,8750,8232,518,0,00:00:00.000,2025-04-15 12:17:55.097
false,true,8750,8232,518,0,00:00:00.000,2025-04-15 12:17:57.101
false,false,8751,8233,518,30,00:00:30.000,2025-04-15 12:18:00.102
false,false,8763,8245,518,406,00:00:31.000,2025-04-15 12:18:12.116
false,true,8651,8139,512,0,00:00:00.000,2025-04-15 12:15:29.950
false,true,8656,8144,512,0,00:00:00.000,2025-04-15 12:15:37.959
false,false,8665,8153,512,287,00:00:32.000,2025-04-15 12:15:51.972
false,true,8672,8160,512,0,00:00:00.000,2025-04-15 12:16:01.980
false,true,8674,8162,512,0,00:00:00.000,2025-04-15 12:16:08.988
false,true,8674,8162,512,0,00:00:00.000,2025-04-15 12:16:11.992
false,false,8675,8163,512,31,00:00:31.000,2025-04-15 12:16:13.994
false,false,8497,7994,503,254,00:00:33.000,2025-04-15 12:11:51.745
false,false,8508,8004,504,602,00:00:33.000,2025-04-15 12:12:02.753
false,false,8516,8011,505,93,00:00:30.000,2025-04-15 12:12:16.767
false,false,8546,8041,505,630,00:00:31.000,2025-04-15 12:12:52.803
false,false,8561,8056,505,469,00:00:31.000,2025-04-15 12:13:13.824
false,false,8565,8060,505,592,00:00:30.000,2025-04-15 12:13:17.829
false,false,8577,8072,505,978,00:00:32.000,2025-04-15 12:13:29.842
false,false,8781,8262,519,223,00:00:32.000,2025-04-15 12:18:36.137
false,true,8786,8267,519,0,00:00:00.000,2025-04-15 12:18:45.146
false,false,8801,8282,519,30,00:00:30.000,2025-04-15 12:19:14.175
false,false,8803,8284,519,92,00:00:30.000,2025-04-15 12:19:16.178
false,false,8814,8293,521,440,00:00:31.000,2025-04-15 12:19:27.190
false,true,8817,8296,521,0,00:00:00.000,2025-04-15 12:19:36.199
false,false,8831,8309,522,437,00:00:33.000,2025-04-15 12:19:50.214
false,false,8841,8318,523,31,00:00:31.000,2025-04-15 12:20:06.231
false,false,8842,8319,523,61,00:00:30.000,2025-04-15 12:20:07.231
false,false,8932,8402,530,1097,00:00:32.000,2025-04-15 12:22:13.368
false,false,8942,8411,531,1408,00:00:31.000,2025-04-15 12:22:23.374
false,false,8948,8417,531,1601,00:00:33.000,2025-04-15 12:22:29.381
false,true,8956,8425,531,0,00:00:00.000,2025-04-15 12:22:41.393
false,true,8964,8433,531,0,00:00:00.000,2025-04-15 12:22:57.410
false,false,8967,8434,533,98,00:00:33.000,2025-04-15 12:23:00.412
false,false,8974,8441,533,317,00:00:32.000,2025-04-15 12:23:07.421
false,false,8995,8462,533,970,00:00:33.000,2025-04-15 12:23:28.440
false,true,8897,8368,529,0,00:00:00.000,2025-04-15 12:21:35.325
false,true,9243,8691,552,0,00:00:00.000,2025-04-15 12:28:48.753
false,true,9277,8721,556,0,00:00:00.000,2025-04-15 12:29:37.807
false,false,9281,8725,556,124,00:00:32.000,2025-04-15 12:29:50.819
false,false,9289,8732,557,378,00:00:30.000,2025-04-15 12:29:58.827
false,true,9289,8732,557,0,00:00:00.000,2025-04-15 12:30:00.829
false,false,9084,8543,541,859,00:00:33.000,2025-04-15 12:25:27.547
false,false,9107,8563,544,1583,00:00:32.000,2025-04-15 12:25:50.572
false,false,9113,8569,544,1769,00:00:32.000,2025-04-15 12:25:56.577
false,false,9122,8578,544,2053,00:00:33.000,2025-04-15 12:26:05.583
false,false,9128,8584,544,2237,00:00:32.000,2025-04-15 12:26:11.591
false,false,9143,8599,544,2704,00:00:30.000,2025-04-15 12:26:26.605
false,false,9155,8610,545,95,00:00:31.000,2025-04-15 12:26:44.622
false,false,9187,8639,548,600,00:00:33.000,2025-04-15 12:27:28.662
false,true,9190,8642,548,0,00:00:00.000,2025-04-15 12:27:36.671
false,false,9194,8646,548,124,00:00:32.000,2025-04-15 12:27:41.675
false,false,9203,8654,549,405,00:00:31.000,2025-04-15 12:27:50.687
false,false,9204,8655,549,436,00:00:31.000,2025-04-15 12:27:51.689
false,true,9208,8659,549,0,00:00:00.000,2025-04-15 12:27:57.694
false,false,9219,8668,551,347,00:00:30.000,2025-04-15 12:28:12.713
false,false,9356,8795,561,63,00:00:33.000,2025-04-15 12:31:47.929
false,true,9368,8806,562,0,00:00:00.000,2025-04-15 12:32:17.961
false,false,9389,8827,562,159,00:00:30.000,2025-04-15 12:32:50.998
false,false,9001,8468,533,1160,00:00:31.000,2025-04-15 12:23:34.446
false,false,9003,8470,533,33,00:00:33.000,2025-04-15 12:23:42.453
false,false,9009,8476,533,223,00:00:32.000,2025-04-15 12:23:48.458
false,false,9027,8492,535,408,00:00:32.000,2025-04-15 12:24:12.477
false,false,9043,8506,537,467,00:00:30.000,2025-04-15 12:24:34.497
false,false,9480,8916,564,95,00:00:32.000,2025-04-15 12:34:52.129
false,false,9481,8917,564,125,00:00:30.000,2025-04-15 12:34:53.129
false,false,9494,8929,565,533,00:00:30.000,2025-04-15 12:35:06.143
false,true,9501,8933,568,0,00:00:00.000,2025-04-15 12:35:15.153
false,false,9522,8953,569,313,00:00:30.000,2025-04-15 12:35:46.179
false,false,9525,8956,569,406,00:00:32.000,2025-04-15 12:35:49.183
false,false,9533,8962,571,653,00:00:31.000,2025-04-15 12:35:57.194
false,false,9536,8965,571,745,00:00:30.000,2025-04-15 12:36:00.194
false,true,9550,8978,572,0,00:00:00.000,2025-04-15 12:36:23.219
false,false,9560,8988,572,219,00:00:32.000,2025-04-15 12:36:42.239
false,false,9564,8992,572,343,00:00:30.000,2025-04-15 12:36:46.242
false,false,9573,9001,572,629,00:00:30.000,2025-04-15 12:36:55.252
false,false,9580,9007,573,848,00:00:31.000,2025-04-15 12:37:02.257
false,false,9583,9010,573,63,00:00:33.000,2025-04-15 12:37:11.269
false,false,9613,9038,575,378,00:00:30.000,2025-04-15 12:37:47.305
false,false,9629,9054,575,881,00:00:32.000,2025-04-15 12:38:03.321
false,false,9635,9060,575,1072,00:00:32.000,2025-04-15 12:38:09.328
false,false,9404,8842,562,94,00:00:33.000,2025-04-15 12:33:18.028
false,false,9407,8845,562,190,00:00:32.000,2025-04-15 12:33:21.032
false,false,9461,8897,564,1031,00:00:30.000,2025-04-15 12:34:21.101
false,false,9468,8904,564,1253,00:00:32.000,2025-04-15 12:34:28.105
false,false,9337,8776,561,442,00:00:32.000,2025-04-15 12:31:16.902
false,false,9338,8777,561,474,00:00:32.000,2025-04-15 12:31:17.903
false,false,9644,9069,575,1355,00:00:32.000,2025-04-15 12:38:18.344
false,false,9654,9078,576,159,00:00:31.000,2025-04-15 12:38:34.359
false,true,9675,9097,578,0,00:00:00.000,2025-04-15 12:39:00.385
false,false,9683,9104,579,250,00:00:33.000,2025-04-15 12:39:09.396
false,false,9692,9113,579,534,00:00:32.000,2025-04-15 12:39:18.406
false,true,9701,9120,581,0,00:00:00.000,2025-04-15 12:39:37.429
false,false,9706,9125,581,156,00:00:31.000,2025-04-15 12:39:44.437
false,true,1618,1521,97,0,00:00:00.000,2025-04-14 11:39:41.131
false,false,1632,1534,98,186,00:00:30.000,2025-04-14 11:40:29.169
false,false,1650,1552,98,752,00:00:32.000,2025-04-14 11:41:05.198
false,false,1805,1700,105,251,00:00:32.000,2025-04-14 11:48:51.528
false,false,1809,1704,105,380,00:00:33.000,2025-04-14 11:48:59.535
false,true,1839,1731,108,0,00:00:00.000,2025-04-14 11:50:13.587
false,true,1841,1732,109,0,00:00:00.000,2025-04-14 11:50:39.609
false,false,1862,1752,110,659,00:00:32.000,2025-04-14 11:51:21.641
false,false,1871,1760,111,934,00:00:30.000,2025-04-14 11:51:39.655
false,true,1950,1835,115,0,00:00:00.000,2025-04-14 11:55:43.833
false,true,1958,1843,115,0,00:00:00.000,2025-04-14 11:56:29.865
false,false,1959,1844,115,30,00:00:30.000,2025-04-14 11:56:35.872
false,false,1977,1861,116,574,00:00:33.000,2025-04-14 11:57:23.912
false,true,1752,1648,104,0,00:00:00.000,2025-04-14 11:45:37.403
false,true,1773,1669,104,0,00:00:00.000,2025-04-14 11:46:37.439
false,false,1789,1685,104,313,00:00:31.000,2025-04-14 11:48:07.501
false,false,1792,1688,104,411,00:00:32.000,2025-04-14 11:48:13.503
false,true,1880,1769,111,0,00:00:00.000,2025-04-14 11:51:59.667
false,false,1886,1775,111,190,00:00:32.000,2025-04-14 11:52:33.689
false,false,1888,1776,112,254,00:00:33.000,2025-04-14 11:52:37.692
false,false,1903,1790,113,30,00:00:30.000,2025-04-14 11:53:31.731
false,false,1905,1792,113,92,00:00:30.000,2025-04-14 11:53:35.733
false,true,1924,1811,113,0,00:00:00.000,2025-04-14 11:54:19.772
false,false,1926,1812,114,64,00:00:31.000,2025-04-14 11:54:29.781
false,true,1926,1812,114,0,00:00:00.000,2025-04-14 11:54:37.784
false,false,1932,1818,114,191,00:00:32.000,2025-04-14 11:54:53.793
false,true,1699,1597,102,0,00:00:00.000,2025-04-14 11:43:21.296
false,false,1707,1605,102,244,00:00:30.000,2025-04-14 11:43:47.321
false,false,1719,1617,102,62,00:00:32.000,2025-04-14 11:44:23.346
false,false,1726,1623,103,284,00:00:30.000,2025-04-14 11:44:37.356
false,false,1730,1626,104,408,00:00:32.000,2025-04-14 11:44:45.363
false,false,1740,1636,104,726,00:00:32.000,2025-04-14 11:45:05.379
false,false,2260,2131,129,63,00:00:32.000,2025-04-14 12:08:50.386
false,true,2278,2149,129,0,00:00:00.000,2025-04-14 12:09:36.426
false,false,2312,2182,130,249,00:00:32.000,2025-04-14 12:11:10.493
false,false,2324,2194,130,629,00:00:33.000,2025-04-14 12:11:34.513
false,false,2168,2045,123,187,00:00:32.000,2025-04-14 12:05:22.257
false,false,2176,2053,123,438,00:00:30.000,2025-04-14 12:05:38.266
false,false,2177,2054,123,471,00:00:33.000,2025-04-14 12:05:40.266
false,false,2215,2088,127,946,00:00:33.000,2025-04-14 12:07:08.320
false,false,2219,2092,127,1072,00:00:30.000,2025-04-14 12:07:16.326
false,false,2224,2096,128,1230,00:00:31.000,2025-04-14 12:07:26.336
false,false,2235,2107,128,1571,00:00:32.000,2025-04-14 12:07:48.347
false,false,2022,1905,117,594,00:00:31.000,2025-04-14 11:59:17.997
false,false,2032,1915,117,909,00:00:30.000,2025-04-14 11:59:38.015
false,false,2050,1932,118,252,00:00:33.000,2025-04-14 12:00:26.051
false,false,2077,1958,119,478,00:00:31.000,2025-04-14 12:01:32.099
false,false,2081,1962,119,606,00:00:30.000,2025-04-14 12:01:40.102
false,false,2086,1967,119,765,00:00:33.000,2025-04-14 12:01:50.108
false,false,2415,2280,135,248,00:00:31.000,2025-04-14 12:15:48.703
false,false,2421,2286,135,439,00:00:31.000,2025-04-14 12:16:00.710
false,false,2424,2289,135,535,00:00:33.000,2025-04-14 12:16:06.714
false,false,2441,2303,138,188,00:00:33.000,2025-04-14 12:16:52.750
false,true,2451,2313,138,0,00:00:00.000,2025-04-14 12:17:30.784
false,false,2452,2314,138,32,00:00:32.000,2025-04-14 12:17:38.789
false,false,2469,2331,138,158,00:00:31.000,2025-04-14 12:18:36.826
false,false,2338,2207,131,1078,00:00:31.000,2025-04-14 12:12:02.536
false,false,2353,2222,131,158,00:00:33.000,2025-04-14 12:13:08.577
false,false,2361,2230,131,65,00:00:33.000,2025-04-14 12:13:36.599
false,false,2371,2239,132,386,00:00:33.000,2025-04-14 12:13:56.613
false,false,2099,1980,119,1178,00:00:32.000,2025-04-14 12:02:16.127
false,false,2108,1989,119,1458,00:00:32.000,2025-04-14 12:02:34.138
false,false,2134,2014,120,727,00:00:33.000,2025-04-14 12:03:38.188
false,true,2137,2017,120,0,00:00:00.000,2025-04-14 12:03:48.192
false,false,2158,2036,122,662,00:00:33.000,2025-04-14 12:04:38.224
false,false,2162,2040,122,128,00:00:33.000,2025-04-14 12:04:58.239
false,false,2478,2340,138,443,00:00:32.000,2025-04-14 12:18:54.837
false,false,2485,2346,139,661,00:00:30.000,2025-04-14 12:19:08.843
false,false,2491,2352,139,852,00:00:31.000,2025-04-14 12:19:20.848
false,false,2528,2386,142,562,00:00:31.000,2025-04-14 12:20:46.901
false,false,2546,2404,142,1142,00:00:33.000,2025-04-14 12:21:22.933
false,false,2573,2426,147,193,00:00:32.000,2025-04-14 12:22:28.993
false,false,2574,2427,147,223,00:00:30.000,2025-04-14 12:22:30.994
false,true,2588,2441,147,0,00:00:00.000,2025-04-14 12:23:05.020
false,false,2616,2466,150,184,00:00:30.000,2025-04-14 12:24:31.079
false,true,2733,2571,162,0,00:00:00.000,2025-04-14 12:29:07.292
false,false,2734,2572,162,31,00:00:31.000,2025-04-14 12:29:15.294
false,false,2740,2578,162,61,00:00:30.000,2025-04-14 12:29:39.313
false,true,2742,2580,162,0,00:00:00.000,2025-04-14 12:29:53.323
false,false,2747,2585,162,157,00:00:32.000,2025-04-14 12:30:05.334
false,false,2749,2587,162,221,00:00:32.000,2025-04-14 12:30:09.337
false,false,2752,2590,162,31,00:00:31.000,2025-04-14 12:30:27.350
false,false,2647,2494,153,1164,00:00:32.000,2025-04-14 12:25:33.120
false,false,2664,2508,156,127,00:00:33.000,2025-04-14 12:26:19.152
false,false,2686,2528,158,386,00:00:30.000,2025-04-14 12:27:15.202
false,false,2697,2539,158,735,00:00:30.000,2025-04-14 12:27:37.220
false,true,2707,2548,159,0,00:00:00.000,2025-04-14 12:27:59.239
false,true,2707,2548,159,0,00:00:00.000,2025-04-14 12:28:01.242
false,false,2710,2550,160,90,00:00:30.000,2025-04-14 12:28:15.254
false,false,2716,2555,161,278,00:00:30.000,2025-04-14 12:28:27.261
false,false,2775,2612,163,33,00:00:33.000,2025-04-14 12:32:01.416
false,false,2799,2635,164,787,00:00:31.000,2025-04-14 12:32:49.447
false,false,2801,2636,165,62,00:00:31.000,2025-04-14 12:33:05.460
false,false,2820,2653,167,666,00:00:33.000,2025-04-14 12:33:43.485
false,false,2836,2669,167,221,00:00:32.000,2025-04-14 12:34:39.526
false,false,8059,7579,480,754,00:00:30.000,2025-04-15 12:01:33.136
false,false,8139,7654,485,561,00:00:30.000,2025-04-15 12:03:53.278
false,false,8144,7658,486,718,00:00:32.000,2025-04-15 12:03:58.283
false,false,8147,7661,486,814,00:00:32.000,2025-04-15 12:04:01.287
false,false,8192,7705,487,1071,00:00:32.000,2025-04-15 12:04:52.345
false,true,8071,7589,482,0,00:00:00.000,2025-04-15 12:01:53.154
false,false,8082,7599,483,351,00:00:32.000,2025-04-15 12:02:08.169
false,false,8085,7602,483,442,00:00:31.000,2025-04-15 12:02:11.171
false,false,8089,7605,484,65,00:00:33.000,2025-04-15 12:02:21.178
false,false,8100,7616,484,281,00:00:31.000,2025-04-15 12:02:38.198
false,true,8100,7616,484,0,00:00:00.000,2025-04-15 12:02:39.201
false,true,8108,7624,484,0,00:00:00.000,2025-04-15 12:02:53.214
false,false,8118,7634,484,316,00:00:33.000,2025-04-15 12:03:08.230
false,true,8121,7637,484,0,00:00:00.000,2025-04-15 12:03:22.244
false,true,8121,7637,484,0,00:00:00.000,2025-04-15 12:03:25.246
false,false,7933,7458,475,1991,00:00:33.000,2025-04-15 11:58:38.962
false,false,7946,7471,475,127,00:00:30.000,2025-04-15 11:59:03.989
false,true,7949,7474,475,0,00:00:00.000,2025-04-15 11:59:10.993
false,false,7950,7475,475,33,00:00:33.000,2025-04-15 11:59:13.997
false,false,7983,7505,478,377,00:00:33.000,2025-04-15 11:59:53.041
false,false,7992,7514,478,661,00:00:30.000,2025-04-15 12:00:02.047
false,false,8284,7790,494,1123,00:00:31.000,2025-04-15 12:06:54.460
false,false,8294,7800,494,1439,00:00:32.000,2025-04-15 12:07:04.469
false,true,8304,7810,494,0,00:00:00.000,2025-04-15 12:07:15.479
false,false,8312,7816,496,260,00:00:32.000,2025-04-15 12:07:28.490
false,true,8330,7834,496,0,00:00:00.000,2025-04-15 12:07:53.510
false,false,8341,7845,496,344,00:00:30.000,2025-04-15 12:08:09.528
false,true,8341,7845,496,0,00:00:00.000,2025-04-15 12:08:12.533
false,false,8343,7847,496,63,00:00:33.000,2025-04-15 12:08:17.538
false,false,8359,7862,497,90,00:00:30.000,2025-04-15 12:08:39.557
false,false,8366,7869,497,310,00:00:32.000,2025-04-15 12:08:46.565
false,false,8380,7881,499,749,00:00:32.000,2025-04-15 12:09:00.575
false,false,8387,7887,500,963,00:00:30.000,2025-04-15 12:09:07.583
false,false,8393,7893,500,1154,00:00:32.000,2025-04-15 12:09:13.588
false,true,8395,7895,500,0,00:00:00.000,2025-04-15 12:09:21.597
false,true,8411,7910,501,0,00:00:00.000,2025-04-15 12:09:46.619
false,true,8412,7911,501,0,00:00:00.000,2025-04-15 12:09:55.629
false,false,8413,7912,501,33,00:00:33.000,2025-04-15 12:09:57.629
false,false,8431,7929,502,94,00:00:30.000,2025-04-15 12:10:21.653
false,false,8445,7943,502,97,00:00:33.000,2025-04-15 12:10:41.670
false,false,8461,7959,502,257,00:00:32.000,2025-04-15 12:11:03.692
false,true,8463,7961,502,0,00:00:00.000,2025-04-15 12:11:06.695
false,true,8463,7961,502,0,00:00:00.000,2025-04-15 12:11:10.700
false,false,8475,7973,502,376,00:00:31.000,2025-04-15 12:11:23.709
false,false,8483,7980,503,624,00:00:31.000,2025-04-15 12:11:31.720
false,true,8489,7986,503,0,00:00:00.000,2025-04-15 12:11:38.729
false,true,8206,7718,488,0,00:00:00.000,2025-04-15 12:05:18.365
false,false,8207,7719,488,30,00:00:30.000,2025-04-15 12:05:19.365
false,false,8209,7721,488,96,00:00:33.000,2025-04-15 12:05:21.365
false,true,8232,7741,491,0,00:00:00.000,2025-04-15 12:05:48.396
false,false,8239,7747,492,217,00:00:31.000,2025-04-15 12:05:57.404
false,false,8248,7756,492,63,00:00:31.000,2025-04-15 12:06:12.416
false,false,8252,7760,492,125,00:00:30.000,2025-04-15 12:06:22.423
false,false,8254,7761,493,186,00:00:30.000,2025-04-15 12:06:24.426
false,false,8268,7775,493,624,00:00:30.000,2025-04-15 12:06:38.443
false,false,8280,7786,494,999,00:00:33.000,2025-04-15 12:06:50.454
false,true,8580,8075,505,0,00:00:00.000,2025-04-15 12:13:42.848
false,false,8585,8079,506,154,00:00:30.000,2025-04-15 12:13:49.857
false,false,8590,8084,506,95,00:00:31.000,2025-04-15 12:14:00.866
false,false,8592,8085,507,158,00:00:30.000,2025-04-15 12:14:02.868
false,true,8594,8087,507,0,00:00:00.000,2025-04-15 12:14:11.876
false,false,8597,8090,507,93,00:00:31.000,2025-04-15 12:14:19.885
false,false,8613,8104,509,592,00:00:31.000,2025-04-15 12:14:35.901
false,false,8615,8106,509,655,00:00:33.000,2025-04-15 12:14:37.903
false,false,8631,8120,511,192,00:00:32.000,2025-04-15 12:14:59.922
false,false,8639,8127,512,441,00:00:32.000,2025-04-15 12:15:07.930
false,true,8705,8191,514,0,00:00:00.000,2025-04-15 12:17:06.046
false,true,8705,8191,514,0,00:00:00.000,2025-04-15 12:17:08.050
false,false,8744,8227,517,1227,00:00:31.000,2025-04-15 12:17:47.086
false,true,8774,8256,518,0,00:00:00.000,2025-04-15 12:18:27.130
false,true,8639,8127,512,0,00:00:00.000,2025-04-15 12:15:11.934
false,false,8663,8151,512,222,00:00:32.000,2025-04-15 12:15:49.971
false,false,8685,8172,513,341,00:00:31.000,2025-04-15 12:16:24.005
false,true,8692,8179,513,0,00:00:00.000,2025-04-15 12:16:49.030
false,false,8500,7996,504,348,00:00:31.000,2025-04-15 12:11:54.748
false,true,8526,8021,505,0,00:00:00.000,2025-04-15 12:12:29.777
false,true,8526,8021,505,0,00:00:00.000,2025-04-15 12:12:32.781
false,false,8571,8066,505,786,00:00:33.000,2025-04-15 12:13:23.836
false,false,8572,8067,505,817,00:00:31.000,2025-04-15 12:13:24.836
false,false,8782,8263,519,256,00:00:33.000,2025-04-15 12:18:37.138
false,false,8799,8280,519,409,00:00:31.000,2025-04-15 12:19:00.158
false,true,8800,8281,519,0,00:00:00.000,2025-04-15 12:19:13.175
false,false,8805,8285,520,155,00:00:31.000,2025-04-15 12:19:18.180
false,false,8812,8291,521,378,00:00:33.000,2025-04-15 12:19:25.188
false,false,8827,8306,521,310,00:00:32.000,2025-04-15 12:19:46.211
false,false,8846,8322,524,188,00:00:32.000,2025-04-15 12:20:11.238
false,false,8916,8386,530,596,00:00:31.000,2025-04-15 12:21:57.351
false,false,8922,8392,530,780,00:00:30.000,2025-04-15 12:22:03.357
false,false,8963,8432,531,214,00:00:30.000,2025-04-15 12:22:50.404
false,true,8964,8433,531,0,00:00:00.000,2025-04-15 12:22:55.408
false,false,8971,8438,533,222,00:00:32.000,2025-04-15 12:23:04.416
false,false,8847,8323,524,218,00:00:30.000,2025-04-15 12:20:12.239
false,false,8882,8355,527,852,00:00:32.000,2025-04-15 12:20:53.285
false,true,8890,8361,529,0,00:00:00.000,2025-04-15 12:21:13.307
false,true,9241,8689,552,0,00:00:00.000,2025-04-15 12:28:38.743
false,true,9248,8696,552,0,00:00:00.000,2025-04-15 12:28:56.759
false,true,9260,8708,552,0,00:00:00.000,2025-04-15 12:29:12.778
false,true,9277,8721,556,0,00:00:00.000,2025-04-15 12:29:35.805
false,true,9277,8721,556,0,00:00:00.000,2025-04-15 12:29:42.812
false,false,9071,8533,538,450,00:00:33.000,2025-04-15 12:25:14.535
false,false,9095,8553,542,1210,00:00:32.000,2025-04-15 12:25:38.560
false,false,9121,8577,544,2020,00:00:31.000,2025-04-15 12:26:04.582
false,false,9148,8603,545,2861,00:00:33.000,2025-04-15 12:26:31.609
false,false,9165,8620,545,404,00:00:32.000,2025-04-15 12:26:54.633
false,true,9166,8621,545,0,00:00:00.000,2025-04-15 12:26:59.637
false,true,9190,8642,548,0,00:00:00.000,2025-04-15 12:27:34.669
false,true,9190,8642,548,0,00:00:00.000,2025-04-15 12:27:37.671
false,false,9229,8677,552,662,00:00:30.000,2025-04-15 12:28:22.725
false,true,9354,8793,561,0,00:00:00.000,2025-04-15 12:31:37.918
false,false,9378,8816,562,253,00:00:31.000,2025-04-15 12:32:33.978
false,false,9385,8823,562,33,00:00:33.000,2025-04-15 12:32:46.994
false,true,9002,8469,533,0,00:00:00.000,2025-04-15 12:23:37.448
false,false,9030,8494,536,60,00:00:30.000,2025-04-15 12:24:21.486
false,false,9045,8508,537,31,00:00:31.000,2025-04-15 12:24:42.504
false,false,9051,8514,537,219,00:00:32.000,2025-04-15 12:24:48.508
false,false,9066,8529,537,287,00:00:32.000,2025-04-15 12:25:09.532
false,true,9501,8933,568,0,00:00:00.000,2025-04-15 12:35:18.155
false,false,9509,8941,568,255,00:00:32.000,2025-04-15 12:35:27.163
false,false,9515,8947,568,95,00:00:32.000,2025-04-15 12:35:39.173
false,false,9540,8969,571,877,00:00:33.000,2025-04-15 12:36:04.198
false,false,9543,8972,571,971,00:00:30.000,2025-04-15 12:36:07.201
false,false,9552,8980,572,62,00:00:32.000,2025-04-15 12:36:28.223
false,true,9553,8981,572,0,00:00:00.000,2025-04-15 12:36:33.228
false,false,9588,9015,573,224,00:00:33.000,2025-04-15 12:37:16.274
false,false,9603,9029,574,62,00:00:30.000,2025-04-15 12:37:37.298
false,false,9460,8896,564,1001,00:00:30.000,2025-04-15 12:34:20.100
false,false,9476,8912,564,1504,00:00:30.000,2025-04-15 12:34:36.113
false,true,9649,9074,575,0,00:00:00.000,2025-04-15 12:38:25.349
false,false,9656,9080,576,222,00:00:30.000,2025-04-15 12:38:36.361
false,false,9658,9082,576,283,00:00:30.000,2025-04-15 12:38:38.363
false,false,9660,9083,577,347,00:00:33.000,2025-04-15 12:38:40.365
false,false,9669,9091,578,630,00:00:33.000,2025-04-15 12:38:49.377
false,false,9695,9116,579,94,00:00:30.000,2025-04-15 12:39:27.417
false,false,9699,9119,580,222,00:00:33.000,2025-04-15 12:39:31.421
false,false,9703,9122,581,64,00:00:33.000,2025-04-15 12:39:41.433
false,false,1613,1517,96,807,00:00:30.000,2025-04-14 11:39:15.114
false,true,1618,1521,97,0,00:00:00.000,2025-04-14 11:39:47.134
false,true,1626,1529,97,0,00:00:00.000,2025-04-14 11:40:07.149
false,false,1634,1536,98,251,00:00:32.000,2025-04-14 11:40:33.174
false,false,1638,1540,98,376,00:00:31.000,2025-04-14 11:40:41.180
false,false,1647,1549,98,656,00:00:30.000,2025-04-14 11:40:59.191
false,false,1813,1708,105,503,00:00:30.000,2025-04-14 11:49:07.543
false,false,1841,1732,109,62,00:00:32.000,2025-04-14 11:50:27.597
false,false,1846,1736,110,156,00:00:30.000,2025-04-14 11:50:49.615
false,false,1858,1748,110,535,00:00:33.000,2025-04-14 11:51:13.635
false,false,1956,1841,115,158,00:00:31.000,2025-04-14 11:56:17.857
false,false,1960,1844,116,32,00:00:32.000,2025-04-14 11:56:49.886
false,false,1966,1850,116,220,00:00:31.000,2025-04-14 11:57:01.897
false,false,1983,1867,116,189,00:00:30.000,2025-04-14 11:57:47.931
false,false,1994,1878,116,538,00:00:33.000,2025-04-14 11:58:09.947
false,false,1997,1880,117,632,00:00:31.000,2025-04-14 11:58:15.954
false,false,1999,1882,117,696,00:00:32.000,2025-04-14 11:58:19.956
false,false,1747,1643,104,951,00:00:30.000,2025-04-14 11:45:19.388
false,false,1752,1648,104,1109,00:00:30.000,2025-04-14 11:45:29.397
false,false,1760,1656,104,247,00:00:30.000,2025-04-14 11:45:57.415
false,true,1773,1669,104,0,00:00:00.000,2025-04-14 11:46:41.441
false,false,1784,1680,104,153,00:00:31.000,2025-04-14 11:47:57.493
false,true,1880,1769,111,0,00:00:00.000,2025-04-14 11:52:17.676
false,true,1902,1789,113,0,00:00:00.000,2025-04-14 11:53:21.725
false,false,1924,1811,113,690,00:00:31.000,2025-04-14 11:54:13.767
false,true,1926,1812,114,0,00:00:00.000,2025-04-14 11:54:35.783
false,false,1935,1821,114,284,00:00:32.000,2025-04-14 11:54:59.798
false,false,1679,1578,101,345,00:00:31.000,2025-04-14 11:42:39.267
false,false,1684,1583,101,497,00:00:30.000,2025-04-14 11:42:49.274
false,false,1697,1595,102,911,00:00:32.000,2025-04-14 11:43:15.293
false,false,1721,1618,103,124,00:00:30.000,2025-04-14 11:44:27.351
false,false,2261,2132,129,96,00:00:33.000,2025-04-14 12:08:52.390
false,false,2291,2162,129,31,00:00:31.000,2025-04-14 12:10:16.457
false,false,2292,2163,129,64,00:00:33.000,2025-04-14 12:10:18.461
false,true,2304,2174,130,0,00:00:00.000,2025-04-14 12:10:44.482
false,true,2185,2061,124,0,00:00:00.000,2025-04-14 12:06:08.286
false,false,2218,2091,127,1042,00:00:30.000,2025-04-14 12:07:14.323
false,false,2012,1895,117,278,00:00:30.000,2025-04-14 11:58:57.987
false,false,2024,1907,117,656,00:00:32.000,2025-04-14 11:59:22.000
false,true,2042,1924,118,0,00:00:00.000,2025-04-14 12:00:00.033
false,false,2051,1933,118,285,00:00:33.000,2025-04-14 12:00:28.052
false,false,2059,1941,118,535,00:00:31.000,2025-04-14 12:00:44.067
false,false,2079,1960,119,543,00:00:33.000,2025-04-14 12:01:36.101
false,false,2089,1970,119,859,00:00:31.000,2025-04-14 12:01:56.113
false,false,2407,2273,134,635,00:00:31.000,2025-04-14 12:15:20.683
false,true,2407,2273,134,0,00:00:00.000,2025-04-14 12:15:22.684
false,true,2407,2273,134,0,00:00:00.000,2025-04-14 12:15:28.689
false,true,2449,2311,138,0,00:00:00.000,2025-04-14 12:17:10.765
false,true,2449,2311,138,0,00:00:00.000,2025-04-14 12:17:16.770
false,false,2461,2323,138,187,00:00:32.000,2025-04-14 12:18:08.810
false,false,2463,2325,138,251,00:00:31.000,2025-04-14 12:18:12.811
false,false,2337,2206,131,1047,00:00:30.000,2025-04-14 12:12:00.533
false,true,2340,2209,131,0,00:00:00.000,2025-04-14 12:12:10.543
false,false,2341,2210,131,31,00:00:31.000,2025-04-14 12:12:20.546
false,false,2363,2231,132,130,00:00:32.000,2025-04-14 12:13:40.601
false,false,2381,2248,133,701,00:00:33.000,2025-04-14 12:14:16.629
false,false,2109,1990,119,1491,00:00:33.000,2025-04-14 12:02:36.141
false,false,2118,1999,119,218,00:00:30.000,2025-04-14 12:03:06.165
false,false,2126,2006,120,476,00:00:33.000,2025-04-14 12:03:22.176
false,false,2139,2019,120,64,00:00:31.000,2025-04-14 12:04:00.198
false,false,2144,2024,120,219,00:00:32.000,2025-04-14 12:04:10.204
false,false,2146,2026,120,280,00:00:30.000,2025-04-14 12:04:14.207
false,false,2495,2356,139,976,00:00:31.000,2025-04-14 12:19:28.852
false,false,2497,2358,139,1039,00:00:31.000,2025-04-14 12:19:32.853
false,false,2504,2365,139,1258,00:00:32.000,2025-04-14 12:19:46.859
false,false,2531,2389,142,661,00:00:33.000,2025-04-14 12:20:52.906
false,false,2548,2404,144,1204,00:00:31.000,2025-04-14 12:21:26.936
false,false,2549,2405,144,1237,00:00:33.000,2025-04-14 12:21:28.939
false,false,2560,2414,146,1588,00:00:33.000,2025-04-14 12:21:50.960
false,true,2567,2421,146,0,00:00:00.000,2025-04-14 12:22:12.982
false,false,2625,2475,150,472,00:00:31.000,2025-04-14 12:24:49.093
false,false,2634,2482,152,757,00:00:31.000,2025-04-14 12:25:07.107
false,false,2636,2484,152,818,00:00:31.000,2025-04-14 12:25:11.109
false,false,2728,2566,162,653,00:00:32.000,2025-04-14 12:28:51.281
false,true,2733,2571,162,0,00:00:00.000,2025-04-14 12:29:03.290
false,true,2738,2576,162,0,00:00:00.000,2025-04-14 12:29:25.303
false,true,2738,2576,162,0,00:00:00.000,2025-04-14 12:29:35.310
false,true,2758,2595,163,0,00:00:00.000,2025-04-14 12:30:45.364
false,false,2765,2602,163,224,00:00:30.000,2025-04-14 12:31:17.391
false,false,2655,2499,156,1416,00:00:30.000,2025-04-14 12:25:49.133
false,false,2662,2506,156,64,00:00:33.000,2025-04-14 12:26:15.151
false,false,2672,2515,157,379,00:00:32.000,2025-04-14 12:26:35.165
false,false,2674,2517,157,444,00:00:33.000,2025-04-14 12:26:39.171
false,true,2674,2517,157,0,00:00:00.000,2025-04-14 12:26:49.178
false,false,2678,2520,158,131,00:00:33.000,2025-04-14 12:26:59.189
false,false,2709,2550,159,60,00:00:30.000,2025-04-14 12:28:13.251
false,true,2799,2635,164,0,00:00:00.000,2025-04-14 12:32:55.454
false,false,2809,2642,167,318,00:00:32.000,2025-04-14 12:33:21.470
false,true,2821,2654,167,0,00:00:00.000,2025-04-14 12:33:57.493
false,false,2826,2659,167,158,00:00:32.000,2025-04-14 12:34:07.501
false,true,2829,2662,167,0,00:00:00.000,2025-04-14 12:34:17.512
false,false,2832,2665,167,93,00:00:32.000,2025-04-14 12:34:31.519
false,false,2846,2679,167,540,00:00:33.000,2025-04-14 12:34:59.542
false,false,2851,2683,168,32,00:00:32.000,2025-04-14 12:35:21.562
false,true,2851,2683,168,0,00:00:00.000,2025-04-14 12:35:25.566
false,false,2860,2690,170,283,00:00:31.000,2025-04-14 12:35:51.578
false,false,2873,2703,170,691,00:00:30.000,2025-04-14 12:36:17.597
false,true,2876,2706,170,0,00:00:00.000,2025-04-14 12:36:43.615
false,false,8060,7580,480,786,00:00:32.000,2025-04-15 12:01:34.138
false,false,8070,7588,482,1098,00:00:31.000,2025-04-15 12:01:44.147
false,true,8070,7588,482,0,00:00:00.000,2025-04-15 12:01:50.154
false,false,8164,7677,487,188,00:00:31.000,2025-04-15 12:04:24.314
false,false,8171,7684,487,413,00:00:33.000,2025-04-15 12:04:31.319
false,false,8182,7695,487,754,00:00:31.000,2025-04-15 12:04:42.334
false,true,8195,7708,487,0,00:00:00.000,2025-04-15 12:04:58.350
false,false,8202,7714,488,221,00:00:33.000,2025-04-15 12:05:08.357
false,false,8083,7600,483,381,00:00:30.000,2025-04-15 12:02:09.170
false,false,8098,7614,484,220,00:00:30.000,2025-04-15 12:02:36.195
false,true,8108,7624,484,0,00:00:00.000,2025-04-15 12:02:56.216
false,false,7926,7451,475,1771,00:00:33.000,2025-04-15 11:58:31.952
false,false,7927,7452,475,1803,00:00:32.000,2025-04-15 11:58:32.953
false,true,7936,7461,475,0,00:00:00.000,2025-04-15 11:58:47.971
false,false,7955,7480,475,194,00:00:33.000,2025-04-15 11:59:19.003
false,true,7971,7495,476,0,00:00:00.000,2025-04-15 11:59:36.024
false,true,7971,7495,476,0,00:00:00.000,2025-04-15 11:59:38.025
false,false,7982,7504,478,344,00:00:31.000,2025-04-15 11:59:52.040
false,false,7990,7512,478,600,00:00:33.000,2025-04-15 12:00:00.046
false,false,8288,7794,494,1249,00:00:32.000,2025-04-15 12:06:58.461
false,false,8323,7827,496,609,00:00:33.000,2025-04-15 12:07:39.503
false,true,8325,7829,496,0,00:00:00.000,2025-04-15 12:07:42.506
false,false,8326,7830,496,33,00:00:33.000,2025-04-15 12:07:48.509
false,true,8330,7834,496,0,00:00:00.000,2025-04-15 12:07:57.516
false,false,8331,7835,496,30,00:00:30.000,2025-04-15 12:07:59.516
false,false,8347,7850,497,193,00:00:32.000,2025-04-15 12:08:21.542
false,false,8382,7882,500,810,00:00:31.000,2025-04-15 12:09:02.578
false,false,8384,7884,500,871,00:00:31.000,2025-04-15 12:09:04.579
false,false,8394,7894,500,1184,00:00:30.000,2025-04-15 12:09:14.589
false,true,8409,7908,501,0,00:00:00.000,2025-04-15 12:09:36.610
false,false,8412,7911,501,31,00:00:31.000,2025-04-15 12:09:50.624
false,false,8438,7936,502,313,00:00:30.000,2025-04-15 12:10:28.659
false,false,8462,7960,502,288,00:00:31.000,2025-04-15 12:11:04.692
false,false,8485,7982,503,684,00:00:30.000,2025-04-15 12:11:33.722
false,false,8213,7725,488,218,00:00:30.000,2025-04-15 12:05:25.371
false,true,8232,7741,491,0,00:00:00.000,2025-04-15 12:05:47.394
false,true,8232,7741,491,0,00:00:00.000,2025-04-15 12:05:49.398
false,false,8233,7742,491,31,00:00:31.000,2025-04-15 12:05:51.398
false,false,8240,7748,492,248,00:00:31.000,2025-04-15 12:05:58.404
false,false,8251,7759,492,95,00:00:32.000,2025-04-15 12:06:21.423
false,false,8260,7767,493,374,00:00:32.000,2025-04-15 12:06:30.432
false,false,8596,8089,507,62,00:00:31.000,2025-04-15 12:14:18.883
false,false,8602,8094,508,253,00:00:32.000,2025-04-15 12:14:24.890
false,false,8612,8103,509,561,00:00:30.000,2025-04-15 12:14:34.900
false,true,8625,8115,510,0,00:00:00.000,2025-04-15 12:14:49.913
false,false,8629,8118,511,128,00:00:32.000,2025-04-15 12:14:57.919
false,false,8739,8222,517,1071,00:00:33.000,2025-04-15 12:17:42.080
false,false,8767,8249,518,534,00:00:33.000,2025-04-15 12:18:16.117
false,false,8774,8256,518,752,00:00:32.000,2025-04-15 12:18:23.125
false,false,8648,8136,512,286,00:00:31.000,2025-04-15 12:15:22.947
false,false,8654,8142,512,97,00:00:33.000,2025-04-15 12:15:34.956
false,true,8656,8144,512,0,00:00:00.000,2025-04-15 12:15:38.961
false,false,8660,8148,512,125,00:00:30.000,2025-04-15 12:15:46.968
false,true,8674,8162,512,0,00:00:00.000,2025-04-15 12:16:07.987
false,true,8674,8162,512,0,00:00:00.000,2025-04-15 12:16:12.992
false,true,8686,8173,513,0,00:00:00.000,2025-04-15 12:16:26.007
false,true,8692,8179,513,0,00:00:00.000,2025-04-15 12:16:47.027
false,false,8511,8007,504,694,00:00:32.000,2025-04-15 12:12:05.756
false,true,8513,8009,504,0,00:00:00.000,2025-04-15 12:12:08.760
false,true,8513,8009,504,0,00:00:00.000,2025-04-15 12:12:11.763
false,false,8526,8021,505,408,00:00:30.000,2025-04-15 12:12:26.774
false,false,8540,8035,505,442,00:00:32.000,2025-04-15 12:12:46.794
false,false,8545,8040,505,599,00:00:32.000,2025-04-15 12:12:51.801
false,true,8546,8041,505,0,00:00:00.000,2025-04-15 12:12:55.806
false,true,8546,8041,505,0,00:00:00.000,2025-04-15 12:12:56.806
false,false,8570,8065,505,753,00:00:30.000,2025-04-15 12:13:22.836
false,false,8576,8071,505,946,00:00:32.000,2025-04-15 12:13:28.841
false,true,8786,8267,519,0,00:00:00.000,2025-04-15 12:18:42.143
false,true,8817,8296,521,0,00:00:00.000,2025-04-15 12:19:35.198
false,false,8824,8303,521,218,00:00:33.000,2025-04-15 12:19:43.208
false,false,8911,8381,530,437,00:00:31.000,2025-04-15 12:21:52.346
false,false,8924,8394,530,844,00:00:33.000,2025-04-15 12:22:05.359
false,false,8938,8407,531,1284,00:00:33.000,2025-04-15 12:22:19.371
false,false,8939,8408,531,1314,00:00:30.000,2025-04-15 12:22:20.372
false,false,8966,8433,533,65,00:00:33.000,2025-04-15 12:22:59.411
false,false,8984,8451,533,624,00:00:30.000,2025-04-15 12:23:17.428
false,false,8985,8452,533,657,00:00:33.000,2025-04-15 12:23:18.429
false,false,8988,8455,533,748,00:00:31.000,2025-04-15 12:23:21.432
false,false,8993,8460,533,904,00:00:31.000,2025-04-15 12:23:26.438
false,false,8849,8325,524,283,00:00:32.000,2025-04-15 12:20:14.242
false,false,8851,8327,524,347,00:00:32.000,2025-04-15 12:20:16.244
false,false,8854,8330,524,444,00:00:33.000,2025-04-15 12:20:19.245
false,false,8855,8331,524,476,00:00:32.000,2025-04-15 12:20:20.247
false,true,8855,8331,524,0,00:00:00.000,2025-04-15 12:20:21.248
false,false,8867,8341,526,380,00:00:33.000,2025-04-15 12:20:38.269
false,false,8868,8342,526,411,00:00:31.000,2025-04-15 12:20:39.270
false,false,8874,8348,526,597,00:00:31.000,2025-04-15 12:20:45.276
false,false,8876,8349,527,663,00:00:33.000,2025-04-15 12:20:47.277
false,false,8878,8351,527,725,00:00:32.000,2025-04-15 12:20:49.280
false,false,8891,8362,529,33,00:00:33.000,2025-04-15 12:21:14.307
false,false,9243,8691,552,60,00:00:30.000,2025-04-15 12:28:42.748
false,false,9247,8695,552,127,00:00:33.000,2025-04-15 12:28:52.755
false,true,9289,8732,557,0,00:00:00.000,2025-04-15 12:29:59.827
false,true,9289,8732,557,0,00:00:00.000,2025-04-15 12:30:04.833
false,false,9291,8734,557,65,00:00:32.000,2025-04-15 12:30:06.834
false,false,9087,8546,541,952,00:00:30.000,2025-04-15 12:25:30.549
false,false,9102,8559,543,1426,00:00:33.000,2025-04-15 12:25:45.568
false,false,9115,8571,544,1831,00:00:30.000,2025-04-15 12:25:58.578
false,false,9116,8572,544,1864,00:00:33.000,2025-04-15 12:25:59.580
false,false,9125,8581,544,2144,00:00:31.000,2025-04-15 12:26:08.587
false,false,9138,8594,544,2548,00:00:32.000,2025-04-15 12:26:21.599
false,false,9139,8595,544,2580,00:00:32.000,2025-04-15 12:26:22.601
false,true,9166,8621,545,0,00:00:00.000,2025-04-15 12:27:01.640
false,false,9175,8628,547,221,00:00:32.000,2025-04-15 12:27:16.654
false,false,9207,8658,549,531,00:00:32.000,2025-04-15 12:27:54.692
false,false,9208,8659,549,564,00:00:33.000,2025-04-15 12:27:55.692
false,false,9213,8664,549,158,00:00:31.000,2025-04-15 12:28:06.707
false,false,9363,8802,561,282,00:00:31.000,2025-04-15 12:31:54.937
false,false,9366,8804,562,61,00:00:30.000,2025-04-15 12:32:03.948
false,false,9370,8808,562,64,00:00:31.000,2025-04-15 12:32:19.963
false,true,9370,8808,562,0,00:00:00.000,2025-04-15 12:32:25.969
false,false,9390,8828,562,192,00:00:33.000,2025-04-15 12:32:51.999
false,false,9007,8474,533,160,00:00:30.000,2025-04-15 12:23:46.457
false,false,9012,8479,533,315,00:00:30.000,2025-04-15 12:23:51.460
false,true,9014,8481,533,0,00:00:00.000,2025-04-15 12:23:57.466
false,false,9019,8485,534,158,00:00:31.000,2025-04-15 12:24:04.470
false,false,9035,8499,536,217,00:00:33.000,2025-04-15 12:24:26.491
false,false,9041,8505,536,405,00:00:30.000,2025-04-15 12:24:32.496
false,false,9042,8505,537,437,00:00:32.000,2025-04-15 12:24:33.497
false,true,9044,8507,537,0,00:00:00.000,2025-04-15 12:24:36.497
false,false,9479,8915,564,63,00:00:30.000,2025-04-15 12:34:51.127
false,false,9487,8923,564,315,00:00:31.000,2025-04-15 12:34:59.135
false,false,9530,8959,571,560,00:00:33.000,2025-04-15 12:35:54.192
false,false,9531,8960,571,592,00:00:32.000,2025-04-15 12:35:55.193
false,false,9532,8961,571,622,00:00:30.000,2025-04-15 12:35:56.194
false,false,9549,8977,572,1158,00:00:30.000,2025-04-15 12:36:13.207
false,true,9553,8981,572,0,00:00:00.000,2025-04-15 12:36:34.227
false,false,9609,9034,575,252,00:00:33.000,2025-04-15 12:37:43.303
false,false,9611,9036,575,315,00:00:31.000,2025-04-15 12:37:45.304
false,false,9626,9051,575,784,00:00:30.000,2025-04-15 12:38:00.317
false,false,9632,9057,575,975,00:00:31.000,2025-04-15 12:38:06.325
false,false,9408,8846,562,222,00:00:32.000,2025-04-15 12:33:22.033
false,false,9419,8857,562,574,00:00:33.000,2025-04-15 12:33:33.047
false,false,9473,8909,564,1409,00:00:32.000,2025-04-15 12:34:33.111
false,false,9336,8775,561,410,00:00:30.000,2025-04-15 12:31:15.901
false,false,9340,8779,561,535,00:00:30.000,2025-04-15 12:31:19.906
false,false,9349,8788,561,818,00:00:33.000,2025-04-15 12:31:28.913
false,false,9649,9074,575,1511,00:00:31.000,2025-04-15 12:38:23.345
false,false,9664,9086,578,474,00:00:32.000,2025-04-15 12:38:44.371
false,false,9670,9092,578,663,00:00:33.000,2025-04-15 12:38:50.378
false,false,9680,9101,579,154,00:00:30.000,2025-04-15 12:39:06.392
false,false,9688,9109,579,407,00:00:31.000,2025-04-15 12:39:14.399
false,false,1596,1501,95,286,00:00:30.000,2025-04-14 11:38:41.080
false,false,1637,1539,98,345,00:00:32.000,2025-04-14 11:40:39.179
false,false,1640,1542,98,437,00:00:30.000,2025-04-14 11:40:45.181
false,false,1644,1546,98,565,00:00:30.000,2025-04-14 11:40:53.185
false,false,1657,1559,98,970,00:00:30.000,2025-04-14 11:41:19.209
false,true,1657,1559,98,0,00:00:00.000,2025-04-14 11:41:29.215
false,true,1667,1568,99,0,00:00:00.000,2025-04-14 11:41:55.234
false,false,1814,1709,105,536,00:00:33.000,2025-04-14 11:49:09.544
false,false,1815,1710,105,567,00:00:31.000,2025-04-14 11:49:11.547
false,true,1841,1732,109,0,00:00:00.000,2025-04-14 11:50:31.600
false,false,1844,1735,109,95,00:00:32.000,2025-04-14 11:50:45.612
false,false,1854,1744,110,404,00:00:30.000,2025-04-14 11:51:05.630
false,false,1877,1766,111,1122,00:00:33.000,2025-04-14 11:51:51.661
false,false,1957,1842,115,188,00:00:30.000,2025-04-14 11:56:19.857
false,true,1958,1843,115,0,00:00:00.000,2025-04-14 11:56:31.869
false,false,1973,1857,116,445,00:00:33.000,2025-04-14 11:57:15.906
false,true,1977,1861,116,0,00:00:00.000,2025-04-14 11:57:25.916
false,false,1980,1864,116,94,00:00:31.000,2025-04-14 11:57:41.923
false,false,1982,1866,116,159,00:00:32.000,2025-04-14 11:57:45.928
false,false,1992,1876,116,473,00:00:33.000,2025-04-14 11:58:05.945
false,false,1749,1645,104,1016,00:00:33.000,2025-04-14 11:45:23.392
false,false,1753,1649,104,30,00:00:30.000,2025-04-14 11:45:43.405
false,false,1754,1650,104,60,00:00:30.000,2025-04-14 11:45:45.407
false,false,1770,1666,104,224,00:00:30.000,2025-04-14 11:46:29.434
false,true,1773,1669,104,0,00:00:00.000,2025-04-14 11:46:43.444
false,false,1786,1682,104,216,00:00:31.000,2025-04-14 11:48:01.498
false,false,1787,1683,104,249,00:00:33.000,2025-04-14 11:48:03.499
false,true,1880,1769,111,0,00:00:00.000,2025-04-14 11:52:05.669
false,true,1880,1769,111,0,00:00:00.000,2025-04-14 11:52:21.679
false,false,1885,1774,111,158,00:00:33.000,2025-04-14 11:52:31.686
false,false,1904,1791,113,62,00:00:32.000,2025-04-14 11:53:33.730
false,false,1923,1810,113,659,00:00:32.000,2025-04-14 11:54:11.765
false,true,1667,1568,99,0,00:00:00.000,2025-04-14 11:42:03.241
false,false,1692,1590,102,752,00:00:31.000,2025-04-14 11:43:05.284
false,true,1699,1597,102,0,00:00:00.000,2025-04-14 11:43:23.298
false,true,1717,1615,102,0,00:00:00.000,2025-04-14 11:44:11.338
false,false,1722,1619,103,157,00:00:33.000,2025-04-14 11:44:29.351
false,false,1742,1638,104,792,00:00:33.000,2025-04-14 11:45:09.381
false,false,2268,2139,129,320,00:00:33.000,2025-04-14 12:09:06.403
false,true,2290,2161,129,0,00:00:00.000,2025-04-14 12:10:04.445
false,false,2296,2166,130,187,00:00:31.000,2025-04-14 12:10:26.467
false,false,2299,2169,130,280,00:00:30.000,2025-04-14 12:10:32.472
false,false,2328,2198,130,758,00:00:33.000,2025-04-14 12:11:42.521
false,false,2170,2047,123,252,00:00:33.000,2025-04-14 12:05:26.259
false,false,2192,2067,125,219,00:00:31.000,2025-04-14 12:06:22.293
false,false,2197,2071,126,377,00:00:31.000,2025-04-14 12:06:32.300
false,false,2210,2083,127,789,00:00:32.000,2025-04-14 12:06:58.316
false,false,2005,1888,117,63,00:00:33.000,2025-04-14 11:58:43.977
false,false,2008,1891,117,156,00:00:30.000,2025-04-14 11:58:49.981
false,false,2011,1894,117,248,00:00:30.000,2025-04-14 11:58:55.986
false,false,2018,1901,117,466,00:00:32.000,2025-04-14 11:59:09.993
false,true,2042,1924,118,0,00:00:00.000,2025-04-14 12:00:02.034
false,false,2045,1927,118,94,00:00:32.000,2025-04-14 12:00:16.043
false,false,2065,1946,119,93,00:00:33.000,2025-04-14 12:01:08.088
false,false,2437,2300,137,61,00:00:30.000,2025-04-14 12:16:44.744
false,true,2464,2326,138,0,00:00:00.000,2025-04-14 12:18:26.819
false,false,2348,2217,131,33,00:00:33.000,2025-04-14 12:12:46.563
false,false,2366,2234,132,227,00:00:33.000,2025-04-14 12:13:46.605
false,false,2401,2267,134,442,00:00:33.000,2025-04-14 12:15:08.673
false,false,2128,2008,120,539,00:00:33.000,2025-04-14 12:03:26.180
false,false,2131,2011,120,632,00:00:30.000,2025-04-14 12:03:32.184
false,false,2136,2016,120,788,00:00:31.000,2025-04-14 12:03:42.190
false,true,2137,2017,120,0,00:00:00.000,2025-04-14 12:03:50.193
false,false,2149,2029,120,376,00:00:32.000,2025-04-14 12:04:20.211
false,false,2475,2337,138,349,00:00:31.000,2025-04-14 12:18:48.835
false,false,2476,2338,138,380,00:00:31.000,2025-04-14 12:18:50.835
false,false,2539,2397,142,915,00:00:32.000,2025-04-14 12:21:08.921
false,false,2552,2407,145,1334,00:00:31.000,2025-04-14 12:21:34.944
false,false,2556,2411,145,1460,00:00:33.000,2025-04-14 12:21:42.951
false,false,2579,2432,147,380,00:00:31.000,2025-04-14 12:22:41.003
false,false,2583,2436,147,509,00:00:31.000,2025-04-14 12:22:49.010
false,false,2595,2447,148,224,00:00:30.000,2025-04-14 12:23:25.035
false,false,2609,2459,150,30,00:00:30.000,2025-04-14 12:24:05.063
false,true,2610,2460,150,0,00:00:00.000,2025-04-14 12:24:17.075
false,false,2626,2476,150,504,00:00:32.000,2025-04-14 12:24:51.095
false,true,2742,2580,162,0,00:00:00.000,2025-04-14 12:29:51.321
false,true,2742,2580,162,0,00:00:00.000,2025-04-14 12:29:55.323
false,true,2751,2589,162,0,00:00:00.000,2025-04-14 12:30:17.342
false,false,2766,2603,163,257,00:00:33.000,2025-04-14 12:31:19.391
false,false,2772,2609,163,444,00:00:31.000,2025-04-14 12:31:31.396
false,true,2774,2611,163,0,00:00:00.000,2025-04-14 12:31:51.408
false,true,2660,2504,156,0,00:00:00.000,2025-04-14 12:26:01.142
false,false,2683,2525,158,293,00:00:33.000,2025-04-14 12:27:09.196
false,false,2694,2536,158,639,00:00:32.000,2025-04-14 12:27:31.214
false,false,2699,2540,159,797,00:00:31.000,2025-04-14 12:27:41.221
false,false,2714,2553,161,218,00:00:32.000,2025-04-14 12:28:23.258
false,false,2777,2614,163,96,00:00:32.000,2025-04-14 12:32:05.418
false,false,2780,2617,163,190,00:00:30.000,2025-04-14 12:32:11.424
false,true,2799,2635,164,0,00:00:00.000,2025-04-14 12:32:59.458
false,false,2828,2661,167,221,00:00:32.000,2025-04-14 12:34:11.507
false,true,2829,2662,167,0,00:00:00.000,2025-04-14 12:34:25.515
false,false,2843,2676,167,443,00:00:33.000,2025-04-14 12:34:53.537
false,false,2848,2681,167,603,00:00:31.000,2025-04-14 12:35:03.546
false,false,2853,2685,168,65,00:00:33.000,2025-04-14 12:35:37.572
false,false,2857,2687,170,190,00:00:31.000,2025-04-14 12:35:45.576
false,true,2873,2703,170,0,00:00:00.000,2025-04-14 12:36:29.603
false,false,8051,7572,479,504,00:00:31.000,2025-04-15 12:01:25.129
false,false,8061,7581,480,819,00:00:33.000,2025-04-15 12:01:35.139
false,true,8070,7588,482,0,00:00:00.000,2025-04-15 12:01:47.151
false,false,8122,7637,485,30,00:00:30.000,2025-04-15 12:03:36.262
false,false,8154,7668,486,1041,00:00:33.000,2025-04-15 12:04:08.293
false,true,8158,7672,486,0,00:00:00.000,2025-04-15 12:04:15.304
false,false,8178,7691,487,631,00:00:33.000,2025-04-15 12:04:38.329
false,false,8188,7701,487,945,00:00:30.000,2025-04-15 12:04:48.341
false,false,8195,7708,487,1168,00:00:33.000,2025-04-15 12:04:55.348
false,false,8201,7714,487,188,00:00:33.000,2025-04-15 12:05:07.356
false,true,8087,7604,483,0,00:00:00.000,2025-04-15 12:02:14.174
false,true,8087,7604,483,0,00:00:00.000,2025-04-15 12:02:19.177
false,false,8108,7624,484,251,00:00:30.000,2025-04-15 12:02:52.214
false,false,8109,7625,484,31,00:00:31.000,2025-04-15 12:02:59.220
false,true,8119,7635,484,0,00:00:00.000,2025-04-15 12:03:12.233
false,true,8121,7637,484,0,00:00:00.000,2025-04-15 12:03:26.248
false,true,7949,7474,475,0,00:00:00.000,2025-04-15 11:59:07.991
false,false,7958,7483,475,286,00:00:31.000,2025-04-15 11:59:22.007
false,false,7964,7489,475,478,00:00:33.000,2025-04-15 11:59:28.013
false,false,7970,7494,476,671,00:00:33.000,2025-04-15 11:59:34.022
false,false,7989,7511,478,567,00:00:33.000,2025-04-15 11:59:59.045
false,false,7994,7516,478,30,00:00:30.000,2025-04-15 12:00:10.054
false,false,8303,7809,494,1718,00:00:30.000,2025-04-15 12:07:13.477
false,true,8304,7810,494,0,00:00:00.000,2025-04-15 12:07:17.480
false,false,8309,7813,496,163,00:00:33.000,2025-04-15 12:07:25.489
false,true,8325,7829,496,0,00:00:00.000,2025-04-15 12:07:45.507
false,false,8330,7834,496,158,00:00:31.000,2025-04-15 12:07:52.510
false,true,8341,7845,496,0,00:00:00.000,2025-04-15 12:08:11.532
false,true,8341,7845,496,0,00:00:00.000,2025-04-15 12:08:14.535
false,false,8346,7850,496,161,00:00:32.000,2025-04-15 12:08:20.541
false,false,8379,7880,499,717,00:00:33.000,2025-04-15 12:08:59.575
false,false,8397,7897,500,61,00:00:31.000,2025-04-15 12:09:23.599
false,false,8400,7900,500,157,00:00:32.000,2025-04-15 12:09:26.602
false,true,8411,7910,501,0,00:00:00.000,2025-04-15 12:09:49.622
false,false,8421,7919,502,285,00:00:32.000,2025-04-15 12:10:05.637
false,false,8424,7922,502,381,00:00:31.000,2025-04-15 12:10:08.641
false,false,8428,7926,502,508,00:00:32.000,2025-04-15 12:10:12.644
false,true,8428,7926,502,0,00:00:00.000,2025-04-15 12:10:15.646
false,false,8443,7941,502,31,00:00:31.000,2025-04-15 12:10:39.669
false,false,8446,7944,502,129,00:00:32.000,2025-04-15 12:10:42.672
false,false,8447,7945,502,161,00:00:32.000,2025-04-15 12:10:43.673
false,false,8448,7946,502,193,00:00:32.000,2025-04-15 12:10:44.673
false,false,8465,7963,502,63,00:00:31.000,2025-04-15 12:11:13.702
false,false,8477,7975,502,437,00:00:31.000,2025-04-15 12:11:25.713
false,false,8479,7977,502,498,00:00:30.000,2025-04-15 12:11:27.715
false,true,8489,7986,503,0,00:00:00.000,2025-04-15 12:11:42.734
false,false,8205,7717,488,314,00:00:33.000,2025-04-15 12:05:11.358
false,true,8206,7718,488,0,00:00:00.000,2025-04-15 12:05:14.360
false,true,8206,7718,488,0,00:00:00.000,2025-04-15 12:05:17.362
false,false,8235,7744,491,95,00:00:31.000,2025-04-15 12:05:53.400
false,true,8248,7756,492,0,00:00:00.000,2025-04-15 12:06:13.416
false,true,8248,7756,492,0,00:00:00.000,2025-04-15 12:06:14.417
false,true,8248,7756,492,0,00:00:00.000,2025-04-15 12:06:15.417
false,false,8250,7758,492,63,00:00:33.000,2025-04-15 12:06:20.422
false,false,8274,7781,493,810,00:00:30.000,2025-04-15 12:06:44.450
false,false,8587,8081,506,216,00:00:31.000,2025-04-15 12:13:51.857
false,false,8609,8100,509,470,00:00:33.000,2025-04-15 12:14:31.898
false,false,8624,8114,510,941,00:00:33.000,2025-04-15 12:14:46.911
false,false,8696,8183,513,124,00:00:31.000,2025-04-15 12:16:53.032
false,false,8720,8205,515,469,00:00:33.000,2025-04-15 12:17:23.061
false,false,8722,8207,515,532,00:00:30.000,2025-04-15 12:17:25.063
false,true,8750,8232,518,0,00:00:00.000,2025-04-15 12:17:56.099
false,false,8755,8237,518,156,00:00:30.000,2025-04-15 12:18:04.108
false,false,8771,8253,518,658,00:00:30.000,2025-04-15 12:18:20.121
false,false,8641,8129,512,61,00:00:30.000,2025-04-15 12:15:15.937
false,true,8651,8139,512,0,00:00:00.000,2025-04-15 12:15:31.954
false,true,8656,8144,512,0,00:00:00.000,2025-04-15 12:15:39.963
false,false,8666,8154,512,317,00:00:30.000,2025-04-15 12:15:52.972
false,true,8672,8160,512,0,00:00:00.000,2025-04-15 12:15:59.979
false,true,8672,8160,512,0,00:00:00.000,2025-04-15 12:16:02.982
false,false,8678,8165,513,125,00:00:31.000,2025-04-15 12:16:16.997
false,true,8686,8173,513,0,00:00:00.000,2025-04-15 12:16:36.017
false,true,8692,8179,513,0,00:00:00.000,2025-04-15 12:16:45.026
false,true,8513,8009,504,0,00:00:00.000,2025-04-15 12:12:12.764
false,false,8518,8013,505,156,00:00:33.000,2025-04-15 12:12:18.769
false,true,8546,8041,505,0,00:00:00.000,2025-04-15 12:12:58.809
false,false,8556,8051,505,311,00:00:31.000,2025-04-15 12:13:08.820
false,false,8562,8057,505,500,00:00:31.000,2025-04-15 12:13:14.825
false,false,8567,8062,505,657,00:00:33.000,2025-04-15 12:13:19.832
false,false,8779,8260,519,160,00:00:32.000,2025-04-15 12:18:34.136
false,false,8796,8277,519,315,00:00:32.000,2025-04-15 12:18:57.157
false,false,8809,8289,520,279,00:00:30.000,2025-04-15 12:19:22.185
false,false,8830,8308,522,404,00:00:32.000,2025-04-15 12:19:49.214
false,false,8833,8310,523,500,00:00:30.000,2025-04-15 12:19:52.216
false,false,8836,8313,523,593,00:00:31.000,2025-04-15 12:19:55.220
false,false,8917,8387,530,626,00:00:30.000,2025-04-15 12:21:58.352
false,false,8941,8410,531,1377,00:00:30.000,2025-04-15 12:22:22.374
false,true,8956,8425,531,0,00:00:00.000,2025-04-15 12:22:40.393
false,false,8970,8437,533,190,00:00:30.000,2025-04-15 12:23:03.415
false,false,8860,8335,525,163,00:00:33.000,2025-04-15 12:20:31.259
false,false,8871,8345,526,503,00:00:32.000,2025-04-15 12:20:42.273
false,true,8886,8357,529,0,00:00:00.000,2025-04-15 12:21:02.292
false,false,8888,8359,529,64,00:00:31.000,2025-04-15 12:21:05.296
false,false,8890,8361,529,126,00:00:30.000,2025-04-15 12:21:07.299
false,true,8892,8363,529,0,00:00:00.000,2025-04-15 12:21:20.315
false,false,8895,8366,529,66,00:00:33.000,2025-04-15 12:21:30.320
false,true,8897,8368,529,0,00:00:00.000,2025-04-15 12:21:34.323
false,false,8900,8371,529,93,00:00:33.000,2025-04-15 12:21:41.332
false,true,9241,8689,552,0,00:00:00.000,2025-04-15 12:28:37.742
false,true,9243,8691,552,0,00:00:00.000,2025-04-15 12:28:47.752
false,false,9244,8692,552,32,00:00:32.000,2025-04-15 12:28:49.753
false,true,9248,8696,552,0,00:00:00.000,2025-04-15 12:28:57.761
false,false,9255,8703,552,217,00:00:31.000,2025-04-15 12:29:06.769
false,true,9260,8708,552,0,00:00:00.000,2025-04-15 12:29:13.779
false,true,9277,8721,556,0,00:00:00.000,2025-04-15 12:29:44.815
false,false,9283,8727,556,189,00:00:33.000,2025-04-15 12:29:52.820
false,false,9294,8737,557,160,00:00:30.000,2025-04-15 12:30:09.838
false,false,9070,8532,538,417,00:00:33.000,2025-04-15 12:25:13.535
false,false,9086,8545,541,922,00:00:32.000,2025-04-15 12:25:29.549
false,false,9089,8548,541,1016,00:00:33.000,2025-04-15 12:25:32.551
false,false,9104,8560,544,1489,00:00:31.000,2025-04-15 12:25:47.570
false,false,9140,8596,544,2611,00:00:31.000,2025-04-15 12:26:23.602
false,true,9152,8607,545,0,00:00:00.000,2025-04-15 12:26:36.616
false,true,9166,8621,545,0,00:00:00.000,2025-04-15 12:26:56.635
false,true,9168,8623,545,0,00:00:00.000,2025-04-15 12:27:08.645
false,false,9176,8629,547,252,00:00:31.000,2025-04-15 12:27:17.654
false,false,9199,8651,548,280,00:00:32.000,2025-04-15 12:27:46.683
false,false,9224,8672,552,503,00:00:31.000,2025-04-15 12:28:17.718
false,false,9238,8686,552,946,00:00:30.000,2025-04-15 12:28:31.736
false,true,9354,8793,561,0,00:00:00.000,2025-04-15 12:31:35.916
false,true,9354,8793,561,0,00:00:00.000,2025-04-15 12:31:44.926
false,false,9355,8794,561,30,00:00:30.000,2025-04-15 12:31:46.928
false,true,9368,8806,562,0,00:00:00.000,2025-04-15 12:32:06.952
false,true,9368,8806,562,0,00:00:00.000,2025-04-15 12:32:07.952
false,true,9368,8806,562,0,00:00:00.000,2025-04-15 12:32:16.960
false,true,9384,8822,562,0,00:00:00.000,2025-04-15 12:32:44.991
false,false,9020,8486,534,191,00:00:33.000,2025-04-15 12:24:05.471
false,true,9044,8507,537,0,00:00:00.000,2025-04-15 12:24:37.499
false,false,9046,8509,537,63,00:00:32.000,2025-04-15 12:24:43.505
false,true,9057,8520,537,0,00:00:00.000,2025-04-15 12:24:59.520
false,false,9491,8926,565,442,00:00:31.000,2025-04-15 12:35:03.140
false,true,9512,8944,568,0,00:00:00.000,2025-04-15 12:35:33.167
false,true,9512,8944,568,0,00:00:00.000,2025-04-15 12:35:36.170
false,false,9534,8963,571,683,00:00:30.000,2025-04-15 12:35:58.194
false,false,9537,8966,571,778,00:00:33.000,2025-04-15 12:36:01.195
false,true,9550,8978,572,0,00:00:00.000,2025-04-15 12:36:18.211
false,false,9562,8990,572,280,00:00:31.000,2025-04-15 12:36:44.240
false,false,9586,9013,573,158,00:00:32.000,2025-04-15 12:37:14.271
false,false,9608,9033,575,219,00:00:30.000,2025-04-15 12:37:42.302
false,false,9618,9043,575,532,00:00:30.000,2025-04-15 12:37:52.311
false,false,9624,9049,575,723,00:00:32.000,2025-04-15 12:37:58.316
false,false,9625,9050,575,754,00:00:31.000,2025-04-15 12:37:59.316
false,false,9627,9052,575,817,00:00:33.000,2025-04-15 12:38:01.319
false,false,9633,9058,575,1007,00:00:32.000,2025-04-15 12:38:07.326
false,true,9401,8839,562,0,00:00:00.000,2025-04-15 12:33:13.022
false,false,9403,8841,562,61,00:00:30.000,2025-04-15 12:33:17.027
false,false,9425,8862,563,766,00:00:30.000,2025-04-15 12:33:39.056
false,false,9445,8882,563,541,00:00:32.000,2025-04-15 12:34:05.085
false,false,9447,8884,563,602,00:00:31.000,2025-04-15 12:34:07.088
false,true,9476,8912,564,0,00:00:00.000,2025-04-15 12:34:39.117
false,false,9478,8914,564,33,00:00:33.000,2025-04-15 12:34:50.126
false,false,9651,9076,575,63,00:00:33.000,2025-04-15 12:38:31.356
false,false,9652,9076,576,96,00:00:33.000,2025-04-15 12:38:32.357
false,false,9667,9089,578,567,00:00:31.000,2025-04-15 12:38:47.375
false,false,9685,9106,579,315,00:00:33.000,2025-04-15 12:39:11.399
false,false,9697,9118,579,158,00:00:32.000,2025-04-15 12:39:29.418
false,false,9712,9131,581,341,00:00:30.000,2025-04-15 12:39:50.443
false,false,1597,1502,95,316,00:00:30.000,2025-04-14 11:38:43.081
false,false,1598,1503,95,346,00:00:30.000,2025-04-14 11:38:45.083
false,false,1610,1514,96,716,00:00:30.000,2025-04-14 11:39:09.106
false,false,1611,1515,96,747,00:00:31.000,2025-04-14 11:39:11.109
false,true,1614,1518,96,0,00:00:00.000,2025-04-14 11:39:27.121
false,false,1628,1531,97,63,00:00:33.000,2025-04-14 11:40:21.159
false,false,1663,1565,98,193,00:00:31.000,2025-04-14 11:41:43.225
false,true,1667,1568,99,0,00:00:00.000,2025-04-14 11:41:57.235
false,false,1799,1694,105,63,00:00:33.000,2025-04-14 11:48:39.524
false,false,1804,1699,105,219,00:00:31.000,2025-04-14 11:48:49.527
false,false,1817,1712,105,33,00:00:33.000,2025-04-14 11:49:27.561
false,false,1842,1733,109,31,00:00:31.000,2025-04-14 11:50:41.610
false,false,1860,1750,110,596,00:00:31.000,2025-04-14 11:51:17.638
false,false,1867,1756,111,813,00:00:30.000,2025-04-14 11:51:31.650
false,false,1869,1758,111,873,00:00:30.000,2025-04-14 11:51:35.653
false,false,1873,1762,111,996,00:00:31.000,2025-04-14 11:51:43.656
false,false,1947,1833,114,666,00:00:33.000,2025-04-14 11:55:23.818
false,true,1977,1861,116,0,00:00:00.000,2025-04-14 11:57:29.917
false,false,1998,1881,117,664,00:00:32.000,2025-04-14 11:58:17.955
false,false,1764,1660,104,32,00:00:32.000,2025-04-14 11:46:17.425
false,true,1777,1673,104,0,00:00:00.000,2025-04-14 11:47:23.474
false,true,1777,1673,104,0,00:00:00.000,2025-04-14 11:47:29.480
false,true,1779,1675,104,0,00:00:00.000,2025-04-14 11:47:41.485
false,false,1788,1684,104,282,00:00:33.000,2025-04-14 11:48:05.500
false,true,1880,1769,111,0,00:00:00.000,2025-04-14 11:52:15.675
false,false,1910,1797,113,250,00:00:30.000,2025-04-14 11:53:45.745
false,false,1911,1798,113,280,00:00:30.000,2025-04-14 11:53:47.746
false,false,1921,1808,113,597,00:00:30.000,2025-04-14 11:54:07.762
false,false,1940,1826,114,443,00:00:31.000,2025-04-14 11:55:09.806
false,false,1942,1828,114,504,00:00:30.000,2025-04-14 11:55:13.810
false,false,1943,1829,114,534,00:00:30.000,2025-04-14 11:55:15.812
false,false,1690,1588,102,689,00:00:32.000,2025-04-14 11:43:01.282
false,true,1699,1597,102,0,00:00:00.000,2025-04-14 11:43:27.302
false,false,1704,1602,102,151,00:00:30.000,2025-04-14 11:43:41.316
false,false,1708,1606,102,275,00:00:31.000,2025-04-14 11:43:49.321
false,false,1743,1639,104,822,00:00:30.000,2025-04-14 11:45:11.382
false,false,1745,1641,104,888,00:00:33.000,2025-04-14 11:45:15.388
false,false,2275,2146,129,538,00:00:32.000,2025-04-14 12:09:20.414
false,false,2297,2167,130,220,00:00:33.000,2025-04-14 12:10:28.469
false,false,2301,2171,130,345,00:00:33.000,2025-04-14 12:10:36.475
false,false,2313,2183,130,279,00:00:30.000,2025-04-14 12:11:12.496
false,false,2316,2186,130,374,00:00:33.000,2025-04-14 12:11:18.502
false,false,2174,2051,123,376,00:00:32.000,2025-04-14 12:05:34.264
false,false,2196,2071,125,346,00:00:31.000,2025-04-14 12:06:30.298
false,false,2202,2076,126,535,00:00:32.000,2025-04-14 12:06:42.303
false,true,2258,2129,129,0,00:00:00.000,2025-04-14 12:08:36.378
false,true,2003,1886,117,0,00:00:00.000,2025-04-14 11:58:39.975
false,false,2007,1890,117,126,00:00:31.000,2025-04-14 11:58:47.980
false,false,2036,1918,118,1036,00:00:33.000,2025-04-14 11:59:46.019
false,false,2043,1925,118,31,00:00:31.000,2025-04-14 12:00:12.041
false,false,2053,1935,118,347,00:00:31.000,2025-04-14 12:00:32.056
false,true,2062,1944,118,0,00:00:00.000,2025-04-14 12:00:52.071
false,true,2062,1944,118,0,00:00:00.000,2025-04-14 12:01:02.080
false,false,2073,1954,119,351,00:00:32.000,2025-04-14 12:01:24.097
false,false,2416,2281,135,281,00:00:33.000,2025-04-14 12:15:50.704
false,false,2422,2287,135,472,00:00:33.000,2025-04-14 12:16:02.711
false,false,2439,2302,137,125,00:00:33.000,2025-04-14 12:16:48.746
false,true,2451,2313,138,0,00:00:00.000,2025-04-14 12:17:28.782
false,true,2451,2313,138,0,00:00:00.000,2025-04-14 12:17:34.786
false,true,2455,2317,138,0,00:00:00.000,2025-04-14 12:17:48.796
false,true,2464,2326,138,0,00:00:00.000,2025-04-14 12:18:22.816
false,false,2465,2327,138,32,00:00:32.000,2025-04-14 12:18:28.819
false,false,2470,2332,138,189,00:00:31.000,2025-04-14 12:18:38.828
false,false,2346,2215,131,188,00:00:31.000,2025-04-14 12:12:30.551
false,false,2406,2272,134,604,00:00:32.000,2025-04-14 12:15:18.682
false,false,2095,1976,119,1050,00:00:30.000,2025-04-14 12:02:08.122
false,true,2158,2036,122,0,00:00:00.000,2025-04-14 12:04:44.229
false,false,2512,2370,142,60,00:00:30.000,2025-04-14 12:20:14.880
false,false,2520,2378,142,313,00:00:31.000,2025-04-14 12:20:30.891
false,false,2532,2390,142,694,00:00:33.000,2025-04-14 12:20:54.907
false,false,2537,2395,142,851,00:00:32.000,2025-04-14 12:21:04.915
false,false,2542,2400,142,1011,00:00:33.000,2025-04-14 12:21:14.926
false,false,2569,2422,147,63,00:00:32.000,2025-04-14 12:22:20.985
false,false,2577,2430,147,318,00:00:31.000,2025-04-14 12:22:36.998
false,false,2584,2437,147,539,00:00:30.000,2025-04-14 12:22:51.012
false,false,2603,2454,149,476,00:00:33.000,2025-04-14 12:23:41.042
false,false,2606,2456,150,571,00:00:31.000,2025-04-14 12:23:47.049
false,true,2608,2458,150,0,00:00:00.000,2025-04-14 12:23:53.054
false,true,2608,2458,150,0,00:00:00.000,2025-04-14 12:23:59.059
false,true,2610,2460,150,0,00:00:00.000,2025-04-14 12:24:19.075
false,false,2621,2471,150,345,00:00:31.000,2025-04-14 12:24:41.087
false,false,2631,2479,152,662,00:00:31.000,2025-04-14 12:25:01.104
false,false,2735,2573,162,64,00:00:33.000,2025-04-14 12:29:17.296
false,false,2737,2575,162,127,00:00:30.000,2025-04-14 12:29:21.299
false,false,2742,2580,162,123,00:00:32.000,2025-04-14 12:29:43.316
false,true,2758,2595,163,0,00:00:00.000,2025-04-14 12:30:55.370
false,true,2758,2595,163,0,00:00:00.000,2025-04-14 12:30:59.374
false,false,2687,2529,158,419,00:00:33.000,2025-04-14 12:27:17.205
false,false,2689,2531,158,483,00:00:33.000,2025-04-14 12:27:21.207
false,false,2784,2620,164,314,00:00:30.000,2025-04-14 12:32:19.427
false,false,2829,2662,167,254,00:00:33.000,2025-04-14 12:34:13.509
false,true,2829,2662,167,0,00:00:00.000,2025-04-14 12:34:19.512
false,false,2831,2664,167,61,00:00:30.000,2025-04-14 12:34:29.517
false,false,2834,2667,167,156,00:00:32.000,2025-04-14 12:34:35.523
false,false,2850,2683,167,666,00:00:33.000,2025-04-14 12:35:07.551
false,true,2850,2683,167,0,00:00:00.000,2025-04-14 12:35:13.554
false,true,2851,2683,168,0,00:00:00.000,2025-04-14 12:35:23.565
false,true,2851,2683,168,0,00:00:00.000,2025-04-14 12:35:27.567
false,false,2865,2695,170,442,00:00:33.000,2025-04-14 12:36:01.585
false,false,2877,2707,170,30,00:00:30.000,2025-04-14 12:36:49.619
false,false,8055,7576,479,630,00:00:31.000,2025-04-15 12:01:29.133
false,false,8123,7638,485,60,00:00:30.000,2025-04-15 12:03:37.263
false,false,8126,7641,485,155,00:00:31.000,2025-04-15 12:03:40.266
false,false,8150,7664,486,913,00:00:33.000,2025-04-15 12:04:04.289
false,false,8155,7669,486,1073,00:00:32.000,2025-04-15 12:04:09.294
false,false,8187,7700,487,915,00:00:33.000,2025-04-15 12:04:47.339
false,false,8203,7715,488,251,00:00:30.000,2025-04-15 12:05:09.357
false,false,8204,7716,488,281,00:00:30.000,2025-04-15 12:05:10.358
false,true,8071,7589,482,0,00:00:00.000,2025-04-15 12:01:54.155
false,false,8116,7632,484,253,00:00:32.000,2025-04-15 12:03:06.227
false,true,7936,7461,475,0,00:00:00.000,2025-04-15 11:58:45.969
false,true,7942,7467,475,0,00:00:00.000,2025-04-15 11:58:54.980
false,true,7942,7467,475,0,00:00:00.000,2025-04-15 11:58:57.984
false,true,7942,7467,475,0,00:00:00.000,2025-04-15 11:58:58.985
false,false,7947,7472,475,159,00:00:32.000,2025-04-15 11:59:04.990
false,false,7977,7500,477,191,00:00:32.000,2025-04-15 11:59:47.036
false,false,7981,7503,478,313,00:00:30.000,2025-04-15 11:59:51.039
false,true,7993,7515,478,0,00:00:00.000,2025-04-15 12:00:07.052
false,true,8304,7810,494,0,00:00:00.000,2025-04-15 12:07:19.483
false,false,8317,7821,496,419,00:00:32.000,2025-04-15 12:07:33.497
false,true,8330,7834,496,0,00:00:00.000,2025-04-15 12:07:54.512
false,false,8351,7854,497,314,00:00:30.000,2025-04-15 12:08:25.545
false,false,8355,7858,497,439,00:00:33.000,2025-04-15 12:08:29.548
false,true,8356,7859,497,0,00:00:00.000,2025-04-15 12:08:33.551
false,true,8356,7859,497,0,00:00:00.000,2025-04-15 12:08:34.551
false,false,8358,7861,497,60,00:00:30.000,2025-04-15 12:08:38.556
false,false,8372,7874,498,499,00:00:32.000,2025-04-15 12:08:52.570
false,false,8389,7889,500,1026,00:00:30.000,2025-04-15 12:09:09.585
false,true,8395,7895,500,0,00:00:00.000,2025-04-15 12:09:20.595
false,false,8404,7904,500,282,00:00:30.000,2025-04-15 12:09:30.604
false,true,8409,7908,501,0,00:00:00.000,2025-04-15 12:09:37.611
false,true,8428,7926,502,0,00:00:00.000,2025-04-15 12:10:17.648
false,false,8429,7927,502,31,00:00:31.000,2025-04-15 12:10:19.651
false,false,8432,7930,502,126,00:00:32.000,2025-04-15 12:10:22.654
false,false,8436,7934,502,252,00:00:32.000,2025-04-15 12:10:26.657
false,true,8453,7951,502,0,00:00:00.000,2025-04-15 12:10:50.679
false,false,8459,7957,502,193,00:00:32.000,2025-04-15 12:11:01.690
false,true,8463,7961,502,0,00:00:00.000,2025-04-15 12:11:11.701
false,false,8466,7964,502,96,00:00:33.000,2025-04-15 12:11:14.702
false,false,8473,7971,502,313,00:00:33.000,2025-04-15 12:11:21.708
false,false,8482,7979,503,593,00:00:30.000,2025-04-15 12:11:30.718
false,true,8489,7986,503,0,00:00:00.000,2025-04-15 12:11:41.734
false,false,8494,7991,503,158,00:00:33.000,2025-04-15 12:11:48.738
false,false,8496,7993,503,221,00:00:32.000,2025-04-15 12:11:50.742
false,true,8206,7718,488,0,00:00:00.000,2025-04-15 12:05:13.360
false,true,8232,7741,491,0,00:00:00.000,2025-04-15 12:05:50.398
false,false,8238,7747,491,186,00:00:30.000,2025-04-15 12:05:56.403
false,true,8246,7754,492,0,00:00:00.000,2025-04-15 12:06:07.412
false,true,8248,7756,492,0,00:00:00.000,2025-04-15 12:06:18.420
false,false,8256,7763,493,246,00:00:30.000,2025-04-15 12:06:26.429
false,false,8264,7771,493,502,00:00:30.000,2025-04-15 12:06:34.436
false,false,8272,7779,493,748,00:00:31.000,2025-04-15 12:06:42.448
false,true,8578,8073,505,0,00:00:00.000,2025-04-15 12:13:34.845
false,false,8579,8074,505,30,00:00:30.000,2025-04-15 12:13:37.847
false,true,8580,8075,505,0,00:00:00.000,2025-04-15 12:13:44.851
false,true,8594,8087,507,0,00:00:00.000,2025-04-15 12:14:06.870
false,true,8594,8087,507,0,00:00:00.000,2025-04-15 12:14:15.879
false,false,8618,8109,509,751,00:00:32.000,2025-04-15 12:14:40.906
false,false,8701,8188,513,281,00:00:32.000,2025-04-15 12:16:58.039
false,false,8702,8189,513,312,00:00:31.000,2025-04-15 12:16:59.039
false,false,8724,8209,515,597,00:00:32.000,2025-04-15 12:17:27.064
false,false,8733,8218,515,880,00:00:32.000,2025-04-15 12:17:36.073
false,true,8750,8232,518,0,00:00:00.000,2025-04-15 12:17:58.101
false,true,8750,8232,518,0,00:00:00.000,2025-04-15 12:17:59.102
false,false,8773,8255,518,720,00:00:31.000,2025-04-15 12:18:22.123
false,true,8774,8256,518,0,00:00:00.000,2025-04-15 12:18:25.127
false,false,8647,8135,512,255,00:00:33.000,2025-04-15 12:15:21.946
false,true,8651,8139,512,0,00:00:00.000,2025-04-15 12:15:26.949
false,false,8652,8140,512,31,00:00:31.000,2025-04-15 12:15:32.955
false,true,8656,8144,512,0,00:00:00.000,2025-04-15 12:15:42.964
false,false,8661,8149,512,157,00:00:32.000,2025-04-15 12:15:47.970
false,false,8667,8155,512,350,00:00:33.000,2025-04-15 12:15:53.973
false,true,8672,8160,512,0,00:00:00.000,2025-04-15 12:16:03.983
false,false,8674,8162,512,63,00:00:31.000,2025-04-15 12:16:06.985
false,false,8683,8170,513,279,00:00:30.000,2025-04-15 12:16:22.003
false,true,8686,8173,513,0,00:00:00.000,2025-04-15 12:16:34.015
false,false,8693,8180,513,32,00:00:32.000,2025-04-15 12:16:50.030
false,false,8503,7999,504,443,00:00:32.000,2025-04-15 12:11:57.749
false,false,8521,8016,505,248,00:00:31.000,2025-04-15 12:12:21.770
false,true,8526,8021,505,0,00:00:00.000,2025-04-15 12:12:27.775
false,false,8564,8059,505,562,00:00:32.000,2025-04-15 12:13:16.827
false,false,8788,8269,519,61,00:00:31.000,2025-04-15 12:18:49.151
false,false,8791,8272,519,159,00:00:33.000,2025-04-15 12:18:52.154
false,true,8799,8280,519,0,00:00:00.000,2025-04-15 12:19:04.161
false,false,8819,8298,521,60,00:00:30.000,2025-04-15 12:19:38.201
false,false,8820,8299,521,91,00:00:31.000,2025-04-15 12:19:39.203
false,false,8821,8300,521,122,00:00:31.000,2025-04-15 12:19:40.205
false,false,8837,8314,523,626,00:00:33.000,2025-04-15 12:19:56.221
false,false,8844,8321,523,124,00:00:31.000,2025-04-15 12:20:09.234
false,false,8921,8391,530,750,00:00:32.000,2025-04-15 12:22:02.356
false,false,8943,8412,531,1440,00:00:32.000,2025-04-15 12:22:24.375
false,false,8947,8416,531,1568,00:00:31.000,2025-04-15 12:22:28.379
false,false,8956,8425,531,1853,00:00:30.000,2025-04-15 12:22:37.389
false,false,8957,8426,531,32,00:00:32.000,2025-04-15 12:22:44.395
false,true,8964,8433,531,0,00:00:00.000,2025-04-15 12:22:52.406
false,false,8969,8436,533,160,00:00:32.000,2025-04-15 12:23:02.413
false,false,8996,8463,533,1003,00:00:33.000,2025-04-15 12:23:29.440
false,false,8881,8354,527,820,00:00:33.000,2025-04-15 12:20:52.283
false,true,8886,8357,529,0,00:00:00.000,2025-04-15 12:21:01.291
false,true,8890,8361,529,0,00:00:00.000,2025-04-15 12:21:12.306
false,true,9241,8689,552,0,00:00:00.000,2025-04-15 12:28:36.741
false,false,9242,8690,552,30,00:00:30.000,2025-04-15 12:28:41.747
false,true,9248,8696,552,0,00:00:00.000,2025-04-15 12:28:55.758
false,false,9275,8719,556,475,00:00:32.000,2025-04-15 12:29:32.800
false,true,9277,8721,556,0,00:00:00.000,2025-04-15 12:29:46.816
false,false,9280,8724,556,92,00:00:32.000,2025-04-15 12:29:49.818
false,false,9088,8547,541,983,00:00:31.000,2025-04-15 12:25:31.550
false,false,9101,8559,542,1393,00:00:30.000,2025-04-15 12:25:44.567
false,false,9117,8573,544,1895,00:00:31.000,2025-04-15 12:26:00.581
false,false,9127,8583,544,2205,00:00:31.000,2025-04-15 12:26:10.592
false,true,9152,8607,545,0,00:00:00.000,2025-04-15 12:26:39.617
false,true,9152,8607,545,0,00:00:00.000,2025-04-15 12:26:40.618
false,true,9168,8623,545,0,00:00:00.000,2025-04-15 12:27:06.644
false,false,9183,8635,548,474,00:00:33.000,2025-04-15 12:27:24.658
false,false,9192,8644,548,61,00:00:31.000,2025-04-15 12:27:39.674
false,false,9209,8660,549,31,00:00:31.000,2025-04-15 12:28:02.700
false,false,9210,8661,549,61,00:00:30.000,2025-04-15 12:28:03.701
false,false,9215,8665,550,221,00:00:31.000,2025-04-15 12:28:08.709
false,false,9227,8675,552,600,00:00:32.000,2025-04-15 12:28:20.723
false,true,9370,8808,562,0,00:00:00.000,2025-04-15 12:32:22.965
false,false,9375,8813,562,158,00:00:32.000,2025-04-15 12:32:30.975
false,true,9384,8822,562,0,00:00:00.000,2025-04-15 12:32:41.987
false,false,9388,8826,562,129,00:00:33.000,2025-04-15 12:32:49.997
false,false,9005,8472,533,99,00:00:33.000,2025-04-15 12:23:44.454
false,false,9008,8475,533,191,00:00:31.000,2025-04-15 12:23:47.457
false,false,9010,8477,533,254,00:00:31.000,2025-04-15 12:23:49.459
false,false,9056,8519,537,375,00:00:32.000,2025-04-15 12:24:53.515
false,true,9057,8520,537,0,00:00:00.000,2025-04-15 12:24:55.518
false,false,9064,8527,537,222,00:00:31.000,2025-04-15 12:25:07.529
false,false,9496,8931,565,597,00:00:32.000,2025-04-15 12:35:08.144
false,false,9500,8933,567,723,00:00:31.000,2025-04-15 12:35:12.149
false,true,9501,8933,568,0,00:00:00.000,2025-04-15 12:35:17.155
false,false,9507,8939,568,191,00:00:31.000,2025-04-15 12:35:25.162
false,false,9547,8975,572,1096,00:00:32.000,2025-04-15 12:36:11.204
false,true,9550,8978,572,0,00:00:00.000,2025-04-15 12:36:24.219
false,false,9556,8984,572,94,00:00:31.000,2025-04-15 12:36:38.233
false,false,9569,8997,572,503,00:00:32.000,2025-04-15 12:36:51.248
false,false,9572,9000,572,599,00:00:32.000,2025-04-15 12:36:54.251
false,false,9576,9003,573,723,00:00:30.000,2025-04-15 12:36:58.253
false,false,9606,9031,575,158,00:00:32.000,2025-04-15 12:37:40.301
false,false,9612,9037,575,348,00:00:33.000,2025-04-15 12:37:46.304
false,false,9622,9047,575,659,00:00:32.000,2025-04-15 12:37:56.313
false,false,9623,9048,575,691,00:00:32.000,2025-04-15 12:37:57.314
false,true,9401,8839,562,0,00:00:00.000,2025-04-15 12:33:14.023
false,false,9409,8847,562,255,00:00:33.000,2025-04-15 12:33:23.035
false,true,9428,8865,563,0,00:00:00.000,2025-04-15 12:33:45.060
false,false,9443,8880,563,476,00:00:33.000,2025-04-15 12:34:03.084
false,false,9474,8910,564,1442,00:00:33.000,2025-04-15 12:34:34.112
false,true,9476,8912,564,0,00:00:00.000,2025-04-15 12:34:41.118
false,true,9477,8913,564,0,00:00:00.000,2025-04-15 12:34:47.124
false,true,9477,8913,564,0,00:00:00.000,2025-04-15 12:34:48.124
false,false,9334,8773,561,347,00:00:30.000,2025-04-15 12:31:13.900
false,false,9344,8783,561,657,00:00:31.000,2025-04-15 12:31:23.908
false,false,9346,8785,561,721,00:00:33.000,2025-04-15 12:31:25.910
false,false,9665,9087,578,504,00:00:30.000,2025-04-15 12:38:45.373
false,false,9671,9093,578,694,00:00:31.000,2025-04-15 12:38:51.379
false,true,9675,9097,578,0,00:00:00.000,2025-04-15 12:38:57.383
false,false,9701,9120,581,287,00:00:32.000,2025-04-15 12:39:33.425
false,true,9701,9120,581,0,00:00:00.000,2025-04-15 12:39:39.431
false,false,1600,1505,95,407,00:00:31.000,2025-04-14 11:38:49.087
false,false,1608,1513,95,655,00:00:33.000,2025-04-14 11:39:05.101
false,false,1621,1524,97,97,00:00:33.000,2025-04-14 11:39:55.141
false,false,1645,1547,98,596,00:00:31.000,2025-04-14 11:40:55.187
false,true,1657,1559,98,0,00:00:00.000,2025-04-14 11:41:31.215
false,false,1810,1705,105,410,00:00:30.000,2025-04-14 11:49:01.537
false,false,1811,1706,105,442,00:00:32.000,2025-04-14 11:49:03.540
false,false,1821,1715,106,162,00:00:32.000,2025-04-14 11:49:35.561
false,false,1823,1717,106,225,00:00:30.000,2025-04-14 11:49:39.565
false,false,1828,1722,106,381,00:00:33.000,2025-04-14 11:49:49.570
false,false,1834,1726,108,569,00:00:31.000,2025-04-14 11:50:01.578
false,false,1876,1765,111,1089,00:00:33.000,2025-04-14 11:51:49.660
false,false,1952,1837,115,32,00:00:32.000,2025-04-14 11:56:09.851
false,false,1954,1839,115,96,00:00:32.000,2025-04-14 11:56:13.855
false,true,1959,1844,115,0,00:00:00.000,2025-04-14 11:56:37.874
false,false,1961,1845,116,64,00:00:32.000,2025-04-14 11:56:51.889
false,true,2003,1886,117,0,00:00:00.000,2025-04-14 11:58:29.967
false,false,1759,1655,104,217,00:00:30.000,2025-04-14 11:45:55.414
false,true,1776,1672,104,0,00:00:00.000,2025-04-14 11:47:03.458
false,false,1794,1690,104,477,00:00:33.000,2025-04-14 11:48:17.509
false,false,1881,1770,111,30,00:00:30.000,2025-04-14 11:52:23.682
false,false,1906,1793,113,122,00:00:30.000,2025-04-14 11:53:37.735
false,false,1912,1799,113,311,00:00:31.000,2025-04-14 11:53:49.747
false,true,1924,1811,113,0,00:00:00.000,2025-04-14 11:54:15.770
false,true,1924,1811,113,0,00:00:00.000,2025-04-14 11:54:21.775
false,false,1669,1569,100,31,00:00:31.000,2025-04-14 11:42:19.253
false,false,1670,1570,100,62,00:00:31.000,2025-04-14 11:42:21.255
false,false,1676,1575,101,251,00:00:33.000,2025-04-14 11:42:33.265
false,false,1694,1592,102,818,00:00:33.000,2025-04-14 11:43:09.288
false,true,1717,1615,102,0,00:00:00.000,2025-04-14 11:44:09.337
false,false,1728,1625,103,345,00:00:31.000,2025-04-14 11:44:41.361
false,true,2258,2129,129,0,00:00:00.000,2025-04-14 12:08:40.379
false,false,2264,2135,129,192,00:00:33.000,2025-04-14 12:08:58.396
false,false,2269,2140,129,350,00:00:30.000,2025-04-14 12:09:08.405
false,false,2280,2151,129,64,00:00:32.000,2025-04-14 12:09:42.428
false,true,2290,2161,129,0,00:00:00.000,2025-04-14 12:10:14.455
false,true,2304,2174,130,0,00:00:00.000,2025-04-14 12:10:52.485
false,true,2304,2174,130,0,00:00:00.000,2025-04-14 12:10:54.487
false,false,2321,2191,130,535,00:00:33.000,2025-04-14 12:11:28.508
false,false,2187,2063,124,62,00:00:31.000,2025-04-14 12:06:12.289
false,false,2203,2076,127,567,00:00:32.000,2025-04-14 12:06:44.306
false,false,2213,2086,127,882,00:00:31.000,2025-04-14 12:07:04.318
false,false,2214,2087,127,913,00:00:31.000,2025-04-14 12:07:06.319
false,false,2227,2099,128,1322,00:00:30.000,2025-04-14 12:07:32.338
false,false,2239,2111,128,1700,00:00:32.000,2025-04-14 12:07:56.353
false,false,2258,2129,129,2305,00:00:32.000,2025-04-14 12:08:34.376
false,false,2020,1903,117,532,00:00:33.000,2025-04-14 11:59:13.995
false,false,2062,1944,118,633,00:00:33.000,2025-04-14 12:00:50.070
false,true,2062,1944,118,0,00:00:00.000,2025-04-14 12:00:58.077
false,false,2069,1950,119,223,00:00:33.000,2025-04-14 12:01:16.094
false,false,2411,2276,135,124,00:00:31.000,2025-04-14 12:15:40.694
false,true,2449,2311,138,0,00:00:00.000,2025-04-14 12:17:14.768
false,true,2449,2311,138,0,00:00:00.000,2025-04-14 12:17:20.774
false,false,2451,2313,138,61,00:00:31.000,2025-04-14 12:17:24.778
false,true,2455,2317,138,0,00:00:00.000,2025-04-14 12:17:56.802
false,false,2462,2324,138,220,00:00:33.000,2025-04-14 12:18:10.811
false,true,2340,2209,131,0,00:00:00.000,2025-04-14 12:12:12.543
false,false,2343,2212,131,96,00:00:32.000,2025-04-14 12:12:24.549
false,false,2345,2214,131,157,00:00:31.000,2025-04-14 12:12:28.551
false,true,2359,2228,131,0,00:00:00.000,2025-04-14 12:13:22.587
false,true,2359,2228,131,0,00:00:00.000,2025-04-14 12:13:32.598
false,false,2379,2246,133,635,00:00:30.000,2025-04-14 12:14:12.624
false,false,2392,2258,134,156,00:00:33.000,2025-04-14 12:14:50.659
false,false,2093,1974,119,989,00:00:33.000,2025-04-14 12:02:04.118
false,false,2120,2001,119,284,00:00:33.000,2025-04-14 12:03:10.167
false,false,2122,2002,120,348,00:00:33.000,2025-04-14 12:03:14.171
false,false,2140,2020,120,94,00:00:30.000,2025-04-14 12:04:02.199
false,false,2148,2028,120,344,00:00:31.000,2025-04-14 12:04:18.210
false,true,2158,2036,122,0,00:00:00.000,2025-04-14 12:04:46.231
false,false,2488,2349,139,757,00:00:33.000,2025-04-14 12:19:14.846
false,false,2503,2364,139,1226,00:00:30.000,2025-04-14 12:19:44.858
false,false,2525,2383,142,467,00:00:31.000,2025-04-14 12:20:40.898
false,false,2585,2438,147,569,00:00:30.000,2025-04-14 12:22:53.011
false,false,2594,2446,148,194,00:00:33.000,2025-04-14 12:23:23.032
false,true,2608,2458,150,0,00:00:00.000,2025-04-14 12:24:01.061
false,false,2637,2485,152,849,00:00:31.000,2025-04-14 12:25:13.109
false,false,2640,2488,152,942,00:00:30.000,2025-04-14 12:25:19.113
false,true,2733,2571,162,0,00:00:00.000,2025-04-14 12:29:05.291
false,true,2733,2571,162,0,00:00:00.000,2025-04-14 12:29:09.292
false,false,2754,2591,163,96,00:00:33.000,2025-04-14 12:30:31.352
false,true,2758,2595,163,0,00:00:00.000,2025-04-14 12:30:47.364
false,false,2764,2601,163,194,00:00:33.000,2025-04-14 12:31:15.390
false,false,2767,2604,163,290,00:00:33.000,2025-04-14 12:31:21.392
false,false,2652,2496,156,1322,00:00:32.000,2025-04-14 12:25:43.129
false,true,2660,2504,156,0,00:00:00.000,2025-04-14 12:26:05.144
false,false,2669,2512,157,284,00:00:30.000,2025-04-14 12:26:29.160
false,false,2711,2551,160,120,00:00:30.000,2025-04-14 12:28:17.254
false,false,2794,2630,164,626,00:00:32.000,2025-04-14 12:32:39.443
false,false,2797,2633,164,724,00:00:33.000,2025-04-14 12:32:45.447
false,false,2817,2650,167,568,00:00:32.000,2025-04-14 12:33:37.480
false,true,2821,2654,167,0,00:00:00.000,2025-04-14 12:33:53.488
false,true,2821,2654,167,0,00:00:00.000,2025-04-14 12:33:55.491
false,true,2851,2683,168,0,00:00:00.000,2025-04-14 12:35:33.570
false,false,2859,2689,170,252,00:00:31.000,2025-04-14 12:35:49.577
false,false,2875,2705,170,65,00:00:32.000,2025-04-14 12:36:33.607
false,false,2878,2708,170,63,00:00:33.000,2025-04-14 12:36:51.620
false,true,8070,7588,482,0,00:00:00.000,2025-04-15 12:01:49.153
false,true,8121,7637,484,0,00:00:00.000,2025-04-15 12:03:33.258
false,false,8158,7672,486,1168,00:00:30.000,2025-04-15 12:04:12.297
false,false,8162,7676,486,127,00:00:32.000,2025-04-15 12:04:22.312
false,false,8166,7679,487,254,00:00:33.000,2025-04-15 12:04:26.315
false,false,8169,7682,487,350,00:00:33.000,2025-04-15 12:04:29.318
false,true,8195,7708,487,0,00:00:00.000,2025-04-15 12:04:59.351
false,true,8071,7589,482,0,00:00:00.000,2025-04-15 12:01:56.157
false,false,8084,7601,483,411,00:00:30.000,2025-04-15 12:02:10.170
false,true,8087,7604,483,0,00:00:00.000,2025-04-15 12:02:16.175
false,false,8099,7615,484,250,00:00:30.000,2025-04-15 12:02:37.197
false,true,8100,7616,484,0,00:00:00.000,2025-04-15 12:02:44.207
false,false,8106,7622,484,190,00:00:33.000,2025-04-15 12:02:50.211
false,false,8110,7626,484,63,00:00:32.000,2025-04-15 12:03:00.220
false,true,7971,7495,476,0,00:00:00.000,2025-04-15 11:59:39.027
false,false,7980,7502,478,283,00:00:30.000,2025-04-15 11:59:50.037
false,false,8291,7797,494,1344,00:00:31.000,2025-04-15 12:07:01.463
false,false,8296,7802,494,1502,00:00:31.000,2025-04-15 12:07:06.472
false,false,8318,7822,496,451,00:00:32.000,2025-04-15 12:07:34.498
false,false,8319,7823,496,483,00:00:32.000,2025-04-15 12:07:35.499
false,false,8325,7829,496,670,00:00:31.000,2025-04-15 12:07:41.505
false,true,8330,7834,496,0,00:00:00.000,2025-04-15 12:07:55.513
false,false,8345,7849,496,129,00:00:33.000,2025-04-15 12:08:19.540
false,true,8356,7859,497,0,00:00:00.000,2025-04-15 12:08:32.551
false,true,8356,7859,497,0,00:00:00.000,2025-04-15 12:08:35.553
false,true,8356,7859,497,0,00:00:00.000,2025-04-15 12:08:36.553
false,false,8361,7864,497,150,00:00:30.000,2025-04-15 12:08:41.559
false,false,8386,7886,500,933,00:00:32.000,2025-04-15 12:09:06.581
false,false,8409,7908,501,440,00:00:30.000,2025-04-15 12:09:35.610
false,true,8411,7910,501,0,00:00:00.000,2025-04-15 12:09:47.620
false,false,8415,7914,501,95,00:00:30.000,2025-04-15 12:09:59.630
false,false,8435,7933,502,220,00:00:33.000,2025-04-15 12:10:25.655
false,false,8439,7937,502,346,00:00:33.000,2025-04-15 12:10:29.660
false,false,8456,7954,502,96,00:00:32.000,2025-04-15 12:10:58.688
false,false,8463,7961,502,319,00:00:31.000,2025-04-15 12:11:05.695
false,false,8470,7968,502,220,00:00:33.000,2025-04-15 12:11:18.706
false,false,8471,7969,502,250,00:00:30.000,2025-04-15 12:11:19.707
false,false,8488,7985,503,779,00:00:33.000,2025-04-15 12:11:36.727
false,false,8206,7718,488,346,00:00:32.000,2025-04-15 12:05:12.359
false,false,8218,7729,489,375,00:00:32.000,2025-04-15 12:05:30.376
false,false,8220,7731,489,436,00:00:31.000,2025-04-15 12:05:32.378
false,false,8226,7736,490,627,00:00:32.000,2025-04-15 12:05:38.384
false,false,8241,7749,492,278,00:00:30.000,2025-04-15 12:05:59.404
false,false,8600,8092,508,191,00:00:33.000,2025-04-15 12:14:22.888
false,false,8608,8099,509,437,00:00:32.000,2025-04-15 12:14:30.896
false,false,8610,8101,509,500,00:00:30.000,2025-04-15 12:14:32.898
false,true,8625,8115,510,0,00:00:00.000,2025-04-15 12:14:53.917
false,false,8628,8118,510,96,00:00:31.000,2025-04-15 12:14:56.920
false,false,8725,8210,515,629,00:00:32.000,2025-04-15 12:17:28.065
false,false,8749,8231,518,1386,00:00:32.000,2025-04-15 12:17:52.093
false,true,8774,8256,518,0,00:00:00.000,2025-04-15 12:18:29.131
false,false,8643,8131,512,126,00:00:33.000,2025-04-15 12:15:17.939
false,true,8651,8139,512,0,00:00:00.000,2025-04-15 12:15:28.950
false,false,8669,8157,512,411,00:00:31.000,2025-04-15 12:15:55.975
false,false,8673,8161,512,32,00:00:32.000,2025-04-15 12:16:05.984
false,true,8674,8162,512,0,00:00:00.000,2025-04-15 12:16:09.989
false,false,8692,8179,513,189,00:00:32.000,2025-04-15 12:16:43.025
false,false,8510,8006,504,662,00:00:30.000,2025-04-15 12:12:04.755
false,false,8513,8009,504,756,00:00:30.000,2025-04-15 12:12:07.759
false,false,8514,8010,504,30,00:00:30.000,2025-04-15 12:12:14.766
false,false,8515,8010,505,63,00:00:33.000,2025-04-15 12:12:15.766
false,false,8520,8015,505,217,00:00:30.000,2025-04-15 12:12:20.770
false,false,8523,8018,505,312,00:00:32.000,2025-04-15 12:12:23.771
false,false,8532,8027,505,189,00:00:33.000,2025-04-15 12:12:38.786
false,false,8542,8037,505,505,00:00:32.000,2025-04-15 12:12:48.798
false,false,8544,8039,505,567,00:00:32.000,2025-04-15 12:12:50.800
false,false,8554,8049,505,250,00:00:30.000,2025-04-15 12:13:06.816
false,false,8559,8054,505,407,00:00:30.000,2025-04-15 12:13:11.822
false,false,8785,8266,519,349,00:00:30.000,2025-04-15 12:18:40.141
false,false,8786,8267,519,379,00:00:30.000,2025-04-15 12:18:41.143
false,false,8839,8316,523,688,00:00:31.000,2025-04-15 12:19:58.222
false,true,8840,8317,523,0,00:00:00.000,2025-04-15 12:20:00.224
false,false,8926,8396,530,907,00:00:33.000,2025-04-15 12:22:07.361
false,false,8936,8405,531,1221,00:00:30.000,2025-04-15 12:22:17.370
false,false,8955,8424,531,1823,00:00:31.000,2025-04-15 12:22:36.388
false,false,8980,8447,533,504,00:00:30.000,2025-04-15 12:23:13.424
false,false,8981,8448,533,534,00:00:30.000,2025-04-15 12:23:14.424
false,true,8855,8331,524,0,00:00:00.000,2025-04-15 12:20:23.249
false,false,8872,8346,526,534,00:00:31.000,2025-04-15 12:20:43.274
false,false,8879,8352,527,756,00:00:31.000,2025-04-15 12:20:50.281
false,true,8893,8364,529,0,00:00:00.000,2025-04-15 12:21:25.318
false,false,8897,8368,529,128,00:00:32.000,2025-04-15 12:21:32.321
false,false,9240,8688,552,1011,00:00:33.000,2025-04-15 12:28:33.738
false,true,9260,8708,552,0,00:00:00.000,2025-04-15 12:29:15.781
false,true,9260,8708,552,0,00:00:00.000,2025-04-15 12:29:16.782
false,false,9279,8723,556,60,00:00:30.000,2025-04-15 12:29:48.818
false,false,9126,8582,544,2174,00:00:30.000,2025-04-15 12:26:09.589
false,true,9168,8623,545,0,00:00:00.000,2025-04-15 12:27:09.646
false,false,9169,8624,545,30,00:00:30.000,2025-04-15 12:27:10.646
false,false,9190,8642,548,695,00:00:33.000,2025-04-15 12:27:31.664
false,false,9197,8649,548,216,00:00:31.000,2025-04-15 12:27:44.680
false,false,9205,8656,549,468,00:00:32.000,2025-04-15 12:27:52.690
false,true,9208,8659,549,0,00:00:00.000,2025-04-15 12:27:56.693
false,false,9217,8667,550,284,00:00:33.000,2025-04-15 12:28:10.710
false,false,9221,8669,552,410,00:00:33.000,2025-04-15 12:28:14.715
false,true,9364,8802,562,0,00:00:00.000,2025-04-15 12:32:00.943
false,false,9368,8806,562,123,00:00:31.000,2025-04-15 12:32:05.950
false,false,9379,8817,562,283,00:00:30.000,2025-04-15 12:32:34.979
false,false,9401,8839,562,545,00:00:33.000,2025-04-15 12:33:03.011
false,false,9016,8482,534,63,00:00:32.000,2025-04-15 12:24:01.468
false,true,9028,8493,535,0,00:00:00.000,2025-04-15 12:24:15.480
false,true,9044,8507,537,0,00:00:00.000,2025-04-15 12:24:39.500
false,false,9048,8511,537,126,00:00:32.000,2025-04-15 12:24:45.506
false,false,9052,8515,537,249,00:00:30.000,2025-04-15 12:24:49.510
false,false,9059,8522,537,64,00:00:33.000,2025-04-15 12:25:02.524
false,false,9062,8525,537,158,00:00:31.000,2025-04-15 12:25:05.526
false,false,9485,8921,564,253,00:00:30.000,2025-04-15 12:34:57.132
false,true,9501,8933,568,0,00:00:00.000,2025-04-15 12:35:16.154
false,false,9508,8940,568,223,00:00:32.000,2025-04-15 12:35:26.162
false,false,9511,8943,568,318,00:00:31.000,2025-04-15 12:35:29.164
false,false,9546,8974,572,1064,00:00:30.000,2025-04-15 12:36:10.202
false,false,9571,8999,572,567,00:00:33.000,2025-04-15 12:36:53.249
false,true,9581,9008,573,0,00:00:00.000,2025-04-15 12:37:05.261
false,false,9605,9031,574,126,00:00:32.000,2025-04-15 12:37:39.300
false,false,9432,8869,563,127,00:00:33.000,2025-04-15 12:33:52.071
false,false,9442,8879,563,443,00:00:32.000,2025-04-15 12:34:02.082
false,true,9477,8913,564,0,00:00:00.000,2025-04-15 12:34:45.121
false,false,9347,8786,561,752,00:00:31.000,2025-04-15 12:31:26.911
false,false,9647,9072,575,1449,00:00:31.000,2025-04-15 12:38:21.345
false,false,9691,9112,579,502,00:00:30.000,2025-04-15 12:39:17.405
false,true,9692,9113,579,0,00:00:00.000,2025-04-15 12:39:23.413
false,true,9701,9120,581,0,00:00:00.000,2025-04-15 12:39:34.426
false,true,9701,9120,581,0,00:00:00.000,2025-04-15 12:39:35.427
false,false,1601,1506,95,437,00:00:30.000,2025-04-14 11:38:51.088
false,true,1614,1518,96,0,00:00:00.000,2025-04-14 11:39:23.118
false,false,1625,1528,97,224,00:00:31.000,2025-04-14 11:40:03.146
false,false,1626,1529,97,255,00:00:31.000,2025-04-14 11:40:05.147
false,false,1655,1557,98,909,00:00:32.000,2025-04-14 11:41:15.207
false,true,1816,1711,105,0,00:00:00.000,2025-04-14 11:49:23.556
false,false,1825,1719,106,286,00:00:30.000,2025-04-14 11:49:43.567
false,false,1826,1720,106,318,00:00:32.000,2025-04-14 11:49:45.568
false,false,1833,1726,107,538,00:00:33.000,2025-04-14 11:49:59.577
false,false,1837,1729,108,661,00:00:32.000,2025-04-14 11:50:07.582
false,false,1843,1734,109,63,00:00:32.000,2025-04-14 11:50:43.612
false,false,1853,1743,110,374,00:00:30.000,2025-04-14 11:51:03.629
false,false,1857,1747,110,502,00:00:32.000,2025-04-14 11:51:11.632
false,false,1948,1834,114,698,00:00:32.000,2025-04-14 11:55:25.820
false,true,1950,1835,115,0,00:00:00.000,2025-04-14 11:55:33.826
false,true,1951,1836,115,0,00:00:00.000,2025-04-14 11:55:57.843
false,true,1958,1843,115,0,00:00:00.000,2025-04-14 11:56:23.862
false,true,1958,1843,115,0,00:00:00.000,2025-04-14 11:56:27.864
false,false,1965,1849,116,189,00:00:30.000,2025-04-14 11:56:59.896
false,true,1977,1861,116,0,00:00:00.000,2025-04-14 11:57:33.921
false,false,1978,1862,116,30,00:00:30.000,2025-04-14 11:57:37.923
false,false,1761,1657,104,278,00:00:31.000,2025-04-14 11:45:59.415
false,true,1773,1669,104,0,00:00:00.000,2025-04-14 11:46:47.448
false,true,1779,1675,104,0,00:00:00.000,2025-04-14 11:47:37.482
false,false,1796,1692,104,541,00:00:31.000,2025-04-14 11:48:21.512
false,true,1880,1769,111,0,00:00:00.000,2025-04-14 11:52:09.671
false,true,1880,1769,111,0,00:00:00.000,2025-04-14 11:52:19.678
false,false,1884,1773,111,125,00:00:33.000,2025-04-14 11:52:29.684
false,true,1894,1781,113,0,00:00:00.000,2025-04-14 11:52:59.706
false,true,1902,1789,113,0,00:00:00.000,2025-04-14 11:53:29.731
false,false,1936,1822,114,315,00:00:31.000,2025-04-14 11:55:01.799
false,true,1667,1568,99,0,00:00:00.000,2025-04-14 11:42:01.240
false,true,1668,1569,99,0,00:00:00.000,2025-04-14 11:42:13.249
false,false,1681,1580,101,407,00:00:32.000,2025-04-14 11:42:43.269
false,false,1731,1627,104,439,00:00:31.000,2025-04-14 11:44:47.364
false,false,1741,1637,104,759,00:00:33.000,2025-04-14 11:45:07.380
false,false,2263,2134,129,159,00:00:30.000,2025-04-14 12:08:56.394
false,false,2276,2147,129,568,00:00:30.000,2025-04-14 12:09:22.414
false,false,2278,2149,129,628,00:00:30.000,2025-04-14 12:09:26.418
false,true,2278,2149,129,0,00:00:00.000,2025-04-14 12:09:38.427
false,false,2282,2153,129,128,00:00:31.000,2025-04-14 12:09:46.433
false,true,2290,2161,129,0,00:00:00.000,2025-04-14 12:10:12.453
false,true,2304,2174,130,0,00:00:00.000,2025-04-14 12:10:50.484
false,false,2306,2176,130,62,00:00:31.000,2025-04-14 12:10:58.490
false,false,2307,2177,130,92,00:00:30.000,2025-04-14 12:11:00.490
false,false,2322,2192,130,565,00:00:30.000,2025-04-14 12:11:30.511
false,false,2333,2202,131,922,00:00:33.000,2025-04-14 12:11:52.528
false,true,2185,2061,124,0,00:00:00.000,2025-04-14 12:06:02.281
false,false,2209,2082,127,757,00:00:31.000,2025-04-14 12:06:56.314
false,false,2242,2114,128,1797,00:00:33.000,2025-04-14 12:08:02.359
false,false,2251,2122,129,2083,00:00:32.000,2025-04-14 12:08:20.371
false,false,2037,1919,118,1066,00:00:30.000,2025-04-14 11:59:48.022
false,true,2042,1924,118,0,00:00:00.000,2025-04-14 12:00:04.034
false,false,2048,1930,118,189,00:00:31.000,2025-04-14 12:00:22.048
false,false,2052,1934,118,316,00:00:31.000,2025-04-14 12:00:30.054
false,false,2064,1945,119,60,00:00:30.000,2025-04-14 12:01:06.085
false,false,2068,1949,119,190,00:00:33.000,2025-04-14 12:01:14.092
false,true,2407,2273,134,0,00:00:00.000,2025-04-14 12:15:26.687
false,false,2448,2310,138,408,00:00:32.000,2025-04-14 12:17:06.763
false,true,2340,2209,131,0,00:00:00.000,2025-04-14 12:12:14.544
false,true,2347,2216,131,0,00:00:00.000,2025-04-14 12:12:34.554
false,false,2355,2224,131,220,00:00:30.000,2025-04-14 12:13:12.579
false,true,2359,2228,131,0,00:00:00.000,2025-04-14 12:13:26.591
false,false,2380,2247,133,668,00:00:33.000,2025-04-14 12:14:14.626
false,true,2387,2253,134,0,00:00:00.000,2025-04-14 12:14:32.645
false,false,2399,2265,134,379,00:00:31.000,2025-04-14 12:15:04.670
false,false,2110,1991,119,1524,00:00:33.000,2025-04-14 12:02:38.143
false,false,2119,2000,119,251,00:00:33.000,2025-04-14 12:03:08.166
false,false,2127,2007,120,506,00:00:30.000,2025-04-14 12:03:24.177
false,false,2130,2010,120,602,00:00:31.000,2025-04-14 12:03:30.181
false,false,2141,2021,120,124,00:00:30.000,2025-04-14 12:04:04.200
false,false,2142,2022,120,154,00:00:30.000,2025-04-14 12:04:06.202
false,false,2157,2035,122,629,00:00:33.000,2025-04-14 12:04:36.221
false,false,2166,2043,123,124,00:00:30.000,2025-04-14 12:05:18.253
false,false,2472,2334,138,253,00:00:31.000,2025-04-14 12:18:42.829
false,false,2498,2359,139,1070,00:00:31.000,2025-04-14 12:19:34.853
false,false,2510,2368,142,1454,00:00:33.000,2025-04-14 12:19:58.871
false,false,2533,2391,142,725,00:00:31.000,2025-04-14 12:20:56.909
false,false,2540,2398,142,946,00:00:31.000,2025-04-14 12:21:10.922
false,false,2544,2402,142,1076,00:00:33.000,2025-04-14 12:21:18.930
false,false,2550,2406,144,1270,00:00:33.000,2025-04-14 12:21:30.941
false,false,2553,2408,145,1365,00:00:31.000,2025-04-14 12:21:36.946
false,false,2567,2421,146,1808,00:00:30.000,2025-04-14 12:22:04.973
false,true,2567,2421,146,0,00:00:00.000,2025-04-14 12:22:08.978
false,true,2588,2441,147,0,00:00:00.000,2025-04-14 12:23:07.021
false,false,2593,2445,148,161,00:00:32.000,2025-04-14 12:23:21.032
false,false,2599,2451,148,346,00:00:30.000,2025-04-14 12:23:33.039
false,false,2604,2455,149,508,00:00:32.000,2025-04-14 12:23:43.045
false,false,2628,2478,150,569,00:00:33.000,2025-04-14 12:24:55.097
false,true,2742,2580,162,0,00:00:00.000,2025-04-14 12:29:49.321
false,false,2745,2583,162,94,00:00:32.000,2025-04-14 12:30:01.330
false,false,2746,2584,162,125,00:00:31.000,2025-04-14 12:30:03.332
false,true,2751,2589,162,0,00:00:00.000,2025-04-14 12:30:19.343
false,false,2753,2591,162,63,00:00:32.000,2025-04-14 12:30:29.351
false,false,2757,2594,163,189,00:00:31.000,2025-04-14 12:30:37.357
false,false,2670,2513,157,317,00:00:33.000,2025-04-14 12:26:31.162
false,true,2674,2517,157,0,00:00:00.000,2025-04-14 12:26:45.176
false,false,2679,2521,158,162,00:00:31.000,2025-04-14 12:27:01.190
false,false,2682,2524,158,260,00:00:33.000,2025-04-14 12:27:07.194
false,false,2685,2527,158,356,00:00:32.000,2025-04-14 12:27:13.198
false,false,2700,2541,159,828,00:00:31.000,2025-04-14 12:27:43.224
false,false,2704,2545,159,955,00:00:33.000,2025-04-14 12:27:51.231
false,false,2708,2549,159,30,00:00:30.000,2025-04-14 12:28:11.248
false,false,2721,2559,162,430,00:00:30.000,2025-04-14 12:28:37.270
false,false,2788,2624,164,438,00:00:30.000,2025-04-14 12:32:27.431
false,false,2802,2637,165,95,00:00:33.000,2025-04-14 12:33:07.463
false,false,2840,2673,167,348,00:00:33.000,2025-04-14 12:34:47.532
false,false,2847,2680,167,572,00:00:32.000,2025-04-14 12:35:01.544
false,true,2850,2683,167,0,00:00:00.000,2025-04-14 12:35:09.552
false,true,2850,2683,167,0,00:00:00.000,2025-04-14 12:35:17.559
false,false,2858,2688,170,221,00:00:31.000,2025-04-14 12:35:47.577
false,false,2870,2700,170,599,00:00:32.000,2025-04-14 12:36:11.592
false,false,2874,2704,170,33,00:00:33.000,2025-04-14 12:36:31.605
false,false,8057,7578,479,692,00:00:30.000,2025-04-15 12:01:31.135
false,false,8062,7582,480,850,00:00:31.000,2025-04-15 12:01:36.140
false,false,8063,7582,481,881,00:00:31.000,2025-04-15 12:01:37.141
false,false,8068,7586,482,1035,00:00:31.000,2025-04-15 12:01:42.146
false,false,8148,7662,486,847,00:00:33.000,2025-04-15 12:04:02.287
false,false,8151,7665,486,945,00:00:32.000,2025-04-15 12:04:05.290
false,false,8152,7666,486,975,00:00:30.000,2025-04-15 12:04:06.292
false,true,8158,7672,486,0,00:00:00.000,2025-04-15 12:04:18.306
false,false,8160,7674,486,62,00:00:30.000,2025-04-15 12:04:20.310
false,false,8168,7681,487,317,00:00:30.000,2025-04-15 12:04:28.317
false,false,8190,7703,487,1006,00:00:30.000,2025-04-15 12:04:50.343
false,false,8075,7593,482,126,00:00:31.000,2025-04-15 12:02:01.161
false,false,8080,7597,483,286,00:00:31.000,2025-04-15 12:02:06.167
false,false,8096,7612,484,158,00:00:32.000,2025-04-15 12:02:34.191
false,true,8119,7635,484,0,00:00:00.000,2025-04-15 12:03:10.232
false,true,8119,7635,484,0,00:00:00.000,2025-04-15 12:03:11.233
false,false,8121,7637,484,62,00:00:32.000,2025-04-15 12:03:17.238
false,true,7936,7461,475,0,00:00:00.000,2025-04-15 11:58:44.968
false,false,7954,7479,475,161,00:00:32.000,2025-04-15 11:59:18.002
false,false,7956,7481,475,224,00:00:30.000,2025-04-15 11:59:20.004
false,false,7957,7482,475,255,00:00:31.000,2025-04-15 11:59:21.005
false,false,8299,7805,494,1593,00:00:30.000,2025-04-15 12:07:09.474
false,false,8310,7814,496,196,00:00:33.000,2025-04-15 12:07:26.489
false,false,8311,7815,496,228,00:00:32.000,2025-04-15 12:07:27.490
false,false,8324,7828,496,639,00:00:30.000,2025-04-15 12:07:40.504
false,false,8340,7844,496,314,00:00:31.000,2025-04-15 12:08:08.526
false,false,8373,7875,498,529,00:00:30.000,2025-04-15 12:08:53.570
false,false,8390,7890,500,1059,00:00:33.000,2025-04-15 12:09:10.586
false,false,8407,7906,501,377,00:00:33.000,2025-04-15 12:09:33.606
false,true,8412,7911,501,0,00:00:00.000,2025-04-15 12:09:56.629
false,false,8416,7915,501,128,00:00:33.000,2025-04-15 12:10:00.630
false,true,8463,7961,502,0,00:00:00.000,2025-04-15 12:11:07.695
false,false,8469,7967,502,187,00:00:31.000,2025-04-15 12:11:17.705
false,false,8480,7977,503,530,00:00:32.000,2025-04-15 12:11:28.716
false,false,8490,7987,503,32,00:00:32.000,2025-04-15 12:11:44.736
false,false,8495,7992,503,189,00:00:31.000,2025-04-15 12:11:49.740
false,true,8206,7718,488,0,00:00:00.000,2025-04-15 12:05:15.360
false,false,8222,7733,489,500,00:00:32.000,2025-04-15 12:05:34.379
false,false,8227,7737,490,658,00:00:31.000,2025-04-15 12:05:39.386
false,false,8228,7738,490,691,00:00:33.000,2025-04-15 12:05:40.388
false,true,8232,7741,491,0,00:00:00.000,2025-04-15 12:05:45.391
false,false,8236,7745,491,126,00:00:31.000,2025-04-15 12:05:54.400
false,false,8255,7762,493,216,00:00:30.000,2025-04-15 12:06:25.427
false,false,8259,7766,493,342,00:00:32.000,2025-04-15 12:06:29.431
false,false,8265,7772,493,532,00:00:30.000,2025-04-15 12:06:35.437
false,false,8266,7773,493,562,00:00:30.000,2025-04-15 12:06:36.439
false,true,8578,8073,505,0,00:00:00.000,2025-04-15 12:13:33.844
false,true,8587,8081,506,0,00:00:00.000,2025-04-15 12:13:56.862
false,true,8594,8087,507,0,00:00:00.000,2025-04-15 12:14:05.870
false,true,8594,8087,507,0,00:00:00.000,2025-04-15 12:14:09.875
false,false,8604,8095,509,313,00:00:30.000,2025-04-15 12:14:26.893
false,false,8607,8098,509,405,00:00:30.000,2025-04-15 12:14:29.895
false,false,8619,8110,509,784,00:00:33.000,2025-04-15 12:14:41.907
false,true,8705,8191,514,0,00:00:00.000,2025-04-15 12:17:03.043
false,true,8705,8191,514,0,00:00:00.000,2025-04-15 12:17:05.045
false,false,8706,8192,514,30,00:00:30.000,2025-04-15 12:17:09.051
false,false,8718,8203,515,403,00:00:32.000,2025-04-15 12:17:21.060
false,false,8729,8214,515,756,00:00:32.000,2025-04-15 12:17:32.069
false,false,8738,8221,517,1038,00:00:32.000,2025-04-15 12:17:41.079
false,false,8743,8226,517,1196,00:00:30.000,2025-04-15 12:17:46.085
false,false,8761,8243,518,345,00:00:31.000,2025-04-15 12:18:10.112
false,true,8774,8256,518,0,00:00:00.000,2025-04-15 12:18:26.129
false,true,8686,8173,513,0,00:00:00.000,2025-04-15 12:16:27.008
false,true,8686,8173,513,0,00:00:00.000,2025-04-15 12:16:28.009
false,true,8686,8173,513,0,00:00:00.000,2025-04-15 12:16:32.014
false,false,8512,8008,504,726,00:00:32.000,2025-04-15 12:12:06.758
false,false,8517,8012,505,123,00:00:30.000,2025-04-15 12:12:17.768
false,true,8546,8041,505,0,00:00:00.000,2025-04-15 12:12:53.804
false,true,8546,8041,505,0,00:00:00.000,2025-04-15 12:12:57.808
false,false,8560,8055,505,438,00:00:31.000,2025-04-15 12:13:12.823
false,false,8790,8271,519,126,00:00:33.000,2025-04-15 12:18:51.153
false,false,8798,8279,519,378,00:00:33.000,2025-04-15 12:18:59.157
false,true,8799,8280,519,0,00:00:00.000,2025-04-15 12:19:06.162
false,false,8828,8306,522,341,00:00:31.000,2025-04-15 12:19:47.212
false,true,8840,8317,523,0,00:00:00.000,2025-04-15 12:20:02.226
false,false,8927,8397,530,937,00:00:30.000,2025-04-15 12:22:08.362
false,true,8964,8433,531,0,00:00:00.000,2025-04-15 12:22:54.407
false,false,8852,8328,524,379,00:00:32.000,2025-04-15 12:20:17.245
false,true,8855,8331,524,0,00:00:00.000,2025-04-15 12:20:25.253
false,false,8856,8332,524,31,00:00:31.000,2025-04-15 12:20:27.255
false,false,8857,8333,524,64,00:00:33.000,2025-04-15 12:20:28.257
false,false,8859,8335,524,130,00:00:33.000,2025-04-15 12:20:30.258
false,false,8885,8356,529,946,00:00:30.000,2025-04-15 12:20:56.288
false,true,8886,8357,529,0,00:00:00.000,2025-04-15 12:20:59.289
false,true,8890,8361,529,0,00:00:00.000,2025-04-15 12:21:11.306
false,true,8892,8363,529,0,00:00:00.000,2025-04-15 12:21:18.312
false,true,8892,8363,529,0,00:00:00.000,2025-04-15 12:21:19.314
false,true,8893,8364,529,0,00:00:00.000,2025-04-15 12:21:28.320
false,true,8897,8368,529,0,00:00:00.000,2025-04-15 12:21:37.328
false,false,9241,8689,552,1043,00:00:32.000,2025-04-15 12:28:34.738
false,false,9253,8701,552,156,00:00:30.000,2025-04-15 12:29:04.768
false,false,9267,8712,555,221,00:00:31.000,2025-04-15 12:29:24.791
false,true,9277,8721,556,0,00:00:00.000,2025-04-15 12:29:45.816
false,false,9288,8731,557,348,00:00:31.000,2025-04-15 12:29:57.827
false,true,9289,8732,557,0,00:00:00.000,2025-04-15 12:30:02.831
false,false,9074,8536,538,544,00:00:31.000,2025-04-15 12:25:17.538
false,false,9096,8554,542,1240,00:00:30.000,2025-04-15 12:25:39.562
false,false,9119,8575,544,1958,00:00:33.000,2025-04-15 12:26:02.581
false,false,9120,8576,544,1989,00:00:31.000,2025-04-15 12:26:03.581
false,false,9134,8590,544,2424,00:00:32.000,2025-04-15 12:26:17.597
false,false,9137,8593,544,2516,00:00:30.000,2025-04-15 12:26:20.599
false,false,9150,8605,545,2926,00:00:33.000,2025-04-15 12:26:33.611
false,false,9151,8606,545,2957,00:00:31.000,2025-04-15 12:26:34.613
false,false,9158,8613,545,185,00:00:30.000,2025-04-15 12:26:47.626
false,false,9161,8616,545,278,00:00:31.000,2025-04-15 12:26:50.629
false,false,9180,8632,548,376,00:00:30.000,2025-04-15 12:27:21.657
false,false,9186,8638,548,567,00:00:31.000,2025-04-15 12:27:27.662
false,false,9202,8653,549,374,00:00:32.000,2025-04-15 12:27:49.686
false,false,9232,8680,552,755,00:00:33.000,2025-04-15 12:28:25.729
false,true,9354,8793,561,0,00:00:00.000,2025-04-15 12:31:38.919
false,true,9364,8802,562,0,00:00:00.000,2025-04-15 12:31:57.940
false,true,9368,8806,562,0,00:00:00.000,2025-04-15 12:32:10.954
false,false,9383,8821,562,411,00:00:31.000,2025-04-15 12:32:38.984
false,false,9392,8830,562,258,00:00:33.000,2025-04-15 12:32:54.002
false,true,9401,8839,562,0,00:00:00.000,2025-04-15 12:33:05.014
false,true,9028,8493,535,0,00:00:00.000,2025-04-15 12:24:17.482
false,false,9055,8518,537,343,00:00:33.000,2025-04-15 12:24:52.514
false,true,9057,8520,537,0,00:00:00.000,2025-04-15 12:24:57.519
false,false,9484,8920,564,223,00:00:33.000,2025-04-15 12:34:56.132
false,false,9497,8932,565,629,00:00:32.000,2025-04-15 12:35:09.145
false,false,9510,8942,568,287,00:00:32.000,2025-04-15 12:35:28.164
false,true,9512,8944,568,0,00:00:00.000,2025-04-15 12:35:31.166
false,false,9513,8945,568,31,00:00:31.000,2025-04-15 12:35:37.170
false,false,9524,8955,569,374,00:00:31.000,2025-04-15 12:35:48.181
false,false,9527,8958,569,467,00:00:31.000,2025-04-15 12:35:51.187
false,false,9539,8968,571,844,00:00:33.000,2025-04-15 12:36:03.198
false,false,9548,8976,572,1128,00:00:32.000,2025-04-15 12:36:12.205
false,true,9553,8981,572,0,00:00:00.000,2025-04-15 12:36:32.227
false,false,9563,8991,572,313,00:00:33.000,2025-04-15 12:36:45.240
false,false,9581,9008,573,878,00:00:30.000,2025-04-15 12:37:03.258
false,true,9581,9008,573,0,00:00:00.000,2025-04-15 12:37:09.266
false,false,9589,9016,573,256,00:00:32.000,2025-04-15 12:37:17.275
false,false,9599,9025,574,571,00:00:30.000,2025-04-15 12:37:27.287
false,true,9601,9027,574,0,00:00:00.000,2025-04-15 12:37:35.296
false,false,9614,9039,575,409,00:00:31.000,2025-04-15 12:37:48.307
false,false,9615,9040,575,440,00:00:31.000,2025-04-15 12:37:49.309
false,false,9620,9045,575,594,00:00:30.000,2025-04-15 12:37:54.312
false,false,9634,9059,575,1040,00:00:33.000,2025-04-15 12:38:08.327
false,false,9412,8850,562,350,00:00:30.000,2025-04-15 12:33:26.038
false,false,9420,8857,563,607,00:00:33.000,2025-04-15 12:33:34.049
false,false,9423,8860,563,703,00:00:33.000,2025-04-15 12:33:37.052
false,true,9428,8865,563,0,00:00:00.000,2025-04-15 12:33:46.063
false,false,9440,8877,563,378,00:00:32.000,2025-04-15 12:34:00.080
false,false,9455,8892,563,849,00:00:30.000,2025-04-15 12:34:15.093
false,true,9476,8912,564,0,00:00:00.000,2025-04-15 12:34:37.114
false,true,9649,9074,575,0,00:00:00.000,2025-04-15 12:38:29.354
false,false,9661,9084,577,378,00:00:31.000,2025-04-15 12:38:41.367
false,false,9693,9114,579,33,00:00:33.000,2025-04-15 12:39:25.414
false,false,9700,9119,581,255,00:00:33.000,2025-04-15 12:39:32.423
false,false,9704,9123,581,94,00:00:30.000,2025-04-15 12:39:42.434
false,false,9705,9124,581,125,00:00:31.000,2025-04-15 12:39:43.436
false,false,1609,1514,95,686,00:00:31.000,2025-04-14 11:39:07.103
false,true,1614,1518,96,0,00:00:00.000,2025-04-14 11:39:29.123
false,false,1620,1523,97,64,00:00:31.000,2025-04-14 11:39:53.139
false,true,1626,1529,97,0,00:00:00.000,2025-04-14 11:40:15.154
false,false,1636,1538,98,313,00:00:31.000,2025-04-14 11:40:37.178
false,false,1652,1554,98,813,00:00:30.000,2025-04-14 11:41:09.202
false,false,1812,1707,105,473,00:00:31.000,2025-04-14 11:49:05.541
false,false,1816,1711,105,599,00:00:32.000,2025-04-14 11:49:13.548
false,true,1816,1711,105,0,00:00:00.000,2025-04-14 11:49:25.557
false,false,1835,1727,108,599,00:00:30.000,2025-04-14 11:50:03.579
false,false,1839,1731,108,721,00:00:30.000,2025-04-14 11:50:11.586
false,false,1863,1753,110,689,00:00:30.000,2025-04-14 11:51:23.642
false,false,1878,1767,111,1152,00:00:30.000,2025-04-14 11:51:53.664
false,true,1959,1844,115,0,00:00:00.000,2025-04-14 11:56:47.885
false,false,1974,1858,116,477,00:00:32.000,2025-04-14 11:57:17.908
false,false,1989,1873,116,377,00:00:33.000,2025-04-14 11:57:59.939
false,false,1991,1875,116,440,00:00:33.000,2025-04-14 11:58:03.944
false,false,1767,1663,104,129,00:00:33.000,2025-04-14 11:46:23.429
false,true,1779,1675,104,0,00:00:00.000,2025-04-14 11:47:45.487
false,true,1880,1769,111,0,00:00:00.000,2025-04-14 11:52:13.673
false,false,1887,1775,112,221,00:00:31.000,2025-04-14 11:52:35.689
false,false,1895,1782,113,32,00:00:32.000,2025-04-14 11:53:03.710
false,false,1898,1785,113,126,00:00:32.000,2025-04-14 11:53:09.714
false,false,1909,1796,113,220,00:00:33.000,2025-04-14 11:53:43.743
false,false,1919,1806,113,535,00:00:33.000,2025-04-14 11:54:03.760
false,true,1926,1812,114,0,00:00:00.000,2025-04-14 11:54:33.782
false,false,1927,1813,114,32,00:00:32.000,2025-04-14 11:54:43.789
false,false,1928,1814,114,64,00:00:32.000,2025-04-14 11:54:45.789
false,false,1937,1823,114,348,00:00:33.000,2025-04-14 11:55:03.799
false,false,1938,1824,114,380,00:00:32.000,2025-04-14 11:55:05.801
false,true,1668,1569,99,0,00:00:00.000,2025-04-14 11:42:17.252
false,false,1689,1587,102,657,00:00:30.000,2025-04-14 11:42:59.280
false,false,1698,1596,102,941,00:00:30.000,2025-04-14 11:43:17.295
false,false,1699,1597,102,973,00:00:32.000,2025-04-14 11:43:19.296
false,false,1703,1601,102,121,00:00:30.000,2025-04-14 11:43:39.315
false,false,1732,1628,104,472,00:00:33.000,2025-04-14 11:44:49.365
false,false,2298,2168,130,250,00:00:30.000,2025-04-14 12:10:30.470
false,false,2302,2172,130,375,00:00:30.000,2025-04-14 12:10:38.476
false,false,2314,2184,130,311,00:00:32.000,2025-04-14 12:11:14.496
false,false,2326,2196,130,692,00:00:31.000,2025-04-14 12:11:38.518
false,false,2181,2058,123,594,00:00:31.000,2025-04-14 12:05:48.274
false,false,2183,2060,123,660,00:00:33.000,2025-04-14 12:05:52.275
false,true,2185,2061,124,0,00:00:00.000,2025-04-14 12:06:04.282
false,false,2189,2064,125,127,00:00:32.000,2025-04-14 12:06:16.291
false,false,2190,2065,125,157,00:00:30.000,2025-04-14 12:06:18.292
false,false,2253,2124,129,2146,00:00:31.000,2025-04-14 12:08:24.373
false,false,2257,2128,129,2273,00:00:30.000,2025-04-14 12:08:32.376
false,false,2015,1898,117,371,00:00:30.000,2025-04-14 11:59:03.991
false,false,2021,1904,117,563,00:00:31.000,2025-04-14 11:59:15.996
false,false,2026,1909,117,720,00:00:33.000,2025-04-14 11:59:26.004
false,false,2035,1917,118,1003,00:00:31.000,2025-04-14 11:59:44.018
false,true,2042,1924,118,0,00:00:00.000,2025-04-14 12:00:08.039
false,false,2044,1926,118,62,00:00:31.000,2025-04-14 12:00:14.042
false,false,2060,1942,118,568,00:00:33.000,2025-04-14 12:00:46.067
false,false,2076,1957,119,447,00:00:33.000,2025-04-14 12:01:30.099
false,false,2082,1963,119,639,00:00:33.000,2025-04-14 12:01:42.102
false,false,2084,1965,119,701,00:00:30.000,2025-04-14 12:01:46.105
false,false,2090,1971,119,892,00:00:33.000,2025-04-14 12:01:58.113
false,false,2412,2277,135,156,00:00:32.000,2025-04-14 12:15:42.696
false,true,2455,2317,138,0,00:00:00.000,2025-04-14 12:17:54.800
false,false,2339,2208,131,1111,00:00:33.000,2025-04-14 12:12:04.537
false,false,2344,2213,131,126,00:00:30.000,2025-04-14 12:12:26.550
false,true,2348,2217,131,0,00:00:00.000,2025-04-14 12:12:52.569
false,false,2359,2228,131,346,00:00:31.000,2025-04-14 12:13:20.585
false,false,2360,2229,131,32,00:00:32.000,2025-04-14 12:13:34.598
false,true,2387,2253,134,0,00:00:00.000,2025-04-14 12:14:40.650
false,false,2391,2257,134,123,00:00:32.000,2025-04-14 12:14:48.659
false,false,2400,2266,134,409,00:00:30.000,2025-04-14 12:15:06.672
false,false,2091,1972,119,923,00:00:31.000,2025-04-14 12:02:00.114
false,true,2111,1992,119,0,00:00:00.000,2025-04-14 12:02:46.151
false,false,2112,1993,119,32,00:00:32.000,2025-04-14 12:02:54.155
false,false,2125,2005,120,443,00:00:32.000,2025-04-14 12:03:20.175
false,false,2153,2032,121,502,00:00:30.000,2025-04-14 12:04:28.214
false,true,2158,2036,122,0,00:00:00.000,2025-04-14 12:04:40.224
false,false,2490,2351,139,821,00:00:31.000,2025-04-14 12:19:18.847
false,false,2521,2379,142,345,00:00:32.000,2025-04-14 12:20:32.894
false,false,2538,2396,142,883,00:00:32.000,2025-04-14 12:21:06.918
false,false,2557,2411,146,1490,00:00:30.000,2025-04-14 12:21:44.953
false,false,2562,2416,146,1651,00:00:30.000,2025-04-14 12:21:54.964
false,true,2588,2441,147,0,00:00:00.000,2025-04-14 12:23:01.016
false,false,2608,2458,150,633,00:00:32.000,2025-04-14 12:23:51.052
false,false,2617,2467,150,217,00:00:33.000,2025-04-14 12:24:33.081
false,false,2619,2469,150,282,00:00:33.000,2025-04-14 12:24:37.086
false,true,2738,2576,162,0,00:00:00.000,2025-04-14 12:29:27.305
false,true,2738,2576,162,0,00:00:00.000,2025-04-14 12:29:33.309
false,true,2751,2589,162,0,00:00:00.000,2025-04-14 12:30:15.340
false,true,2751,2589,162,0,00:00:00.000,2025-04-14 12:30:25.347
false,false,2768,2605,163,320,00:00:30.000,2025-04-14 12:31:23.393
false,false,2770,2607,163,380,00:00:30.000,2025-04-14 12:31:27.394
false,true,2772,2609,163,0,00:00:00.000,2025-04-14 12:31:39.403
false,true,2772,2609,163,0,00:00:00.000,2025-04-14 12:31:41.404
false,true,2774,2611,163,0,00:00:00.000,2025-04-14 12:31:55.411
false,false,2641,2489,152,974,00:00:32.000,2025-04-14 12:25:21.114
false,false,2645,2493,152,1101,00:00:32.000,2025-04-14 12:25:29.119
false,false,2650,2495,155,1259,00:00:33.000,2025-04-14 12:25:39.125
false,false,2657,2501,156,1480,00:00:31.000,2025-04-14 12:25:53.136
false,false,2660,2504,156,1576,00:00:32.000,2025-04-14 12:25:59.140
false,false,2673,2516,157,411,00:00:32.000,2025-04-14 12:26:37.168
false,false,2690,2532,158,515,00:00:32.000,2025-04-14 12:27:23.208
false,false,2693,2535,158,607,00:00:32.000,2025-04-14 12:27:29.214
false,false,2696,2538,158,705,00:00:33.000,2025-04-14 12:27:35.219
false,false,2702,2543,159,891,00:00:33.000,2025-04-14 12:27:47.228
false,true,2707,2548,159,0,00:00:00.000,2025-04-14 12:28:09.248
false,false,2795,2631,164,659,00:00:33.000,2025-04-14 12:32:41.443
false,false,2813,2646,167,441,00:00:30.000,2025-04-14 12:33:29.476
false,false,2821,2654,167,699,00:00:33.000,2025-04-14 12:33:45.486
false,true,2821,2654,167,0,00:00:00.000,2025-04-14 12:33:51.488
false,true,2850,2683,167,0,00:00:00.000,2025-04-14 12:35:11.554
false,false,2852,2684,168,32,00:00:32.000,2025-04-14 12:35:35.571
false,false,2868,2698,170,535,00:00:30.000,2025-04-14 12:36:07.587
false,true,2873,2703,170,0,00:00:00.000,2025-04-14 12:36:19.597
false,false,8069,7587,482,1067,00:00:32.000,2025-04-15 12:01:43.147
false,true,8070,7588,482,0,00:00:00.000,2025-04-15 12:01:45.149
false,false,8128,7643,485,218,00:00:33.000,2025-04-15 12:03:42.268
false,false,8131,7646,485,313,00:00:32.000,2025-04-15 12:03:45.271
false,false,8142,7656,486,656,00:00:31.000,2025-04-15 12:03:56.282
false,false,8146,7660,486,782,00:00:31.000,2025-04-15 12:04:00.285
false,false,8149,7663,486,880,00:00:33.000,2025-04-15 12:04:03.289
false,false,8165,7678,487,221,00:00:33.000,2025-04-15 12:04:25.314
false,false,8175,7688,487,538,00:00:31.000,2025-04-15 12:04:35.324
false,false,8184,7697,487,817,00:00:32.000,2025-04-15 12:04:44.337
false,false,8185,7698,487,850,00:00:33.000,2025-04-15 12:04:45.338
false,false,8196,7709,487,32,00:00:32.000,2025-04-15 12:05:02.355
false,false,8200,7713,487,155,00:00:30.000,2025-04-15 12:05:06.356
false,false,8074,7592,482,95,00:00:33.000,2025-04-15 12:02:00.161
false,false,8077,7595,482,192,00:00:33.000,2025-04-15 12:02:03.163
false,true,8087,7604,483,0,00:00:00.000,2025-04-15 12:02:15.175
false,true,8091,7607,484,0,00:00:00.000,2025-04-15 12:02:27.184
false,true,8100,7616,484,0,00:00:00.000,2025-04-15 12:02:42.204
false,false,8101,7617,484,30,00:00:30.000,2025-04-15 12:02:45.209
false,false,8102,7618,484,62,00:00:32.000,2025-04-15 12:02:46.210
false,true,7936,7461,475,0,00:00:00.000,2025-04-15 11:58:43.967
false,true,7936,7461,475,0,00:00:00.000,2025-04-15 11:58:46.970
false,false,7963,7488,475,445,00:00:31.000,2025-04-15 11:59:27.012
false,false,7966,7491,475,544,00:00:33.000,2025-04-15 11:59:30.016
false,false,7973,7497,476,63,00:00:31.000,2025-04-15 11:59:43.032
false,false,7976,7499,477,159,00:00:33.000,2025-04-15 11:59:46.035
false,false,7978,7501,477,223,00:00:32.000,2025-04-15 11:59:48.036
false,false,7984,7506,478,409,00:00:32.000,2025-04-15 11:59:54.043
false,false,8283,7789,494,1092,00:00:32.000,2025-04-15 12:06:53.459
false,false,8306,7810,496,66,00:00:33.000,2025-04-15 12:07:22.486
false,false,8327,7831,496,63,00:00:30.000,2025-04-15 12:07:49.510
false,false,8339,7843,496,283,00:00:32.000,2025-04-15 12:08:07.526
false,true,8341,7845,496,0,00:00:00.000,2025-04-15 12:08:15.535
false,false,8371,7873,498,467,00:00:31.000,2025-04-15 12:08:51.567
false,false,8383,7883,500,840,00:00:30.000,2025-04-15 12:09:03.578
false,false,8392,7892,500,1122,00:00:33.000,2025-04-15 12:09:12.587
false,false,8402,7902,500,222,00:00:32.000,2025-04-15 12:09:28.602
false,false,8408,7907,501,410,00:00:33.000,2025-04-15 12:09:34.608
false,true,8411,7910,501,0,00:00:00.000,2025-04-15 12:09:44.617
false,true,8428,7926,502,0,00:00:00.000,2025-04-15 12:10:16.647
false,false,8434,7932,502,187,00:00:31.000,2025-04-15 12:10:24.655
false,false,8441,7939,502,412,00:00:33.000,2025-04-15 12:10:31.662
false,true,8442,7940,502,0,00:00:00.000,2025-04-15 12:10:35.664
false,true,8442,7940,502,0,00:00:00.000,2025-04-15 12:10:38.669
false,true,8463,7961,502,0,00:00:00.000,2025-04-15 12:11:09.699
false,false,8214,7726,488,251,00:00:33.000,2025-04-15 12:05:26.371
false,false,8247,7755,492,32,00:00:32.000,2025-04-15 12:06:11.415
false,true,8248,7756,492,0,00:00:00.000,2025-04-15 12:06:16.418
false,true,8248,7756,492,0,00:00:00.000,2025-04-15 12:06:17.419
false,true,8587,8081,506,0,00:00:00.000,2025-04-15 12:13:52.858
false,false,8589,8083,506,64,00:00:33.000,2025-04-15 12:13:59.865
false,true,8594,8087,507,0,00:00:00.000,2025-04-15 12:14:07.872
false,false,8595,8088,507,31,00:00:31.000,2025-04-15 12:14:17.881
false,false,8601,8093,508,221,00:00:30.000,2025-04-15 12:14:23.888
false,false,8606,8097,509,375,00:00:30.000,2025-04-15 12:14:28.894
false,false,8611,8102,509,531,00:00:31.000,2025-04-15 12:14:33.899
false,false,8623,8114,509,908,00:00:30.000,2025-04-15 12:14:45.910
false,false,8695,8182,513,93,00:00:31.000,2025-04-15 12:16:52.032
false,false,8710,8195,515,154,00:00:32.000,2025-04-15 12:17:13.054
false,false,8776,8258,518,64,00:00:32.000,2025-04-15 12:18:31.133
false,false,8653,8141,512,64,00:00:33.000,2025-04-15 12:15:33.955
false,false,8655,8143,512,127,00:00:30.000,2025-04-15 12:15:35.957
false,false,8656,8144,512,157,00:00:30.000,2025-04-15 12:15:36.958
false,false,8668,8156,512,380,00:00:30.000,2025-04-15 12:15:54.974
false,true,8686,8173,513,0,00:00:00.000,2025-04-15 12:16:35.016
false,false,8689,8176,513,94,00:00:30.000,2025-04-15 12:16:40.022
false,false,8694,8181,513,62,00:00:30.000,2025-04-15 12:16:51.030
false,false,8499,7995,504,317,00:00:30.000,2025-04-15 12:11:53.747
false,false,8525,8020,505,378,00:00:33.000,2025-04-15 12:12:25.773
false,false,8528,8023,505,61,00:00:31.000,2025-04-15 12:12:34.782
false,false,8533,8028,505,222,00:00:33.000,2025-04-15 12:12:39.788
false,false,8537,8032,505,346,00:00:31.000,2025-04-15 12:12:43.792
false,false,8543,8038,505,535,00:00:30.000,2025-04-15 12:12:49.800
false,false,8551,8046,505,155,00:00:32.000,2025-04-15 12:13:03.813
false,true,8786,8267,519,0,00:00:00.000,2025-04-15 12:18:44.144
false,true,8786,8267,519,0,00:00:00.000,2025-04-15 12:18:47.147
false,false,8797,8278,519,345,00:00:30.000,2025-04-15 12:18:58.157
false,true,8799,8280,519,0,00:00:00.000,2025-04-15 12:19:01.158
false,true,8799,8280,519,0,00:00:00.000,2025-04-15 12:19:02.158
false,false,8802,8283,519,62,00:00:32.000,2025-04-15 12:19:15.176
false,false,8822,8301,521,154,00:00:32.000,2025-04-15 12:19:41.206
false,false,8823,8302,521,185,00:00:31.000,2025-04-15 12:19:42.206
false,false,8928,8398,530,970,00:00:33.000,2025-04-15 12:22:09.363
false,false,8940,8409,531,1347,00:00:33.000,2025-04-15 12:22:21.373
false,false,8945,8414,531,1505,00:00:32.000,2025-04-15 12:22:26.378
false,false,8976,8443,533,380,00:00:31.000,2025-04-15 12:23:09.421
false,false,8994,8461,533,937,00:00:33.000,2025-04-15 12:23:27.439
false,false,8998,8465,533,1065,00:00:30.000,2025-04-15 12:23:31.442
false,false,8866,8340,526,347,00:00:30.000,2025-04-15 12:20:37.268
false,true,8892,8363,529,0,00:00:00.000,2025-04-15 12:21:16.309
false,true,8897,8368,529,0,00:00:00.000,2025-04-15 12:21:36.325
false,false,8904,8374,530,219,00:00:31.000,2025-04-15 12:21:45.336
false,false,8910,8380,530,406,00:00:32.000,2025-04-15 12:21:51.345
false,true,9241,8689,552,0,00:00:00.000,2025-04-15 12:28:35.740
false,false,9245,8693,552,62,00:00:30.000,2025-04-15 12:28:50.754
false,true,9248,8696,552,0,00:00:00.000,2025-04-15 12:28:58.762
false,false,9276,8720,556,505,00:00:30.000,2025-04-15 12:29:33.801
false,true,9277,8721,556,0,00:00:00.000,2025-04-15 12:29:39.809
false,true,9277,8721,556,0,00:00:00.000,2025-04-15 12:29:43.813
false,false,9285,8729,556,253,00:00:31.000,2025-04-15 12:29:54.822
false,true,9289,8732,557,0,00:00:00.000,2025-04-15 12:30:03.833
false,false,9072,8534,538,481,00:00:31.000,2025-04-15 12:25:15.536
false,false,9077,8539,538,637,00:00:32.000,2025-04-15 12:25:20.539
false,false,9099,8557,542,1333,00:00:33.000,2025-04-15 12:25:42.565
false,false,9131,8587,544,2330,00:00:33.000,2025-04-15 12:26:14.594
false,false,9132,8588,544,2360,00:00:30.000,2025-04-15 12:26:15.595
false,false,9133,8589,544,2392,00:00:32.000,2025-04-15 12:26:16.596
false,true,9152,8607,545,0,00:00:00.000,2025-04-15 12:26:38.616
false,true,9208,8659,549,0,00:00:00.000,2025-04-15 12:27:59.697
false,true,9370,8808,562,0,00:00:00.000,2025-04-15 12:32:20.964
false,false,9395,8833,562,354,00:00:33.000,2025-04-15 12:32:57.004
false,false,9399,8837,562,482,00:00:33.000,2025-04-15 12:33:01.008
false,false,9015,8481,534,31,00:00:31.000,2025-04-15 12:24:00.467
false,false,9021,8486,535,221,00:00:30.000,2025-04-15 12:24:06.472
false,false,9024,8489,535,312,00:00:30.000,2025-04-15 12:24:09.476
false,true,9028,8493,535,0,00:00:00.000,2025-04-15 12:24:18.483
false,false,9520,8951,569,250,00:00:32.000,2025-04-15 12:35:44.177
false,false,9538,8967,571,811,00:00:33.000,2025-04-15 12:36:02.196
false,true,9550,8978,572,0,00:00:00.000,2025-04-15 12:36:15.209
false,true,9550,8978,572,0,00:00:00.000,2025-04-15 12:36:20.214
false,true,9581,9008,573,0,00:00:00.000,2025-04-15 12:37:07.263
false,false,9601,9027,574,634,00:00:33.000,2025-04-15 12:37:29.288
false,true,9601,9027,574,0,00:00:00.000,2025-04-15 12:37:30.290
false,false,9621,9046,575,627,00:00:33.000,2025-04-15 12:37:55.313
false,false,9636,9061,575,1105,00:00:33.000,2025-04-15 12:38:10.329
false,false,9433,8870,563,160,00:00:33.000,2025-04-15 12:33:53.072
false,false,9444,8881,563,509,00:00:33.000,2025-04-15 12:34:04.085
false,false,9475,8911,564,1474,00:00:32.000,2025-04-15 12:34:35.112
false,false,9643,9068,575,1323,00:00:32.000,2025-04-15 12:38:17.343
false,false,9666,9088,578,536,00:00:32.000,2025-04-15 12:38:46.374
false,false,9673,9095,578,757,00:00:30.000,2025-04-15 12:38:53.381
false,false,9689,9110,579,440,00:00:33.000,2025-04-15 12:39:15.401
false,true,9692,9113,579,0,00:00:00.000,2025-04-15 12:39:22.411
false,false,1614,1518,96,839,00:00:32.000,2025-04-14 11:39:17.114
false,true,1618,1521,97,0,00:00:00.000,2025-04-14 11:39:45.134
false,true,1626,1529,97,0,00:00:00.000,2025-04-14 11:40:13.154
false,false,1627,1530,97,30,00:00:30.000,2025-04-14 11:40:19.156
false,false,1654,1556,98,877,00:00:33.000,2025-04-14 11:41:13.205
false,true,1657,1559,98,0,00:00:00.000,2025-04-14 11:41:27.214
false,false,1659,1561,98,66,00:00:33.000,2025-04-14 11:41:35.219
false,false,1662,1564,98,162,00:00:32.000,2025-04-14 11:41:41.224
false,true,1816,1711,105,0,00:00:00.000,2025-04-14 11:49:15.551
false,true,1816,1711,105,0,00:00:00.000,2025-04-14 11:49:17.552
false,false,1838,1730,108,691,00:00:30.000,2025-04-14 11:50:09.584
false,true,1841,1732,109,0,00:00:00.000,2025-04-14 11:50:33.603
false,false,1865,1755,110,753,00:00:33.000,2025-04-14 11:51:27.645
false,true,1950,1835,115,0,00:00:00.000,2025-04-14 11:55:39.832
false,false,1953,1838,115,64,00:00:32.000,2025-04-14 11:56:11.853
false,true,1959,1844,115,0,00:00:00.000,2025-04-14 11:56:39.877
false,false,1963,1847,116,126,00:00:32.000,2025-04-14 11:56:55.892
false,false,1971,1855,116,380,00:00:31.000,2025-04-14 11:57:11.903
false,true,1763,1659,104,0,00:00:00.000,2025-04-14 11:46:13.423
false,false,1775,1671,104,65,00:00:33.000,2025-04-14 11:46:51.450
false,true,1776,1672,104,0,00:00:00.000,2025-04-14 11:46:57.455
false,true,1776,1672,104,0,00:00:00.000,2025-04-14 11:46:59.457
false,true,1777,1673,104,0,00:00:00.000,2025-04-14 11:47:09.463
false,true,1777,1673,104,0,00:00:00.000,2025-04-14 11:47:11.466
false,false,1782,1678,104,91,00:00:31.000,2025-04-14 11:47:53.490
false,false,1795,1691,104,510,00:00:33.000,2025-04-14 11:48:19.510
false,true,1797,1693,104,0,00:00:00.000,2025-04-14 11:48:33.521
false,true,1880,1769,111,0,00:00:00.000,2025-04-14 11:52:03.668
false,false,1890,1777,113,317,00:00:30.000,2025-04-14 11:52:41.695
false,false,1939,1825,114,412,00:00:32.000,2025-04-14 11:55:07.804
false,false,1668,1569,99,30,00:00:30.000,2025-04-14 11:42:05.243
false,false,1672,1571,101,126,00:00:33.000,2025-04-14 11:42:25.259
false,false,1673,1572,101,157,00:00:31.000,2025-04-14 11:42:27.260
false,false,1685,1584,101,530,00:00:33.000,2025-04-14 11:42:51.275
false,true,1699,1597,102,0,00:00:00.000,2025-04-14 11:43:29.305
false,true,1699,1597,102,0,00:00:00.000,2025-04-14 11:43:31.308
false,false,1709,1607,102,307,00:00:32.000,2025-04-14 11:43:51.323
false,true,1717,1615,102,0,00:00:00.000,2025-04-14 11:44:19.344
false,false,1718,1616,102,30,00:00:30.000,2025-04-14 11:44:21.346
false,false,1725,1622,103,254,00:00:31.000,2025-04-14 11:44:35.355
false,false,1736,1632,104,600,00:00:32.000,2025-04-14 11:44:57.368
false,false,1744,1640,104,855,00:00:33.000,2025-04-14 11:45:13.385
false,true,2258,2129,129,0,00:00:00.000,2025-04-14 12:08:44.384
false,false,2271,2142,129,412,00:00:30.000,2025-04-14 12:09:12.407
false,true,2278,2149,129,0,00:00:00.000,2025-04-14 12:09:28.421
false,false,2281,2152,129,97,00:00:33.000,2025-04-14 12:09:44.429
false,true,2290,2161,129,0,00:00:00.000,2025-04-14 12:10:08.449
false,false,2303,2173,130,406,00:00:31.000,2025-04-14 12:10:40.478
false,false,2334,2203,131,954,00:00:32.000,2025-04-14 12:11:54.529
false,false,2180,2057,123,563,00:00:31.000,2025-04-14 12:05:46.272
false,false,2191,2066,125,188,00:00:31.000,2025-04-14 12:06:20.293
false,false,2211,2084,127,820,00:00:31.000,2025-04-14 12:07:00.317
false,false,2223,2095,128,1199,00:00:32.000,2025-04-14 12:07:24.333
false,false,2230,2102,128,1415,00:00:32.000,2025-04-14 12:07:38.342
false,false,2236,2108,128,1604,00:00:33.000,2025-04-14 12:07:50.348
false,false,2009,1892,117,188,00:00:32.000,2025-04-14 11:58:51.983
false,false,2014,1897,117,341,00:00:30.000,2025-04-14 11:59:01.989
false,false,2027,1910,117,753,00:00:33.000,2025-04-14 11:59:28.005
false,false,2063,1944,119,30,00:00:30.000,2025-04-14 12:01:04.083
false,false,2071,1952,119,288,00:00:33.000,2025-04-14 12:01:20.097
false,true,2435,2298,137,0,00:00:00.000,2025-04-14 12:16:34.735
false,false,2454,2316,138,93,00:00:30.000,2025-04-14 12:17:42.792
false,true,2464,2326,138,0,00:00:00.000,2025-04-14 12:18:16.813
false,true,2464,2326,138,0,00:00:00.000,2025-04-14 12:18:24.817
false,true,2347,2216,131,0,00:00:00.000,2025-04-14 12:12:38.558
false,false,2384,2251,133,798,00:00:33.000,2025-04-14 12:14:22.635
false,false,2395,2261,134,251,00:00:31.000,2025-04-14 12:14:56.663
false,true,2111,1992,119,0,00:00:00.000,2025-04-14 12:02:52.153
false,false,2150,2029,121,409,00:00:33.000,2025-04-14 12:04:22.212
false,false,2156,2034,122,596,00:00:30.000,2025-04-14 12:04:34.220
false,false,2165,2042,123,94,00:00:31.000,2025-04-14 12:05:16.249
false,false,2473,2335,138,286,00:00:33.000,2025-04-14 12:18:44.832
false,false,2534,2392,142,755,00:00:30.000,2025-04-14 12:20:58.911
false,false,2535,2393,142,787,00:00:32.000,2025-04-14 12:21:00.912
false,false,2551,2406,145,1303,00:00:33.000,2025-04-14 12:21:32.943
false,false,2566,2420,146,1778,00:00:31.000,2025-04-14 12:22:02.973
false,true,2567,2421,146,0,00:00:00.000,2025-04-14 12:22:16.983
false,false,2614,2464,150,123,00:00:30.000,2025-04-14 12:24:27.078
false,false,2618,2468,150,249,00:00:32.000,2025-04-14 12:24:35.083
false,false,2732,2570,162,776,00:00:30.000,2025-04-14 12:28:59.287
false,false,2739,2577,162,31,00:00:31.000,2025-04-14 12:29:37.310
false,false,2744,2582,162,62,00:00:32.000,2025-04-14 12:29:59.328
false,false,2748,2586,162,189,00:00:32.000,2025-04-14 12:30:07.335
false,true,2751,2589,162,0,00:00:00.000,2025-04-14 12:30:21.344
false,false,2769,2606,163,350,00:00:30.000,2025-04-14 12:31:25.394
false,true,2774,2611,163,0,00:00:00.000,2025-04-14 12:31:49.407
false,false,2663,2507,156,94,00:00:30.000,2025-04-14 12:26:17.152
false,true,2674,2517,157,0,00:00:00.000,2025-04-14 12:26:43.173
false,false,2680,2522,158,195,00:00:33.000,2025-04-14 12:27:03.191
false,false,2712,2552,160,153,00:00:33.000,2025-04-14 12:28:19.255
false,false,2713,2553,160,186,00:00:33.000,2025-04-14 12:28:21.255
false,false,2717,2556,161,308,00:00:30.000,2025-04-14 12:28:29.264
false,false,2783,2619,164,284,00:00:31.000,2025-04-14 12:32:17.427
false,false,2789,2625,164,468,00:00:30.000,2025-04-14 12:32:29.432
false,false,2792,2628,164,561,00:00:30.000,2025-04-14 12:32:35.437
false,false,2808,2641,167,286,00:00:33.000,2025-04-14 12:33:19.469
false,false,2816,2649,167,536,00:00:30.000,2025-04-14 12:33:35.478
false,true,2821,2654,167,0,00:00:00.000,2025-04-14 12:33:49.487
false,false,2833,2666,167,124,00:00:31.000,2025-04-14 12:34:33.521
false,false,2842,2675,167,410,00:00:30.000,2025-04-14 12:34:51.533
false,false,2855,2686,169,126,00:00:30.000,2025-04-14 12:35:41.574
false,false,2864,2694,170,409,00:00:32.000,2025-04-14 12:35:59.584
false,false,2880,2710,170,124,00:00:31.000,2025-04-14 12:36:55.621
false,false,8156,7670,486,1105,00:00:32.000,2025-04-15 12:04:10.295
false,false,8177,7690,487,598,00:00:30.000,2025-04-15 12:04:37.327
false,false,8189,7702,487,976,00:00:31.000,2025-04-15 12:04:49.343
false,false,8073,7591,482,62,00:00:30.000,2025-04-15 12:01:59.159
false,false,8079,7597,482,255,00:00:30.000,2025-04-15 12:02:05.166
false,false,8092,7608,484,31,00:00:31.000,2025-04-15 12:02:30.187
false,false,7925,7450,475,1738,00:00:32.000,2025-04-15 11:58:30.951
false,false,7928,7453,475,1833,00:00:30.000,2025-04-15 11:58:33.954
false,false,7932,7457,475,1958,00:00:31.000,2025-04-15 11:58:37.959
false,false,7938,7463,475,62,00:00:31.000,2025-04-15 11:58:49.974
false,false,7944,7469,475,64,00:00:33.000,2025-04-15 11:59:01.987
false,true,7993,7515,478,0,00:00:00.000,2025-04-15 12:00:08.053
false,false,8290,7796,494,1313,00:00:32.000,2025-04-15 12:07:00.462
false,false,8292,7798,494,1375,00:00:31.000,2025-04-15 12:07:02.464
false,false,8301,7807,494,1655,00:00:31.000,2025-04-15 12:07:11.475
false,true,8325,7829,496,0,00:00:00.000,2025-04-15 12:07:46.508
false,true,8330,7834,496,0,00:00:00.000,2025-04-15 12:07:58.517
false,false,8403,7903,500,252,00:00:30.000,2025-04-15 12:09:29.602
false,true,8412,7911,501,0,00:00:00.000,2025-04-15 12:09:51.625
false,false,8417,7916,501,158,00:00:30.000,2025-04-15 12:10:01.633
false,false,8460,7958,502,225,00:00:32.000,2025-04-15 12:11:02.691
false,false,8464,7962,502,32,00:00:32.000,2025-04-15 12:11:12.702
false,false,8476,7974,502,406,00:00:30.000,2025-04-15 12:11:24.711
false,false,8478,7976,502,468,00:00:31.000,2025-04-15 12:11:26.714
false,false,8481,7978,503,563,00:00:33.000,2025-04-15 12:11:29.717
false,true,8489,7986,503,0,00:00:00.000,2025-04-15 12:11:39.731
false,false,8225,7736,489,595,00:00:31.000,2025-04-15 12:05:37.382
false,false,8263,7770,493,472,00:00:32.000,2025-04-15 12:06:33.435
false,false,8267,7774,493,594,00:00:32.000,2025-04-15 12:06:37.441
false,false,8275,7782,493,842,00:00:32.000,2025-04-15 12:06:45.450
false,false,8580,8075,505,61,00:00:31.000,2025-04-15 12:13:38.847
false,false,8594,8087,507,223,00:00:33.000,2025-04-15 12:14:04.869
false,false,8598,8091,507,125,00:00:32.000,2025-04-15 12:14:20.886
false,false,8614,8105,509,622,00:00:30.000,2025-04-15 12:14:36.902
false,false,8638,8126,512,409,00:00:33.000,2025-04-15 12:15:06.929
false,false,8698,8185,513,186,00:00:32.000,2025-04-15 12:16:55.035
false,false,8719,8204,515,436,00:00:33.000,2025-04-15 12:17:22.061
false,false,8730,8215,515,787,00:00:31.000,2025-04-15 12:17:33.070
false,false,8747,8229,518,1321,00:00:30.000,2025-04-15 12:17:50.091
false,false,8752,8234,518,61,00:00:31.000,2025-04-15 12:18:01.104
false,false,8753,8235,518,94,00:00:33.000,2025-04-15 12:18:02.105
false,false,8644,8132,512,157,00:00:31.000,2025-04-15 12:15:18.940
false,false,8670,8158,512,444,00:00:33.000,2025-04-15 12:15:56.976
false,false,8672,8160,512,505,00:00:30.000,2025-04-15 12:15:58.977
false,false,8676,8164,512,61,00:00:30.000,2025-04-15 12:16:14.995
false,false,8680,8167,513,186,00:00:31.000,2025-04-15 12:16:18.999
false,true,8686,8173,513,0,00:00:00.000,2025-04-15 12:16:31.012
false,false,8687,8174,513,33,00:00:33.000,2025-04-15 12:16:38.019
false,true,8526,8021,505,0,00:00:00.000,2025-04-15 12:12:30.777
false,true,8546,8041,505,0,00:00:00.000,2025-04-15 12:12:54.805
false,false,8548,8043,505,62,00:00:30.000,2025-04-15 12:13:00.810
false,false,8563,8058,505,530,00:00:30.000,2025-04-15 12:13:15.826
false,false,8569,8064,505,723,00:00:33.000,2025-04-15 12:13:21.834
false,true,8800,8281,519,0,00:00:00.000,2025-04-15 12:19:12.173
false,false,8813,8292,521,409,00:00:31.000,2025-04-15 12:19:26.189
false,false,8838,8315,523,657,00:00:31.000,2025-04-15 12:19:57.221
false,false,8920,8390,530,718,00:00:30.000,2025-04-15 12:22:01.354
false,false,8933,8403,530,1128,00:00:31.000,2025-04-15 12:22:14.368
false,false,8934,8404,530,1161,00:00:33.000,2025-04-15 12:22:15.369
false,false,8935,8405,530,1191,00:00:30.000,2025-04-15 12:22:16.370
false,false,8954,8423,531,1792,00:00:31.000,2025-04-15 12:22:35.386
false,false,8964,8433,531,246,00:00:32.000,2025-04-15 12:22:51.405
false,false,8968,8435,533,128,00:00:30.000,2025-04-15 12:23:01.412
false,false,8978,8445,533,444,00:00:33.000,2025-04-15 12:23:11.422
false,false,8883,8355,528,885,00:00:33.000,2025-04-15 12:20:54.286
false,true,8886,8357,529,0,00:00:00.000,2025-04-15 12:20:58.289
false,true,8890,8361,529,0,00:00:00.000,2025-04-15 12:21:08.301
false,true,8893,8364,529,0,00:00:00.000,2025-04-15 12:21:24.317
false,true,8897,8368,529,0,00:00:00.000,2025-04-15 12:21:33.322
false,true,9248,8696,552,0,00:00:00.000,2025-04-15 12:28:54.758
false,false,9269,8714,555,287,00:00:33.000,2025-04-15 12:29:26.794
false,false,9079,8540,539,700,00:00:33.000,2025-04-15 12:25:22.541
false,false,9093,8551,542,1145,00:00:32.000,2025-04-15 12:25:36.558
false,false,9106,8562,544,1551,00:00:30.000,2025-04-15 12:25:49.571
false,false,9123,8579,544,2083,00:00:30.000,2025-04-15 12:26:06.584
false,false,9135,8591,544,2455,00:00:31.000,2025-04-15 12:26:18.597
false,false,9147,8602,545,2828,00:00:30.000,2025-04-15 12:26:30.609
false,false,9149,8604,545,2893,00:00:32.000,2025-04-15 12:26:32.611
false,true,9152,8607,545,0,00:00:00.000,2025-04-15 12:26:37.616
false,true,9152,8607,545,0,00:00:00.000,2025-04-15 12:26:41.620
false,false,9164,8619,545,372,00:00:33.000,2025-04-15 12:26:53.632
false,true,9166,8621,545,0,00:00:00.000,2025-04-15 12:26:58.636
false,true,9166,8621,545,0,00:00:00.000,2025-04-15 12:27:00.639
false,false,9167,8622,545,31,00:00:31.000,2025-04-15 12:27:02.641
false,true,9168,8623,545,0,00:00:00.000,2025-04-15 12:27:04.641
false,false,9179,8631,548,346,00:00:31.000,2025-04-15 12:27:20.656
false,false,9182,8634,548,441,00:00:32.000,2025-04-15 12:27:23.657
false,false,9184,8636,548,506,00:00:32.000,2025-04-15 12:27:25.659
false,false,9200,8652,548,310,00:00:30.000,2025-04-15 12:27:47.684
false,false,9216,8666,550,251,00:00:30.000,2025-04-15 12:28:09.710
false,false,9230,8678,552,692,00:00:30.000,2025-04-15 12:28:23.726
false,false,9235,8683,552,852,00:00:33.000,2025-04-15 12:28:28.732
false,true,9354,8793,561,0,00:00:00.000,2025-04-15 12:31:36.918
false,false,9365,8803,562,31,00:00:31.000,2025-04-15 12:32:02.947
false,false,9380,8818,562,316,00:00:33.000,2025-04-15 12:32:35.979
false,true,9401,8839,562,0,00:00:00.000,2025-04-15 12:33:10.020
false,false,9002,8469,533,1192,00:00:32.000,2025-04-15 12:23:35.447
false,false,9047,8510,537,94,00:00:31.000,2025-04-15 12:24:44.505
false,true,9057,8520,537,0,00:00:00.000,2025-04-15 12:25:00.522
false,false,9501,8933,568,756,00:00:33.000,2025-04-15 12:35:13.150
false,true,9501,8933,568,0,00:00:00.000,2025-04-15 12:35:19.156
false,true,9512,8944,568,0,00:00:00.000,2025-04-15 12:35:35.169
false,false,9516,8948,568,125,00:00:30.000,2025-04-15 12:35:40.174
false,false,9550,8978,572,1190,00:00:32.000,2025-04-15 12:36:14.208
false,false,9553,8981,572,95,00:00:33.000,2025-04-15 12:36:29.223
false,true,9553,8981,572,0,00:00:00.000,2025-04-15 12:36:35.229
false,false,9555,8983,572,63,00:00:31.000,2025-04-15 12:36:37.233
false,false,9585,9012,573,126,00:00:33.000,2025-04-15 12:37:13.271
false,false,9607,9032,575,189,00:00:31.000,2025-04-15 12:37:41.302
false,false,9631,9056,575,944,00:00:30.000,2025-04-15 12:38:05.323
false,false,9405,8843,562,126,00:00:32.000,2025-04-15 12:33:19.029
false,false,9406,8844,562,158,00:00:32.000,2025-04-15 12:33:20.029
false,true,9428,8865,563,0,00:00:00.000,2025-04-15 12:33:44.059
false,false,9438,8875,563,313,00:00:31.000,2025-04-15 12:33:58.079
false,false,9456,8893,563,879,00:00:30.000,2025-04-15 12:34:16.095
false,false,9472,8908,564,1377,00:00:30.000,2025-04-15 12:34:32.110
false,true,9476,8912,564,0,00:00:00.000,2025-04-15 12:34:40.117
false,true,9477,8913,564,0,00:00:00.000,2025-04-15 12:34:44.119
false,false,9342,8781,561,595,00:00:30.000,2025-04-15 12:31:21.907
false,false,9348,8787,561,785,00:00:33.000,2025-04-15 12:31:27.912
false,false,9659,9082,577,314,00:00:31.000,2025-04-15 12:38:39.365
false,false,9662,9084,578,409,00:00:31.000,2025-04-15 12:38:42.368
false,false,9690,9111,579,472,00:00:32.000,2025-04-15 12:39:16.403
false,false,9694,9115,579,64,00:00:31.000,2025-04-15 12:39:26.416
false,false,9702,9121,581,31,00:00:31.000,2025-04-15 12:39:40.432
false,false,9709,9128,581,250,00:00:31.000,2025-04-15 12:39:47.439
false,false,9711,9130,581,311,00:00:31.000,2025-04-15 12:39:49.441
false,false,1605,1510,95,561,00:00:33.000,2025-04-14 11:38:59.096
false,true,1618,1521,97,0,00:00:00.000,2025-04-14 11:39:49.135
false,false,1641,1543,98,469,00:00:32.000,2025-04-14 11:40:47.182
false,false,1642,1544,98,502,00:00:33.000,2025-04-14 11:40:49.183
false,false,1661,1563,98,130,00:00:32.000,2025-04-14 11:41:39.223
false,false,1666,1567,99,286,00:00:30.000,2025-04-14 11:41:49.228
false,true,1667,1568,99,0,00:00:00.000,2025-04-14 11:41:53.231
false,false,1879,1768,111,1182,00:00:30.000,2025-04-14 11:51:55.665
false,false,1946,1832,114,633,00:00:33.000,2025-04-14 11:55:21.816
false,false,1949,1834,115,731,00:00:33.000,2025-04-14 11:55:27.821
false,false,1951,1836,115,33,00:00:33.000,2025-04-14 11:55:55.842
false,false,1970,1854,116,349,00:00:31.000,2025-04-14 11:57:09.901
false,false,1975,1859,116,509,00:00:32.000,2025-04-14 11:57:19.908
false,false,1976,1860,116,541,00:00:32.000,2025-04-14 11:57:21.910
false,true,1977,1861,116,0,00:00:00.000,2025-04-14 11:57:35.921
false,false,1985,1869,116,252,00:00:31.000,2025-04-14 11:57:51.933
false,false,1987,1871,116,314,00:00:32.000,2025-04-14 11:57:55.936
false,false,2000,1883,117,727,00:00:31.000,2025-04-14 11:58:21.958
false,false,2002,1885,117,791,00:00:33.000,2025-04-14 11:58:25.962
false,false,1750,1646,104,1047,00:00:31.000,2025-04-14 11:45:25.394
false,false,1756,1652,104,121,00:00:31.000,2025-04-14 11:45:49.409
false,true,1797,1693,104,0,00:00:00.000,2025-04-14 11:48:29.517
false,true,1902,1789,113,0,00:00:00.000,2025-04-14 11:53:19.722
false,true,1924,1811,113,0,00:00:00.000,2025-04-14 11:54:25.779
false,false,1691,1589,102,721,00:00:32.000,2025-04-14 11:43:03.282
false,false,1716,1614,102,524,00:00:33.000,2025-04-14 11:44:05.334
false,false,1720,1618,102,94,00:00:32.000,2025-04-14 11:44:25.349
false,false,1737,1633,104,631,00:00:31.000,2025-04-14 11:44:59.370
false,false,1746,1642,104,921,00:00:33.000,2025-04-14 11:45:17.388
false,false,2270,2141,129,382,00:00:32.000,2025-04-14 12:09:10.405
false,false,2277,2148,129,598,00:00:30.000,2025-04-14 12:09:24.416
false,false,2290,2161,129,378,00:00:30.000,2025-04-14 12:10:02.445
false,false,2317,2187,130,406,00:00:32.000,2025-04-14 12:11:20.503
false,false,2319,2189,130,471,00:00:33.000,2025-04-14 12:11:24.507
false,false,2329,2199,130,791,00:00:33.000,2025-04-14 12:11:44.521
false,false,2335,2204,131,986,00:00:32.000,2025-04-14 12:11:56.531
false,false,2175,2052,123,408,00:00:32.000,2025-04-14 12:05:36.265
false,false,2188,2063,125,95,00:00:33.000,2025-04-14 12:06:14.289
false,false,2199,2073,126,440,00:00:30.000,2025-04-14 12:06:36.300
false,false,2233,2105,128,1506,00:00:30.000,2025-04-14 12:07:44.343
false,false,2234,2106,128,1539,00:00:33.000,2025-04-14 12:07:46.346
false,false,2029,1912,117,816,00:00:30.000,2025-04-14 11:59:32.008
false,false,2033,1916,117,942,00:00:33.000,2025-04-14 11:59:40.016
false,false,2039,1921,118,1129,00:00:31.000,2025-04-14 11:59:52.025
false,false,2041,1923,118,1191,00:00:30.000,2025-04-14 11:59:56.029
false,true,2042,1924,118,0,00:00:00.000,2025-04-14 12:00:10.039
false,true,2062,1944,118,0,00:00:00.000,2025-04-14 12:01:00.079
false,false,2409,2275,134,61,00:00:31.000,2025-04-14 12:15:36.692
false,false,2423,2288,135,502,00:00:30.000,2025-04-14 12:16:04.712
false,false,2425,2290,135,568,00:00:33.000,2025-04-14 12:16:08.716
false,false,2427,2292,135,631,00:00:31.000,2025-04-14 12:16:12.719
false,false,2428,2293,135,664,00:00:33.000,2025-04-14 12:16:14.720
false,false,2434,2298,136,854,00:00:31.000,2025-04-14 12:16:26.731
false,false,2442,2304,138,218,00:00:30.000,2025-04-14 12:16:54.753
false,false,2443,2305,138,251,00:00:33.000,2025-04-14 12:16:56.755
false,false,2449,2311,138,441,00:00:33.000,2025-04-14 12:17:08.763
false,false,2340,2209,131,1143,00:00:32.000,2025-04-14 12:12:06.539
false,true,2340,2209,131,0,00:00:00.000,2025-04-14 12:12:08.542
false,true,2348,2217,131,0,00:00:00.000,2025-04-14 12:12:48.565
false,true,2348,2217,131,0,00:00:00.000,2025-04-14 12:12:56.571
false,true,2348,2217,131,0,00:00:00.000,2025-04-14 12:12:58.571
false,false,2349,2218,131,30,00:00:30.000,2025-04-14 12:13:00.574
false,true,2359,2228,131,0,00:00:00.000,2025-04-14 12:13:30.597
false,false,2362,2231,131,98,00:00:33.000,2025-04-14 12:13:38.600
false,false,2370,2238,132,353,00:00:32.000,2025-04-14 12:13:54.610
false,false,2387,2253,134,892,00:00:30.000,2025-04-14 12:14:28.642
false,false,2100,1981,119,1209,00:00:31.000,2025-04-14 12:02:18.128
false,false,2102,1983,119,1271,00:00:32.000,2025-04-14 12:02:22.129
false,true,2111,1992,119,0,00:00:00.000,2025-04-14 12:02:48.151
false,false,2117,1998,119,188,00:00:32.000,2025-04-14 12:03:04.163
false,true,2162,2040,122,0,00:00:00.000,2025-04-14 12:05:04.245
false,false,2471,2333,138,222,00:00:33.000,2025-04-14 12:18:40.829
false,false,2486,2347,139,694,00:00:33.000,2025-04-14 12:19:10.843
false,false,2493,2354,139,913,00:00:31.000,2025-04-14 12:19:24.850
false,true,2510,2368,142,0,00:00:00.000,2025-04-14 12:20:06.876
false,false,2513,2371,142,93,00:00:33.000,2025-04-14 12:20:16.880
false,false,2563,2417,146,1682,00:00:31.000,2025-04-14 12:21:56.966
false,false,2565,2419,146,1747,00:00:33.000,2025-04-14 12:22:00.970
false,true,2567,2421,146,0,00:00:00.000,2025-04-14 12:22:14.983
false,false,2570,2423,147,95,00:00:32.000,2025-04-14 12:22:22.987
false,true,2588,2441,147,0,00:00:00.000,2025-04-14 12:23:09.023
false,false,2607,2457,150,601,00:00:30.000,2025-04-14 12:23:49.051
false,true,2608,2458,150,0,00:00:00.000,2025-04-14 12:23:55.056
false,true,2610,2460,150,0,00:00:00.000,2025-04-14 12:24:15.073
false,false,2627,2477,150,536,00:00:32.000,2025-04-14 12:24:53.096
false,false,2630,2479,151,631,00:00:30.000,2025-04-14 12:24:59.101
false,false,2635,2483,152,787,00:00:30.000,2025-04-14 12:25:09.108
false,false,2729,2567,162,686,00:00:33.000,2025-04-14 12:28:53.282
false,true,2733,2571,162,0,00:00:00.000,2025-04-14 12:29:13.294
false,false,2738,2576,162,157,00:00:30.000,2025-04-14 12:29:23.302
false,true,2751,2589,162,0,00:00:00.000,2025-04-14 12:30:23.345
false,false,2771,2608,163,413,00:00:33.000,2025-04-14 12:31:29.395
false,true,2774,2611,163,0,00:00:00.000,2025-04-14 12:31:57.413
false,true,2707,2548,159,0,00:00:00.000,2025-04-14 12:28:03.243
false,true,2707,2548,159,0,00:00:00.000,2025-04-14 12:28:07.247
false,false,2787,2623,164,408,00:00:33.000,2025-04-14 12:32:25.431
false,false,2790,2626,164,501,00:00:33.000,2025-04-14 12:32:31.434
false,true,2799,2635,164,0,00:00:00.000,2025-04-14 12:33:01.458
false,true,2876,2706,170,0,00:00:00.000,2025-04-14 12:36:41.614
false,true,2876,2706,170,0,00:00:00.000,2025-04-14 12:36:45.617
false,true,8121,7637,484,0,00:00:00.000,2025-04-15 12:03:35.259
false,false,8133,7648,485,374,00:00:30.000,2025-04-15 12:03:47.272
false,false,8141,7656,485,625,00:00:31.000,2025-04-15 12:03:55.281
false,true,8158,7672,486,0,00:00:00.000,2025-04-15 12:04:16.305
false,false,8161,7675,486,95,00:00:33.000,2025-04-15 12:04:21.311
false,false,8183,7696,487,785,00:00:31.000,2025-04-15 12:04:43.336
false,true,8071,7589,482,0,00:00:00.000,2025-04-15 12:01:52.154
false,false,8090,7606,484,96,00:00:31.000,2025-04-15 12:02:22.178
false,false,8105,7621,484,157,00:00:33.000,2025-04-15 12:02:49.211
false,false,8119,7635,484,347,00:00:31.000,2025-04-15 12:03:09.230
false,true,8121,7637,484,0,00:00:00.000,2025-04-15 12:03:19.241
false,false,7929,7454,475,1865,00:00:32.000,2025-04-15 11:58:34.956
false,false,7935,7460,475,2054,00:00:32.000,2025-04-15 11:58:40.965
false,true,7949,7474,475,0,00:00:00.000,2025-04-15 11:59:09.992
false,false,7971,7495,476,701,00:00:30.000,2025-04-15 11:59:35.023
false,true,7993,7515,478,0,00:00:00.000,2025-04-15 12:00:04.049
false,true,7993,7515,478,0,00:00:00.000,2025-04-15 12:00:05.050
false,true,8304,7810,494,0,00:00:00.000,2025-04-15 12:07:20.484
false,false,8305,7810,495,33,00:00:33.000,2025-04-15 12:07:21.484
false,false,8308,7812,496,130,00:00:32.000,2025-04-15 12:07:24.488
false,false,8313,7817,496,291,00:00:31.000,2025-04-15 12:07:29.492
false,true,8325,7829,496,0,00:00:00.000,2025-04-15 12:07:44.507
false,false,8337,7841,496,220,00:00:30.000,2025-04-15 12:08:05.522
false,true,8341,7845,496,0,00:00:00.000,2025-04-15 12:08:13.534
false,false,8357,7860,497,30,00:00:30.000,2025-04-15 12:08:37.555
false,false,8363,7866,497,213,00:00:32.000,2025-04-15 12:08:43.561
false,false,8385,7885,500,901,00:00:30.000,2025-04-15 12:09:05.580
false,false,8398,7898,500,92,00:00:31.000,2025-04-15 12:09:24.600
false,false,8399,7899,500,125,00:00:33.000,2025-04-15 12:09:25.601
false,false,8410,7909,501,30,00:00:30.000,2025-04-15 12:09:42.616
false,true,8411,7910,501,0,00:00:00.000,2025-04-15 12:09:48.621
false,false,8422,7920,502,318,00:00:33.000,2025-04-15 12:10:06.639
false,false,8442,7940,502,442,00:00:30.000,2025-04-15 12:10:32.663
false,false,8444,7942,502,64,00:00:33.000,2025-04-15 12:10:40.670
false,false,8452,7950,502,317,00:00:31.000,2025-04-15 12:10:48.676
false,false,8457,7955,502,129,00:00:33.000,2025-04-15 12:10:59.689
false,false,8468,7966,502,156,00:00:30.000,2025-04-15 12:11:16.705
false,false,8474,7972,502,345,00:00:32.000,2025-04-15 12:11:22.709
false,false,8491,7988,503,64,00:00:32.000,2025-04-15 12:11:45.737
false,false,8211,7723,488,158,00:00:32.000,2025-04-15 12:05:23.369
false,false,8229,7739,490,721,00:00:30.000,2025-04-15 12:05:41.388
false,false,8234,7743,491,64,00:00:33.000,2025-04-15 12:05:52.399
false,true,8246,7754,492,0,00:00:00.000,2025-04-15 12:06:09.413
false,false,8253,7761,492,156,00:00:31.000,2025-04-15 12:06:23.426
false,true,8580,8075,505,0,00:00:00.000,2025-04-15 12:13:40.847
false,true,8587,8081,506,0,00:00:00.000,2025-04-15 12:13:57.862
false,true,8594,8087,507,0,00:00:00.000,2025-04-15 12:14:10.876
false,false,8605,8096,509,345,00:00:32.000,2025-04-15 12:14:27.893
false,false,8634,8123,511,285,00:00:31.000,2025-04-15 12:15:02.925
false,true,8639,8127,512,0,00:00:00.000,2025-04-15 12:15:10.934
false,false,8723,8208,515,565,00:00:33.000,2025-04-15 12:17:26.064
false,false,8726,8211,515,660,00:00:31.000,2025-04-15 12:17:29.066
false,false,8728,8213,515,724,00:00:31.000,2025-04-15 12:17:31.069
false,false,8736,8220,516,976,00:00:32.000,2025-04-15 12:17:39.077
false,false,8764,8246,518,438,00:00:32.000,2025-04-15 12:18:13.116
false,true,8774,8256,518,0,00:00:00.000,2025-04-15 12:18:28.130
false,true,8639,8127,512,0,00:00:00.000,2025-04-15 12:15:12.936
false,false,8651,8139,512,377,00:00:31.000,2025-04-15 12:15:25.949
false,false,8671,8159,512,475,00:00:31.000,2025-04-15 12:15:57.977
false,true,8672,8160,512,0,00:00:00.000,2025-04-15 12:16:00.980
false,false,8677,8164,513,94,00:00:33.000,2025-04-15 12:16:15.996
false,false,8501,7997,504,379,00:00:31.000,2025-04-15 12:11:55.749
false,false,8507,8003,504,569,00:00:31.000,2025-04-15 12:12:01.752
false,false,8519,8014,505,187,00:00:31.000,2025-04-15 12:12:19.770
false,false,8522,8017,505,280,00:00:32.000,2025-04-15 12:12:22.771
false,true,8526,8021,505,0,00:00:00.000,2025-04-15 12:12:31.780
false,false,8534,8029,505,252,00:00:30.000,2025-04-15 12:12:40.789
false,false,8535,8030,505,285,00:00:33.000,2025-04-15 12:12:41.790
false,false,8536,8031,505,315,00:00:30.000,2025-04-15 12:12:42.791
false,false,8547,8042,505,32,00:00:32.000,2025-04-15 12:12:59.810
false,false,8549,8044,505,92,00:00:30.000,2025-04-15 12:13:01.811
false,false,8783,8264,519,289,00:00:33.000,2025-04-15 12:18:38.139
false,false,8787,8268,519,30,00:00:30.000,2025-04-15 12:18:48.149
false,true,8800,8281,519,0,00:00:00.000,2025-04-15 12:19:10.170
false,false,8810,8290,520,312,00:00:33.000,2025-04-15 12:19:23.187
false,false,8816,8295,521,502,00:00:30.000,2025-04-15 12:19:29.192
false,false,8925,8395,530,874,00:00:30.000,2025-04-15 12:22:06.360
false,false,8930,8400,530,1032,00:00:32.000,2025-04-15 12:22:11.365
false,false,8951,8420,531,1696,00:00:32.000,2025-04-15 12:22:32.384
false,true,8956,8425,531,0,00:00:00.000,2025-04-15 12:22:39.392
false,false,8975,8442,533,349,00:00:32.000,2025-04-15 12:23:08.421
false,false,8979,8446,533,474,00:00:30.000,2025-04-15 12:23:12.424
false,false,8982,8449,533,564,00:00:30.000,2025-04-15 12:23:15.426
false,false,8987,8454,533,717,00:00:30.000,2025-04-15 12:23:20.431
false,true,8855,8331,524,0,00:00:00.000,2025-04-15 12:20:24.251
false,false,8861,8335,526,194,00:00:31.000,2025-04-15 12:20:32.261
false,false,8870,8344,526,471,00:00:30.000,2025-04-15 12:20:41.272
false,false,8880,8353,527,787,00:00:31.000,2025-04-15 12:20:51.282
false,true,8892,8363,529,0,00:00:00.000,2025-04-15 12:21:17.310
false,false,8894,8365,529,33,00:00:33.000,2025-04-15 12:21:29.320
false,true,8897,8368,529,0,00:00:00.000,2025-04-15 12:21:38.329
false,false,8899,8370,529,60,00:00:30.000,2025-04-15 12:21:40.331
false,false,8906,8376,530,282,00:00:31.000,2025-04-15 12:21:47.340
false,false,9239,8687,552,978,00:00:32.000,2025-04-15 12:28:32.738
false,false,9246,8694,552,94,00:00:32.000,2025-04-15 12:28:51.755
false,false,9251,8699,552,93,00:00:32.000,2025-04-15 12:29:02.766
false,false,9257,8705,552,282,00:00:33.000,2025-04-15 12:29:08.773
false,false,9270,8715,555,317,00:00:30.000,2025-04-15 12:29:27.795
false,false,9103,8560,543,1458,00:00:32.000,2025-04-15 12:25:46.569
false,false,9157,8612,545,155,00:00:30.000,2025-04-15 12:26:46.625
false,false,9174,8627,547,189,00:00:32.000,2025-04-15 12:27:15.653
false,true,9190,8642,548,0,00:00:00.000,2025-04-15 12:27:32.667
false,false,9198,8650,548,248,00:00:32.000,2025-04-15 12:27:45.681
false,false,9212,8663,549,127,00:00:33.000,2025-04-15 12:28:05.705
false,false,9222,8670,552,442,00:00:32.000,2025-04-15 12:28:15.716
false,false,9231,8679,552,722,00:00:30.000,2025-04-15 12:28:24.728
false,false,9233,8681,552,786,00:00:31.000,2025-04-15 12:28:26.730
false,true,9354,8793,561,0,00:00:00.000,2025-04-15 12:31:41.921
false,true,9354,8793,561,0,00:00:00.000,2025-04-15 12:31:45.927
false,false,9360,8799,561,190,00:00:33.000,2025-04-15 12:31:51.934
false,true,9368,8806,562,0,00:00:00.000,2025-04-15 12:32:14.957
false,false,9387,8825,562,96,00:00:32.000,2025-04-15 12:32:48.996
false,false,9396,8834,562,387,00:00:33.000,2025-04-15 12:32:58.005
false,false,9006,8473,533,130,00:00:31.000,2025-04-15 12:23:45.456
false,false,9017,8483,534,95,00:00:32.000,2025-04-15 12:24:02.468
false,false,9033,8497,536,153,00:00:31.000,2025-04-15 12:24:24.488
false,false,9034,8498,536,184,00:00:31.000,2025-04-15 12:24:25.490
false,false,9038,8502,536,312,00:00:32.000,2025-04-15 12:24:29.494
false,false,9040,8504,536,375,00:00:33.000,2025-04-15 12:24:31.494
false,true,9044,8507,537,0,00:00:00.000,2025-04-15 12:24:38.498
false,false,9492,8927,565,472,00:00:30.000,2025-04-15 12:35:04.141
false,false,9503,8935,568,65,00:00:32.000,2025-04-15 12:35:21.158
false,false,9505,8937,568,129,00:00:32.000,2025-04-15 12:35:23.160
false,false,9521,8952,569,283,00:00:33.000,2025-04-15 12:35:45.178
false,false,9528,8958,570,497,00:00:30.000,2025-04-15 12:35:52.188
false,false,9542,8971,571,941,00:00:31.000,2025-04-15 12:36:06.200
false,false,9554,8982,572,32,00:00:32.000,2025-04-15 12:36:36.232
false,false,9582,9009,573,30,00:00:30.000,2025-04-15 12:37:10.268
false,false,9584,9011,573,93,00:00:30.000,2025-04-15 12:37:12.270
false,false,9595,9021,574,444,00:00:32.000,2025-04-15 12:37:23.280
false,false,9619,9044,575,564,00:00:32.000,2025-04-15 12:37:53.312
false,false,9414,8852,562,416,00:00:33.000,2025-04-15 12:33:28.039
false,false,9416,8854,562,480,00:00:31.000,2025-04-15 12:33:30.043
false,false,9424,8861,563,736,00:00:33.000,2025-04-15 12:33:38.054
false,false,9436,8873,563,252,00:00:30.000,2025-04-15 12:33:56.076
false,false,9335,8774,561,380,00:00:33.000,2025-04-15 12:31:14.900
false,false,9642,9067,575,1291,00:00:33.000,2025-04-15 12:38:16.339
false,false,9646,9071,575,1418,00:00:32.000,2025-04-15 12:38:20.345
false,false,9655,9079,576,192,00:00:33.000,2025-04-15 12:38:35.359
false,false,9682,9103,579,217,00:00:33.000,2025-04-15 12:39:08.394
false,false,9686,9107,579,346,00:00:31.000,2025-04-15 12:39:12.399
false,true,9692,9113,579,0,00:00:00.000,2025-04-15 12:39:24.414
false,false,1612,1516,96,777,00:00:30.000,2025-04-14 11:39:13.113
false,true,1614,1518,96,0,00:00:00.000,2025-04-14 11:39:25.120
false,false,1615,1518,97,31,00:00:31.000,2025-04-14 11:39:31.124
false,false,1631,1533,98,156,00:00:33.000,2025-04-14 11:40:27.166
false,false,1648,1550,98,689,00:00:33.000,2025-04-14 11:41:01.193
false,false,1801,1696,105,125,00:00:31.000,2025-04-14 11:48:43.526
false,false,1818,1713,105,64,00:00:31.000,2025-04-14 11:49:29.559
false,false,1831,1724,107,472,00:00:30.000,2025-04-14 11:49:55.575
false,true,1839,1731,108,0,00:00:00.000,2025-04-14 11:50:15.587
false,false,1868,1757,111,843,00:00:30.000,2025-04-14 11:51:33.652
false,false,1870,1759,111,904,00:00:31.000,2025-04-14 11:51:37.653
false,false,1875,1764,111,1056,00:00:30.000,2025-04-14 11:51:47.660
false,true,1950,1835,115,0,00:00:00.000,2025-04-14 11:55:45.835
false,false,1969,1853,116,318,00:00:33.000,2025-04-14 11:57:07.901
false,false,1995,1878,117,569,00:00:31.000,2025-04-14 11:58:11.949
false,false,2001,1884,117,758,00:00:31.000,2025-04-14 11:58:23.960
false,false,1748,1644,104,983,00:00:32.000,2025-04-14 11:45:21.389
false,true,1752,1648,104,0,00:00:00.000,2025-04-14 11:45:31.399
false,false,1766,1662,104,96,00:00:32.000,2025-04-14 11:46:21.426
false,true,1773,1669,104,0,00:00:00.000,2025-04-14 11:46:39.439
false,true,1776,1672,104,0,00:00:00.000,2025-04-14 11:47:01.457
false,false,1780,1676,104,30,00:00:30.000,2025-04-14 11:47:49.489
false,true,1880,1769,111,0,00:00:00.000,2025-04-14 11:52:11.672
false,false,1883,1772,111,92,00:00:32.000,2025-04-14 11:52:27.683
false,false,1894,1781,113,444,00:00:33.000,2025-04-14 11:52:49.698
false,false,1896,1783,113,62,00:00:30.000,2025-04-14 11:53:05.710
false,false,1902,1789,113,253,00:00:31.000,2025-04-14 11:53:17.722
false,false,1917,1804,113,471,00:00:33.000,2025-04-14 11:53:59.757
false,false,1920,1807,113,567,00:00:32.000,2025-04-14 11:54:05.760
false,false,1933,1819,114,222,00:00:31.000,2025-04-14 11:54:55.794
false,false,1715,1613,102,491,00:00:31.000,2025-04-14 11:44:03.333
false,true,1717,1615,102,0,00:00:00.000,2025-04-14 11:44:15.341
false,true,2278,2149,129,0,00:00:00.000,2025-04-14 12:09:32.424
false,false,2286,2157,129,252,00:00:31.000,2025-04-14 12:09:54.439
false,false,2300,2170,130,312,00:00:32.000,2025-04-14 12:10:34.472
false,false,2311,2181,130,217,00:00:30.000,2025-04-14 12:11:08.493
false,false,2318,2188,130,438,00:00:32.000,2025-04-14 12:11:22.505
false,false,2169,2046,123,219,00:00:32.000,2025-04-14 12:05:24.258
false,false,2198,2072,126,410,00:00:33.000,2025-04-14 12:06:34.300
false,false,2207,2080,127,694,00:00:31.000,2025-04-14 12:06:52.311
false,false,2256,2127,129,2243,00:00:32.000,2025-04-14 12:08:30.375
false,false,2010,1893,117,218,00:00:30.000,2025-04-14 11:58:53.984
false,false,2088,1969,119,828,00:00:30.000,2025-04-14 12:01:54.112
false,false,2417,2282,135,314,00:00:33.000,2025-04-14 12:15:52.705
false,false,2419,2284,135,377,00:00:31.000,2025-04-14 12:15:56.709
false,false,2426,2291,135,600,00:00:32.000,2025-04-14 12:16:10.717
false,false,2447,2309,138,376,00:00:32.000,2025-04-14 12:17:04.760
false,true,2449,2311,138,0,00:00:00.000,2025-04-14 12:17:12.766
false,false,2459,2321,138,123,00:00:30.000,2025-04-14 12:18:04.806
false,false,2467,2329,138,96,00:00:31.000,2025-04-14 12:18:32.824
false,false,2347,2216,131,219,00:00:31.000,2025-04-14 12:12:32.552
false,true,2347,2216,131,0,00:00:00.000,2025-04-14 12:12:36.557
false,true,2348,2217,131,0,00:00:00.000,2025-04-14 12:12:54.570
false,false,2367,2235,132,257,00:00:30.000,2025-04-14 12:13:48.607
false,false,2374,2242,132,481,00:00:33.000,2025-04-14 12:14:02.617
false,false,2385,2252,133,831,00:00:33.000,2025-04-14 12:14:24.637
false,true,2387,2253,134,0,00:00:00.000,2025-04-14 12:14:36.647
false,false,2390,2256,134,91,00:00:30.000,2025-04-14 12:14:46.657
false,false,2403,2269,134,507,00:00:32.000,2025-04-14 12:15:12.676
false,true,2111,1992,119,0,00:00:00.000,2025-04-14 12:02:44.149
false,false,2129,2009,120,571,00:00:32.000,2025-04-14 12:03:28.181
false,false,2137,2017,120,819,00:00:31.000,2025-04-14 12:03:44.190
false,false,2138,2018,120,33,00:00:33.000,2025-04-14 12:03:58.196
false,false,2155,2033,122,566,00:00:31.000,2025-04-14 12:04:32.217
false,false,2160,2038,122,64,00:00:31.000,2025-04-14 12:04:54.238
false,false,2494,2355,139,945,00:00:32.000,2025-04-14 12:19:26.849
false,false,2505,2366,139,1289,00:00:31.000,2025-04-14 12:19:48.861
false,false,2511,2369,142,30,00:00:30.000,2025-04-14 12:20:12.879
false,false,2519,2377,142,282,00:00:33.000,2025-04-14 12:20:28.889
false,false,2524,2382,142,436,00:00:31.000,2025-04-14 12:20:38.898
false,false,2526,2384,142,500,00:00:33.000,2025-04-14 12:20:42.899
false,false,2545,2403,142,1109,00:00:33.000,2025-04-14 12:21:20.931
false,false,2568,2421,147,31,00:00:31.000,2025-04-14 12:22:18.983
false,false,2571,2424,147,128,00:00:33.000,2025-04-14 12:22:24.989
false,false,2582,2435,147,478,00:00:32.000,2025-04-14 12:22:47.008
false,false,2588,2441,147,664,00:00:30.000,2025-04-14 12:22:59.015
false,false,2598,2450,148,316,00:00:31.000,2025-04-14 12:23:31.038
false,true,2608,2458,150,0,00:00:00.000,2025-04-14 12:24:03.063
false,false,2736,2574,162,97,00:00:33.000,2025-04-14 12:29:19.299
false,true,2738,2576,162,0,00:00:00.000,2025-04-14 12:29:31.308
false,false,2762,2599,163,128,00:00:30.000,2025-04-14 12:31:11.387
false,false,2774,2611,163,62,00:00:32.000,2025-04-14 12:31:47.407
false,true,2774,2611,163,0,00:00:00.000,2025-04-14 12:31:59.415
false,false,2648,2494,154,1194,00:00:30.000,2025-04-14 12:25:35.120
false,false,2649,2495,154,1226,00:00:32.000,2025-04-14 12:25:37.122
false,true,2674,2517,157,0,00:00:00.000,2025-04-14 12:26:47.177
false,false,2677,2520,157,98,00:00:32.000,2025-04-14 12:26:57.188
false,false,2688,2530,158,450,00:00:31.000,2025-04-14 12:27:19.207
false,false,2786,2622,164,375,00:00:30.000,2025-04-14 12:32:23.429
false,true,2799,2635,164,0,00:00:00.000,2025-04-14 12:32:57.457
false,false,2800,2635,165,31,00:00:31.000,2025-04-14 12:33:03.459
false,false,2814,2647,167,474,00:00:33.000,2025-04-14 12:33:31.477
false,false,2815,2648,167,506,00:00:32.000,2025-04-14 12:33:33.478
false,false,2825,2658,167,126,00:00:33.000,2025-04-14 12:34:05.501
false,true,2829,2662,167,0,00:00:00.000,2025-04-14 12:34:15.510
false,false,2838,2671,167,285,00:00:32.000,2025-04-14 12:34:43.530
false,false,2856,2686,170,159,00:00:33.000,2025-04-14 12:35:43.575
false,false,2861,2691,170,315,00:00:32.000,2025-04-14 12:35:53.579
false,true,2876,2706,170,0,00:00:00.000,2025-04-14 12:36:47.618
false,false,2881,2711,170,154,00:00:30.000,2025-04-14 12:36:57.621
false,true,8070,7588,482,0,00:00:00.000,2025-04-15 12:01:46.149
false,false,8157,7671,486,1138,00:00:33.000,2025-04-15 12:04:11.296
false,true,8158,7672,486,0,00:00:00.000,2025-04-15 12:04:13.299
false,false,8170,7683,487,380,00:00:30.000,2025-04-15 12:04:30.319
false,false,8174,7687,487,507,00:00:33.000,2025-04-15 12:04:34.323
false,true,8195,7708,487,0,00:00:00.000,2025-04-15 12:04:57.350
false,false,8081,7598,483,319,00:00:33.000,2025-04-15 12:02:07.168
false,true,8100,7616,484,0,00:00:00.000,2025-04-15 12:02:40.202
false,true,8100,7616,484,0,00:00:00.000,2025-04-15 12:02:41.203
false,false,8112,7628,484,126,00:00:32.000,2025-04-15 12:03:02.223
false,false,8114,7630,484,189,00:00:33.000,2025-04-15 12:03:04.225
false,true,8121,7637,484,0,00:00:00.000,2025-04-15 12:03:27.251
false,false,7937,7462,475,31,00:00:31.000,2025-04-15 11:58:48.973
false,true,7942,7467,475,0,00:00:00.000,2025-04-15 11:58:59.986
false,false,7943,7468,475,31,00:00:31.000,2025-04-15 11:59:00.987
false,false,7969,7494,475,638,00:00:30.000,2025-04-15 11:59:33.021
false,false,8295,7801,494,1471,00:00:32.000,2025-04-15 12:07:05.471
false,false,8316,7820,496,387,00:00:33.000,2025-04-15 12:07:32.495
false,false,8354,7857,497,406,00:00:30.000,2025-04-15 12:08:28.547
false,false,8360,7863,497,120,00:00:30.000,2025-04-15 12:08:40.557
false,false,8367,7869,498,342,00:00:32.000,2025-04-15 12:08:47.566
false,false,8370,7872,498,436,00:00:31.000,2025-04-15 12:08:50.567
false,false,8376,7877,499,621,00:00:31.000,2025-04-15 12:08:56.574
false,false,8401,7901,500,190,00:00:33.000,2025-04-15 12:09:27.602
false,true,8409,7908,501,0,00:00:00.000,2025-04-15 12:09:40.613
false,false,8414,7913,501,65,00:00:32.000,2025-04-15 12:09:58.629
false,false,8455,7953,502,64,00:00:31.000,2025-04-15 12:10:57.688
false,false,8484,7981,503,654,00:00:30.000,2025-04-15 12:11:32.721
false,false,8217,7728,489,343,00:00:30.000,2025-04-15 12:05:29.375
false,false,8257,7764,493,279,00:00:33.000,2025-04-15 12:06:27.430
false,false,8278,7784,494,934,00:00:30.000,2025-04-15 12:06:48.453
false,true,8578,8073,505,0,00:00:00.000,2025-04-15 12:13:35.845
false,true,8580,8075,505,0,00:00:00.000,2025-04-15 12:13:41.848
false,true,8580,8075,505,0,00:00:00.000,2025-04-15 12:13:43.850
false,true,8594,8087,507,0,00:00:00.000,2025-04-15 12:14:16.880
false,false,8627,8117,510,65,00:00:32.000,2025-04-15 12:14:55.919
false,false,8635,8124,511,315,00:00:30.000,2025-04-15 12:15:03.925
false,false,8704,8190,514,376,00:00:33.000,2025-04-15 12:17:01.041
false,false,8715,8200,515,309,00:00:31.000,2025-04-15 12:17:18.059
false,false,8717,8202,515,371,00:00:31.000,2025-04-15 12:17:20.060
false,false,8721,8206,515,502,00:00:33.000,2025-04-15 12:17:24.061
false,false,8735,8219,516,944,00:00:33.000,2025-04-15 12:17:38.075
false,false,8748,8230,518,1354,00:00:33.000,2025-04-15 12:17:51.092
false,false,8649,8137,512,316,00:00:30.000,2025-04-15 12:15:23.948
false,true,8656,8144,512,0,00:00:00.000,2025-04-15 12:15:40.963
false,true,8656,8144,512,0,00:00:00.000,2025-04-15 12:15:41.964
false,true,8686,8173,513,0,00:00:00.000,2025-04-15 12:16:29.010
false,false,8690,8177,513,126,00:00:32.000,2025-04-15 12:16:41.024
false,false,8691,8178,513,157,00:00:31.000,2025-04-15 12:16:42.025
false,true,8692,8179,513,0,00:00:00.000,2025-04-15 12:16:44.025
false,false,8502,7998,504,411,00:00:32.000,2025-04-15 12:11:56.749
false,false,8530,8025,505,125,00:00:31.000,2025-04-15 12:12:36.783
false,false,8531,8026,505,156,00:00:31.000,2025-04-15 12:12:37.785
false,false,8553,8048,505,220,00:00:32.000,2025-04-15 12:13:05.816
false,false,8573,8068,505,850,00:00:33.000,2025-04-15 12:13:25.838
false,false,8778,8259,519,128,00:00:32.000,2025-04-15 12:18:33.134
false,false,8792,8273,519,190,00:00:31.000,2025-04-15 12:18:53.154
false,true,8800,8281,519,0,00:00:00.000,2025-04-15 12:19:09.168
false,false,8811,8290,521,345,00:00:33.000,2025-04-15 12:19:24.187
false,true,8817,8296,521,0,00:00:00.000,2025-04-15 12:19:31.195
false,true,8817,8296,521,0,00:00:00.000,2025-04-15 12:19:32.196
false,false,8818,8297,521,30,00:00:30.000,2025-04-15 12:19:37.200
false,true,8840,8317,523,0,00:00:00.000,2025-04-15 12:20:05.230
false,false,8912,8382,530,470,00:00:33.000,2025-04-15 12:21:53.347
false,false,8931,8401,530,1065,00:00:33.000,2025-04-15 12:22:12.365
false,false,8953,8422,531,1761,00:00:32.000,2025-04-15 12:22:34.386
false,false,8977,8444,533,411,00:00:31.000,2025-04-15 12:23:10.421
false,false,8990,8457,533,809,00:00:31.000,2025-04-15 12:23:23.436
false,false,8877,8350,527,693,00:00:30.000,2025-04-15 12:20:48.279
false,true,8886,8357,529,0,00:00:00.000,2025-04-15 12:21:03.293
false,true,8890,8361,529,0,00:00:00.000,2025-04-15 12:21:09.302
false,false,8892,8363,529,66,00:00:33.000,2025-04-15 12:21:15.308
false,false,8902,8373,529,155,00:00:31.000,2025-04-15 12:21:43.335
false,true,9241,8689,552,0,00:00:00.000,2025-04-15 12:28:40.746
false,true,9243,8691,552,0,00:00:00.000,2025-04-15 12:28:44.749
false,false,9282,8726,556,156,00:00:32.000,2025-04-15 12:29:51.819
false,false,9287,8730,557,317,00:00:33.000,2025-04-15 12:29:56.825
false,false,9295,8737,558,193,00:00:33.000,2025-04-15 12:30:10.840
false,false,9085,8544,541,890,00:00:31.000,2025-04-15 12:25:28.547
false,false,9090,8549,541,1047,00:00:31.000,2025-04-15 12:25:33.552
false,false,9098,8556,542,1300,00:00:30.000,2025-04-15 12:25:41.563
false,false,9110,8566,544,1676,00:00:31.000,2025-04-15 12:25:53.574
false,false,9129,8585,544,2267,00:00:30.000,2025-04-15 12:26:12.593
false,false,9156,8611,545,125,00:00:30.000,2025-04-15 12:26:45.624
false,false,9159,8614,545,216,00:00:31.000,2025-04-15 12:26:48.628
false,false,9160,8615,545,247,00:00:31.000,2025-04-15 12:26:49.629
false,true,9168,8623,545,0,00:00:00.000,2025-04-15 12:27:05.643
false,true,9168,8623,545,0,00:00:00.000,2025-04-15 12:27:07.644
false,false,9177,8629,548,283,00:00:31.000,2025-04-15 12:27:18.655
false,false,9181,8633,548,409,00:00:33.000,2025-04-15 12:27:22.657
false,false,9196,8648,548,185,00:00:31.000,2025-04-15 12:27:43.679
false,false,9223,8671,552,472,00:00:30.000,2025-04-15 12:28:16.716
false,true,9354,8793,561,0,00:00:00.000,2025-04-15 12:31:34.916
false,true,9364,8802,562,0,00:00:00.000,2025-04-15 12:31:56.939
false,true,9368,8806,562,0,00:00:00.000,2025-04-15 12:32:12.955
false,true,9384,8822,562,0,00:00:00.000,2025-04-15 12:32:40.986
false,true,9384,8822,562,0,00:00:00.000,2025-04-15 12:32:45.993
false,true,9401,8839,562,0,00:00:00.000,2025-04-15 12:33:09.019
false,false,9013,8480,533,346,00:00:31.000,2025-04-15 12:23:52.460
false,true,9014,8481,533,0,00:00:00.000,2025-04-15 12:23:58.467
false,false,9026,8491,535,376,00:00:33.000,2025-04-15 12:24:11.478
false,false,9028,8493,535,440,00:00:32.000,2025-04-15 12:24:13.479
false,false,9031,8495,536,90,00:00:30.000,2025-04-15 12:24:22.486
false,false,9489,8924,565,379,00:00:33.000,2025-04-15 12:35:01.137
false,false,9493,8928,565,503,00:00:31.000,2025-04-15 12:35:05.143
false,false,9495,8930,565,565,00:00:32.000,2025-04-15 12:35:07.144
false,true,9550,8978,572,0,00:00:00.000,2025-04-15 12:36:22.218
false,true,9550,8978,572,0,00:00:00.000,2025-04-15 12:36:25.220
false,true,9601,9027,574,0,00:00:00.000,2025-04-15 12:37:31.292
false,true,9601,9027,574,0,00:00:00.000,2025-04-15 12:37:32.292
false,false,9467,8903,564,1221,00:00:31.000,2025-04-15 12:34:27.104
false,false,9469,8905,564,1284,00:00:31.000,2025-04-15 12:34:29.106
false,true,9476,8912,564,0,00:00:00.000,2025-04-15 12:34:42.118
false,false,9341,8780,561,565,00:00:30.000,2025-04-15 12:31:20.906
false,false,9639,9064,575,1198,00:00:32.000,2025-04-15 12:38:13.335
false,true,9692,9113,579,0,00:00:00.000,2025-04-15 12:39:21.410
false,false,1599,1504,95,376,00:00:30.000,2025-04-14 11:38:47.086
false,false,1619,1522,97,33,00:00:33.000,2025-04-14 11:39:51.137
false,false,1622,1525,97,128,00:00:31.000,2025-04-14 11:39:57.142
false,false,1629,1531,98,93,00:00:30.000,2025-04-14 11:40:23.161
false,false,1653,1555,98,844,00:00:31.000,2025-04-14 11:41:11.202
false,false,1849,1739,110,251,00:00:31.000,2025-04-14 11:50:55.621
false,false,1950,1835,115,761,00:00:30.000,2025-04-14 11:55:29.825
false,true,1950,1835,115,0,00:00:00.000,2025-04-14 11:55:47.836
false,true,1950,1835,115,0,00:00:00.000,2025-04-14 11:55:51.838
false,false,1955,1840,115,127,00:00:31.000,2025-04-14 11:56:15.855
false,false,1967,1851,116,253,00:00:33.000,2025-04-14 11:57:03.898
false,false,1996,1879,117,601,00:00:32.000,2025-04-14 11:58:13.951
false,false,1771,1667,104,256,00:00:32.000,2025-04-14 11:46:31.436
false,true,1779,1675,104,0,00:00:00.000,2025-04-14 11:47:39.485
false,false,1790,1686,104,346,00:00:33.000,2025-04-14 11:48:09.502
false,true,1797,1693,104,0,00:00:00.000,2025-04-14 11:48:27.517
false,false,1891,1778,113,347,00:00:30.000,2025-04-14 11:52:43.696
false,false,1901,1788,113,222,00:00:33.000,2025-04-14 11:53:15.721
false,true,1902,1789,113,0,00:00:00.000,2025-04-14 11:53:25.729
false,false,1913,1800,113,344,00:00:33.000,2025-04-14 11:53:51.749
false,true,1668,1569,99,0,00:00:00.000,2025-04-14 11:42:11.249
false,false,1671,1571,100,93,00:00:31.000,2025-04-14 11:42:23.257
false,false,1675,1574,101,218,00:00:30.000,2025-04-14 11:42:31.264
false,true,1699,1597,102,0,00:00:00.000,2025-04-14 11:43:25.299
false,false,1705,1603,102,181,00:00:30.000,2025-04-14 11:43:43.317
false,false,1713,1611,102,430,00:00:31.000,2025-04-14 11:43:59.329
false,true,1717,1615,102,0,00:00:00.000,2025-04-14 11:44:17.343
false,false,1723,1620,103,190,00:00:33.000,2025-04-14 11:44:31.353
false,false,1735,1631,104,568,00:00:32.000,2025-04-14 11:44:55.367
false,false,1738,1634,104,664,00:00:33.000,2025-04-14 11:45:01.376
false,false,2266,2137,129,254,00:00:31.000,2025-04-14 12:09:02.401
false,false,2284,2155,129,190,00:00:31.000,2025-04-14 12:09:50.435
false,true,2290,2161,129,0,00:00:00.000,2025-04-14 12:10:10.451
false,false,2330,2199,131,823,00:00:32.000,2025-04-14 12:11:46.523
false,false,2332,2201,131,889,00:00:33.000,2025-04-14 12:11:50.526
false,false,2179,2056,123,532,00:00:31.000,2025-04-14 12:05:44.269
false,false,2184,2061,123,693,00:00:33.000,2025-04-14 12:05:54.276
false,true,2185,2061,124,0,00:00:00.000,2025-04-14 12:06:06.283
false,false,2217,2090,127,1012,00:00:33.000,2025-04-14 12:07:12.323
false,false,2222,2094,128,1167,00:00:30.000,2025-04-14 12:07:22.330
false,false,2252,2123,129,2115,00:00:32.000,2025-04-14 12:08:22.372
false,false,2006,1889,117,95,00:00:32.000,2025-04-14 11:58:45.978
false,false,2025,1908,117,687,00:00:31.000,2025-04-14 11:59:24.001
false,false,2074,1955,119,383,00:00:32.000,2025-04-14 12:01:26.098
false,false,2083,1964,119,671,00:00:32.000,2025-04-14 12:01:44.103
false,false,2440,2303,137,155,00:00:30.000,2025-04-14 12:16:50.747
false,true,2455,2317,138,0,00:00:00.000,2025-04-14 12:17:46.796
false,true,2455,2317,138,0,00:00:00.000,2025-04-14 12:17:50.797
false,false,2468,2330,138,127,00:00:31.000,2025-04-14 12:18:34.824
false,true,2347,2216,131,0,00:00:00.000,2025-04-14 12:12:44.561
false,false,2378,2246,132,605,00:00:31.000,2025-04-14 12:14:10.622
false,false,2383,2250,133,765,00:00:31.000,2025-04-14 12:14:20.633
false,false,2388,2254,134,31,00:00:31.000,2025-04-14 12:14:42.653
false,false,2394,2260,134,220,00:00:32.000,2025-04-14 12:14:54.662
false,false,2397,2263,134,316,00:00:32.000,2025-04-14 12:15:00.666
false,false,2398,2264,134,348,00:00:32.000,2025-04-14 12:15:02.669
false,false,2402,2268,134,475,00:00:33.000,2025-04-14 12:15:10.674
false,false,2092,1973,119,956,00:00:33.000,2025-04-14 12:02:02.116
false,false,2098,1979,119,1146,00:00:32.000,2025-04-14 12:02:14.126
false,false,2106,1987,119,1394,00:00:31.000,2025-04-14 12:02:30.135
false,false,2107,1988,119,1426,00:00:32.000,2025-04-14 12:02:32.137
false,false,2111,1992,119,1555,00:00:31.000,2025-04-14 12:02:40.143
false,false,2113,1994,119,62,00:00:30.000,2025-04-14 12:02:56.157
false,false,2121,2002,119,315,00:00:31.000,2025-04-14 12:03:12.169
false,true,2137,2017,120,0,00:00:00.000,2025-04-14 12:03:54.194
false,false,2147,2027,120,313,00:00:33.000,2025-04-14 12:04:16.209
false,false,2480,2342,138,505,00:00:31.000,2025-04-14 12:18:58.839
false,false,2492,2353,139,882,00:00:30.000,2025-04-14 12:19:22.848
false,false,2496,2357,139,1008,00:00:32.000,2025-04-14 12:19:30.852
false,false,2530,2388,142,628,00:00:33.000,2025-04-14 12:20:50.903
false,false,2547,2404,143,1173,00:00:31.000,2025-04-14 12:21:24.934
false,false,2578,2431,147,349,00:00:31.000,2025-04-14 12:22:39.001
false,false,2580,2433,147,413,00:00:33.000,2025-04-14 12:22:43.004
false,true,2588,2441,147,0,00:00:00.000,2025-04-14 12:23:11.024
false,false,2602,2453,149,443,00:00:33.000,2025-04-14 12:23:39.042
false,false,2605,2456,149,540,00:00:32.000,2025-04-14 12:23:45.047
false,true,2610,2460,150,0,00:00:00.000,2025-04-14 12:24:11.067
false,false,2726,2564,162,589,00:00:30.000,2025-04-14 12:28:47.277
false,false,2743,2581,162,30,00:00:30.000,2025-04-14 12:29:57.325
false,false,2755,2592,163,126,00:00:30.000,2025-04-14 12:30:33.354
false,true,2758,2595,163,0,00:00:00.000,2025-04-14 12:30:43.363
false,true,2772,2609,163,0,00:00:00.000,2025-04-14 12:31:35.399
false,true,2772,2609,163,0,00:00:00.000,2025-04-14 12:31:43.404
false,false,2659,2503,156,1544,00:00:32.000,2025-04-14 12:25:57.138
false,false,2675,2518,157,33,00:00:33.000,2025-04-14 12:26:53.183
false,false,2681,2523,158,227,00:00:32.000,2025-04-14 12:27:05.192
false,false,2705,2546,159,985,00:00:30.000,2025-04-14 12:27:53.234
false,false,2785,2621,164,345,00:00:31.000,2025-04-14 12:32:21.429
false,false,2811,2644,167,380,00:00:30.000,2025-04-14 12:33:25.474
false,true,2821,2654,167,0,00:00:00.000,2025-04-14 12:33:47.487
false,false,2830,2663,167,31,00:00:31.000,2025-04-14 12:34:27.516
false,false,2844,2677,167,474,00:00:31.000,2025-04-14 12:34:55.539
false,false,2866,2696,170,475,00:00:33.000,2025-04-14 12:36:03.586
false,false,8050,7571,479,473,00:00:30.000,2025-04-15 12:01:24.128
false,false,8054,7575,479,599,00:00:33.000,2025-04-15 12:01:28.133
false,false,8056,7577,479,662,00:00:32.000,2025-04-15 12:01:30.134
false,false,8065,7584,481,942,00:00:30.000,2025-04-15 12:01:39.144
false,false,8067,7586,481,1004,00:00:31.000,2025-04-15 12:01:41.145
false,true,8070,7588,482,0,00:00:00.000,2025-04-15 12:01:48.152
false,false,8127,7642,485,185,00:00:30.000,2025-04-15 12:03:41.267
false,false,8132,7647,485,344,00:00:31.000,2025-04-15 12:03:46.272
false,false,8135,7650,485,436,00:00:30.000,2025-04-15 12:03:49.273
false,false,8194,7707,487,1135,00:00:32.000,2025-04-15 12:04:54.348
false,true,8195,7708,487,0,00:00:00.000,2025-04-15 12:05:01.354
false,true,8087,7604,483,0,00:00:00.000,2025-04-15 12:02:17.175
false,false,8103,7619,484,93,00:00:31.000,2025-04-15 12:02:47.211
false,false,8117,7633,484,283,00:00:30.000,2025-04-15 12:03:07.229
false,true,8119,7635,484,0,00:00:00.000,2025-04-15 12:03:13.234
false,true,8119,7635,484,0,00:00:00.000,2025-04-15 12:03:14.235
false,true,8121,7637,484,0,00:00:00.000,2025-04-15 12:03:30.254
false,true,7942,7467,475,0,00:00:00.000,2025-04-15 11:58:55.982
false,false,7948,7473,475,192,00:00:33.000,2025-04-15 11:59:05.991
false,true,7949,7474,475,0,00:00:00.000,2025-04-15 11:59:08.992
false,true,7971,7495,476,0,00:00:00.000,2025-04-15 11:59:37.025
false,true,7971,7495,476,0,00:00:00.000,2025-04-15 11:59:41.029
false,false,7986,7508,478,472,00:00:30.000,2025-04-15 11:59:56.044
false,false,8282,7788,494,1060,00:00:30.000,2025-04-15 12:06:52.458
false,false,8286,7792,494,1185,00:00:32.000,2025-04-15 12:06:56.459
false,false,8356,7859,497,470,00:00:31.000,2025-04-15 12:08:30.549
false,false,8362,7865,497,181,00:00:31.000,2025-04-15 12:08:42.560
false,false,8381,7881,500,779,00:00:30.000,2025-04-15 12:09:01.576
false,false,8406,7905,501,344,00:00:30.000,2025-04-15 12:09:32.606
false,false,8425,7923,502,412,00:00:31.000,2025-04-15 12:10:09.641
false,false,8487,7984,503,746,00:00:32.000,2025-04-15 12:11:35.726
false,true,8206,7718,488,0,00:00:00.000,2025-04-15 12:05:16.361
false,false,8208,7720,488,63,00:00:33.000,2025-04-15 12:05:20.365
false,false,8231,7740,491,787,00:00:33.000,2025-04-15 12:05:43.390
false,false,8244,7752,492,373,00:00:31.000,2025-04-15 12:06:02.407
false,false,8245,7753,492,404,00:00:31.000,2025-04-15 12:06:03.407
false,false,8269,7776,493,654,00:00:30.000,2025-04-15 12:06:39.444
false,true,8587,8081,506,0,00:00:00.000,2025-04-15 12:13:53.858
false,false,8603,8094,509,283,00:00:30.000,2025-04-15 12:14:25.891
false,false,8700,8187,513,249,00:00:31.000,2025-04-15 12:16:57.037
false,false,8708,8193,515,90,00:00:30.000,2025-04-15 12:17:11.052
false,false,8709,8194,515,122,00:00:32.000,2025-04-15 12:17:12.053
false,false,8741,8224,517,1136,00:00:32.000,2025-04-15 12:17:44.082
false,false,8742,8225,517,1166,00:00:30.000,2025-04-15 12:17:45.083
false,false,8757,8239,518,221,00:00:32.000,2025-04-15 12:18:06.108
false,false,8760,8242,518,314,00:00:32.000,2025-04-15 12:18:09.111
false,false,8762,8244,518,375,00:00:30.000,2025-04-15 12:18:11.113
false,false,8765,8247,518,468,00:00:30.000,2025-04-15 12:18:14.115
false,false,8766,8248,518,501,00:00:33.000,2025-04-15 12:18:15.116
false,false,8772,8254,518,689,00:00:31.000,2025-04-15 12:18:21.123
false,false,8775,8257,518,32,00:00:32.000,2025-04-15 12:18:30.132
false,false,8642,8130,512,93,00:00:32.000,2025-04-15 12:15:16.938
false,false,8681,8168,513,218,00:00:32.000,2025-04-15 12:16:19.999
false,false,8686,8173,513,374,00:00:33.000,2025-04-15 12:16:25.005
false,true,8686,8173,513,0,00:00:00.000,2025-04-15 12:16:33.014
false,false,8506,8002,504,538,00:00:31.000,2025-04-15 12:12:00.752
false,true,8513,8009,504,0,00:00:00.000,2025-04-15 12:12:09.761
false,false,8538,8033,505,378,00:00:32.000,2025-04-15 12:12:44.793
false,false,8558,8053,505,377,00:00:33.000,2025-04-15 12:13:10.822
false,false,8568,8063,505,690,00:00:33.000,2025-04-15 12:13:20.833
false,false,8777,8258,519,96,00:00:32.000,2025-04-15 12:18:32.134
false,false,8780,8261,519,191,00:00:31.000,2025-04-15 12:18:35.137
false,false,8789,8270,519,93,00:00:32.000,2025-04-15 12:18:50.152
false,true,8840,8317,523,0,00:00:00.000,2025-04-15 12:20:03.228
false,false,8918,8388,530,657,00:00:31.000,2025-04-15 12:21:59.352
false,false,8919,8389,530,688,00:00:31.000,2025-04-15 12:22:00.353
false,false,8949,8418,531,1634,00:00:33.000,2025-04-15 12:22:30.381
false,false,8952,8421,531,1729,00:00:33.000,2025-04-15 12:22:33.385
false,false,8962,8431,531,184,00:00:30.000,2025-04-15 12:22:49.401
false,false,8986,8453,533,687,00:00:30.000,2025-04-15 12:23:19.429
false,false,8850,8326,524,315,00:00:32.000,2025-04-15 12:20:15.243
false,false,8863,8337,526,257,00:00:33.000,2025-04-15 12:20:34.264
false,false,8887,8358,529,33,00:00:33.000,2025-04-15 12:21:04.295
false,true,8892,8363,529,0,00:00:00.000,2025-04-15 12:21:21.316
false,false,8907,8377,530,312,00:00:30.000,2025-04-15 12:21:48.341
false,false,8909,8379,530,374,00:00:31.000,2025-04-15 12:21:50.343
false,false,9259,8707,552,347,00:00:33.000,2025-04-15 12:29:10.777
false,false,9262,8709,553,63,00:00:32.000,2025-04-15 12:29:19.786
false,false,9265,8711,554,158,00:00:31.000,2025-04-15 12:29:22.789
false,false,9271,8716,555,348,00:00:31.000,2025-04-15 12:29:28.796
false,false,9274,8718,556,443,00:00:33.000,2025-04-15 12:29:31.799
false,true,9277,8721,556,0,00:00:00.000,2025-04-15 12:29:38.808
false,false,9075,8537,538,574,00:00:30.000,2025-04-15 12:25:18.538
false,false,9081,8542,539,764,00:00:33.000,2025-04-15 12:25:24.544
false,false,9094,8552,542,1178,00:00:33.000,2025-04-15 12:25:37.558
false,false,9097,8555,542,1270,00:00:30.000,2025-04-15 12:25:40.562
false,false,9142,8598,544,2674,00:00:31.000,2025-04-15 12:26:25.604
false,false,9193,8645,548,92,00:00:31.000,2025-04-15 12:27:40.675
false,false,9195,8647,548,154,00:00:30.000,2025-04-15 12:27:42.677
false,false,9201,8652,549,342,00:00:32.000,2025-04-15 12:27:48.685
false,true,9354,8793,561,0,00:00:00.000,2025-04-15 12:31:39.920
false,false,9359,8798,561,157,00:00:32.000,2025-04-15 12:31:50.933
false,false,9361,8800,561,221,00:00:31.000,2025-04-15 12:31:52.935
false,true,9370,8808,562,0,00:00:00.000,2025-04-15 12:32:24.967
false,false,9382,8820,562,380,00:00:32.000,2025-04-15 12:32:37.982
false,false,9394,8832,562,321,00:00:32.000,2025-04-15 12:32:56.004
false,false,8999,8466,533,1098,00:00:33.000,2025-04-15 12:23:32.444
false,true,9002,8469,533,0,00:00:00.000,2025-04-15 12:23:36.448
false,true,9002,8469,533,0,00:00:00.000,2025-04-15 12:23:38.449
false,true,9014,8481,533,0,00:00:00.000,2025-04-15 12:23:59.467
false,false,9032,8496,536,122,00:00:32.000,2025-04-15 12:24:23.486
false,false,9057,8520,537,405,00:00:30.000,2025-04-15 12:24:54.517
false,false,9068,8531,537,352,00:00:32.000,2025-04-15 12:25:11.534
false,false,9483,8919,564,190,00:00:32.000,2025-04-15 12:34:55.131
false,false,9490,8925,565,411,00:00:32.000,2025-04-15 12:35:02.138
false,false,9506,8938,568,160,00:00:31.000,2025-04-15 12:35:24.161
false,false,9535,8964,571,715,00:00:32.000,2025-04-15 12:35:59.194
false,true,9550,8978,572,0,00:00:00.000,2025-04-15 12:36:21.217
false,false,9557,8985,572,127,00:00:33.000,2025-04-15 12:36:39.234
false,false,9566,8994,572,407,00:00:31.000,2025-04-15 12:36:48.243
false,false,9578,9005,573,785,00:00:31.000,2025-04-15 12:37:00.256
false,false,9579,9006,573,817,00:00:32.000,2025-04-15 12:37:01.257
false,true,9581,9008,573,0,00:00:00.000,2025-04-15 12:37:08.265
false,false,9594,9021,573,412,00:00:31.000,2025-04-15 12:37:22.279
false,false,9630,9055,575,914,00:00:33.000,2025-04-15 12:38:04.322
false,false,9411,8849,562,320,00:00:32.000,2025-04-15 12:33:25.038
false,false,9413,8851,562,383,00:00:33.000,2025-04-15 12:33:27.038
false,false,9421,8858,563,638,00:00:31.000,2025-04-15 12:33:35.050
false,true,9428,8865,563,0,00:00:00.000,2025-04-15 12:33:48.065
false,false,9430,8867,563,63,00:00:31.000,2025-04-15 12:33:50.067
false,false,9435,8872,563,222,00:00:30.000,2025-04-15 12:33:55.075
false,false,9441,8878,563,411,00:00:33.000,2025-04-15 12:34:01.081
false,false,9446,8883,563,571,00:00:30.000,2025-04-15 12:34:06.086
false,false,9450,8887,563,698,00:00:31.000,2025-04-15 12:34:10.089
false,false,9453,8890,563,789,00:00:31.000,2025-04-15 12:34:13.093
false,false,9462,8898,564,1061,00:00:30.000,2025-04-15 12:34:22.101
false,false,9465,8901,564,1157,00:00:33.000,2025-04-15 12:34:25.104
false,false,9471,8907,564,1347,00:00:30.000,2025-04-15 12:34:31.107
false,true,9476,8912,564,0,00:00:00.000,2025-04-15 12:34:38.116
false,false,9333,8772,561,317,00:00:31.000,2025-04-15 12:31:12.899
false,false,9640,9065,575,1228,00:00:30.000,2025-04-15 12:38:14.337
false,false,9650,9075,575,30,00:00:30.000,2025-04-15 12:38:30.355
false,false,9672,9094,578,727,00:00:33.000,2025-04-15 12:38:52.380
false,false,9687,9108,579,376,00:00:30.000,2025-04-15 12:39:13.399
false,true,9701,9120,581,0,00:00:00.000,2025-04-15 12:39:38.430
false,false,1595,1500,95,256,00:00:32.000,2025-04-14 11:38:39.078
false,false,1617,1520,97,95,00:00:32.000,2025-04-14 11:39:35.128
false,true,1618,1521,97,0,00:00:00.000,2025-04-14 11:39:43.133
false,true,1626,1529,97,0,00:00:00.000,2025-04-14 11:40:09.151
false,true,1626,1529,97,0,00:00:00.000,2025-04-14 11:40:11.153
false,true,1657,1559,98,0,00:00:00.000,2025-04-14 11:41:23.211
false,false,1667,1568,99,319,00:00:33.000,2025-04-14 11:41:51.229
false,false,1822,1716,106,195,00:00:33.000,2025-04-14 11:49:37.563
false,false,1827,1721,106,348,00:00:30.000,2025-04-14 11:49:47.570
false,false,1832,1725,107,505,00:00:33.000,2025-04-14 11:49:57.576
false,true,1841,1732,109,0,00:00:00.000,2025-04-14 11:50:35.605
false,true,1951,1836,115,0,00:00:00.000,2025-04-14 11:55:59.843
false,true,1951,1836,115,0,00:00:00.000,2025-04-14 11:56:07.850
false,true,1958,1843,115,0,00:00:00.000,2025-04-14 11:56:25.863
false,true,1959,1844,115,0,00:00:00.000,2025-04-14 11:56:41.878
false,false,1964,1848,116,159,00:00:33.000,2025-04-14 11:56:57.894
false,false,1990,1874,116,407,00:00:30.000,2025-04-14 11:58:01.942
false,false,1755,1651,104,90,00:00:30.000,2025-04-14 11:45:47.409
false,false,1757,1653,104,154,00:00:33.000,2025-04-14 11:45:51.411
false,false,1763,1659,104,340,00:00:31.000,2025-04-14 11:46:03.416
false,false,1773,1669,104,319,00:00:33.000,2025-04-14 11:46:35.436
false,true,1777,1673,104,0,00:00:00.000,2025-04-14 11:47:15.469
false,true,1779,1675,104,0,00:00:00.000,2025-04-14 11:47:43.486
false,false,1791,1687,104,379,00:00:33.000,2025-04-14 11:48:11.503
false,false,1797,1693,104,573,00:00:32.000,2025-04-14 11:48:23.515
false,true,1797,1693,104,0,00:00:00.000,2025-04-14 11:48:35.522
false,true,1880,1769,111,0,00:00:00.000,2025-04-14 11:52:01.667
false,true,1894,1781,113,0,00:00:00.000,2025-04-14 11:52:51.699
false,false,1922,1809,113,627,00:00:30.000,2025-04-14 11:54:09.764
false,false,1929,1815,114,94,00:00:30.000,2025-04-14 11:54:47.791
false,false,1930,1816,114,126,00:00:32.000,2025-04-14 11:54:49.792
false,false,1934,1820,114,252,00:00:30.000,2025-04-14 11:54:57.796
false,false,1944,1830,114,567,00:00:33.000,2025-04-14 11:55:17.815
false,true,1668,1569,99,0,00:00:00.000,2025-04-14 11:42:09.247
false,false,1677,1576,101,281,00:00:30.000,2025-04-14 11:42:35.265
false,false,1682,1581,101,437,00:00:30.000,2025-04-14 11:42:45.271
false,false,1687,1586,101,594,00:00:31.000,2025-04-14 11:42:55.278
false,false,1695,1593,102,849,00:00:31.000,2025-04-14 11:43:11.289
false,false,2259,2130,129,31,00:00:31.000,2025-04-14 12:08:48.386
false,false,2265,2136,129,223,00:00:31.000,2025-04-14 12:09:00.397
false,false,2273,2144,129,476,00:00:31.000,2025-04-14 12:09:16.412
false,true,2278,2149,129,0,00:00:00.000,2025-04-14 12:09:30.423
false,false,2283,2154,129,159,00:00:31.000,2025-04-14 12:09:48.434
false,false,2308,2178,130,124,00:00:32.000,2025-04-14 12:11:02.491
false,false,2171,2048,123,282,00:00:30.000,2025-04-14 12:05:28.259
false,false,2173,2050,123,344,00:00:32.000,2025-04-14 12:05:32.264
false,false,2208,2081,127,726,00:00:32.000,2025-04-14 12:06:54.312
false,false,2220,2093,127,1105,00:00:33.000,2025-04-14 12:07:18.327
false,false,2229,2101,128,1383,00:00:30.000,2025-04-14 12:07:36.341
false,false,2240,2112,128,1733,00:00:33.000,2025-04-14 12:07:58.355
false,false,2241,2113,128,1764,00:00:31.000,2025-04-14 12:08:00.357
false,false,2247,2118,129,1956,00:00:31.000,2025-04-14 12:08:12.364
false,false,2038,1920,118,1098,00:00:32.000,2025-04-14 11:59:50.023
false,false,2040,1922,118,1161,00:00:32.000,2025-04-14 11:59:54.028
false,false,2078,1959,119,510,00:00:32.000,2025-04-14 12:01:34.099
false,true,2407,2273,134,0,00:00:00.000,2025-04-14 12:15:24.684
false,true,2435,2298,137,0,00:00:00.000,2025-04-14 12:16:36.739
false,true,2435,2298,137,0,00:00:00.000,2025-04-14 12:16:38.741
false,true,2451,2313,138,0,00:00:00.000,2025-04-14 12:17:26.779
false,false,2453,2315,138,63,00:00:31.000,2025-04-14 12:17:40.790
false,true,2348,2217,131,0,00:00:00.000,2025-04-14 12:12:50.566
false,false,2352,2221,131,125,00:00:32.000,2025-04-14 12:13:06.575
false,false,2357,2226,131,285,00:00:32.000,2025-04-14 12:13:16.583
false,false,2372,2240,132,418,00:00:32.000,2025-04-14 12:13:58.615
false,false,2375,2243,132,513,00:00:32.000,2025-04-14 12:14:04.617
false,false,2377,2245,132,574,00:00:30.000,2025-04-14 12:14:08.621
false,false,2382,2249,133,734,00:00:33.000,2025-04-14 12:14:18.631
false,true,2387,2253,134,0,00:00:00.000,2025-04-14 12:14:34.645
false,false,2096,1977,119,1082,00:00:32.000,2025-04-14 12:02:10.123
false,false,2101,1982,119,1239,00:00:30.000,2025-04-14 12:02:20.129
false,true,2111,1992,119,0,00:00:00.000,2025-04-14 12:02:50.151
false,false,2133,2013,120,694,00:00:32.000,2025-04-14 12:03:36.187
false,false,2152,2031,121,472,00:00:33.000,2025-04-14 12:04:26.213
false,true,2158,2036,122,0,00:00:00.000,2025-04-14 12:04:50.234
false,false,2489,2350,139,790,00:00:33.000,2025-04-14 12:19:16.846
false,false,2527,2385,142,531,00:00:31.000,2025-04-14 12:20:44.901
false,false,2543,2401,142,1043,00:00:32.000,2025-04-14 12:21:16.928
false,false,2561,2415,146,1621,00:00:33.000,2025-04-14 12:21:52.961
false,false,2581,2434,147,446,00:00:33.000,2025-04-14 12:22:45.006
false,false,2591,2444,147,96,00:00:33.000,2025-04-14 12:23:17.028
false,false,2596,2448,148,255,00:00:31.000,2025-04-14 12:23:27.036
false,false,2600,2452,148,379,00:00:33.000,2025-04-14 12:23:35.041
false,false,2601,2453,148,410,00:00:31.000,2025-04-14 12:23:37.041
false,false,2620,2470,150,314,00:00:32.000,2025-04-14 12:24:39.087
false,false,2633,2481,152,726,00:00:32.000,2025-04-14 12:25:05.106
false,false,2639,2487,152,912,00:00:30.000,2025-04-14 12:25:17.112
false,false,2756,2593,163,158,00:00:32.000,2025-04-14 12:30:35.355
false,true,2758,2595,163,0,00:00:00.000,2025-04-14 12:30:41.361
false,true,2758,2595,163,0,00:00:00.000,2025-04-14 12:30:49.368
false,true,2758,2595,163,0,00:00:00.000,2025-04-14 12:30:53.368
false,false,2763,2600,163,161,00:00:33.000,2025-04-14 12:31:13.388
false,true,2772,2609,163,0,00:00:00.000,2025-04-14 12:31:33.398
false,true,2772,2609,163,0,00:00:00.000,2025-04-14 12:31:37.401
false,false,2653,2497,156,1353,00:00:31.000,2025-04-14 12:25:45.130
false,false,2658,2502,156,1512,00:00:32.000,2025-04-14 12:25:55.136
false,true,2660,2504,156,0,00:00:00.000,2025-04-14 12:26:11.146
false,false,2661,2505,156,31,00:00:31.000,2025-04-14 12:26:13.148
false,true,2674,2517,157,0,00:00:00.000,2025-04-14 12:26:51.181
false,false,2701,2542,159,858,00:00:30.000,2025-04-14 12:27:45.226
false,true,2707,2548,159,0,00:00:00.000,2025-04-14 12:28:05.245
false,false,2779,2616,163,160,00:00:33.000,2025-04-14 12:32:09.425
false,false,2841,2674,167,380,00:00:32.000,2025-04-14 12:34:49.532
false,false,2862,2692,170,345,00:00:30.000,2025-04-14 12:35:55.581
false,true,2873,2703,170,0,00:00:00.000,2025-04-14 12:36:27.602
false,false,8064,7583,481,912,00:00:31.000,2025-04-15 12:01:38.143
false,false,8129,7644,485,249,00:00:31.000,2025-04-15 12:03:43.269
false,false,8137,7652,485,500,00:00:33.000,2025-04-15 12:03:51.276
false,true,8158,7672,486,0,00:00:00.000,2025-04-15 12:04:14.301
false,false,8163,7676,487,157,00:00:30.000,2025-04-15 12:04:23.313
false,false,8172,7685,487,443,00:00:30.000,2025-04-15 12:04:32.320
false,false,8173,7686,487,474,00:00:31.000,2025-04-15 12:04:33.321
false,false,8176,7689,487,568,00:00:30.000,2025-04-15 12:04:36.326
false,false,8191,7704,487,1039,00:00:33.000,2025-04-15 12:04:51.345
false,false,8193,7706,487,1103,00:00:32.000,2025-04-15 12:04:53.347
false,false,8198,7711,487,95,00:00:30.000,2025-04-15 12:05:04.355
false,false,8071,7589,482,33,00:00:33.000,2025-04-15 12:01:51.153
false,false,8087,7604,483,507,00:00:33.000,2025-04-15 12:02:13.173
false,true,8091,7607,484,0,00:00:00.000,2025-04-15 12:02:24.181
false,true,8091,7607,484,0,00:00:00.000,2025-04-15 12:02:25.182
false,false,8093,7609,484,64,00:00:33.000,2025-04-15 12:02:31.189
false,false,8095,7611,484,126,00:00:30.000,2025-04-15 12:02:33.191
false,true,8100,7616,484,0,00:00:00.000,2025-04-15 12:02:43.206
false,false,8113,7629,484,156,00:00:30.000,2025-04-15 12:03:03.224
false,true,8121,7637,484,0,00:00:00.000,2025-04-15 12:03:23.244
false,false,7931,7456,475,1927,00:00:31.000,2025-04-15 11:58:36.958
false,false,7934,7459,475,2022,00:00:31.000,2025-04-15 11:58:39.964
false,false,7936,7461,475,2087,00:00:33.000,2025-04-15 11:58:41.966
false,false,7961,7486,475,381,00:00:33.000,2025-04-15 11:59:25.010
false,false,7991,7513,478,631,00:00:31.000,2025-04-15 12:00:01.046
false,false,8285,7791,494,1153,00:00:30.000,2025-04-15 12:06:55.460
false,false,8289,7795,494,1281,00:00:32.000,2025-04-15 12:06:59.462
false,false,8293,7799,494,1407,00:00:32.000,2025-04-15 12:07:03.467
false,false,8302,7808,494,1688,00:00:33.000,2025-04-15 12:07:12.476
false,false,8320,7824,496,514,00:00:31.000,2025-04-15 12:07:36.500
false,true,8325,7829,496,0,00:00:00.000,2025-04-15 12:07:43.507
false,false,8332,7836,496,61,00:00:31.000,2025-04-15 12:08:00.518
false,false,8336,7840,496,190,00:00:33.000,2025-04-15 12:08:04.522
false,false,8338,7842,496,251,00:00:31.000,2025-04-15 12:08:06.524
false,false,8368,7870,498,372,00:00:30.000,2025-04-15 12:08:48.566
false,true,8395,7895,500,0,00:00:00.000,2025-04-15 12:09:17.592
false,true,8395,7895,500,0,00:00:00.000,2025-04-15 12:09:18.594
false,false,8411,7910,501,60,00:00:30.000,2025-04-15 12:09:43.617
false,true,8412,7911,501,0,00:00:00.000,2025-04-15 12:09:53.626
false,false,8427,7925,502,476,00:00:32.000,2025-04-15 12:10:11.643
false,true,8428,7926,502,0,00:00:00.000,2025-04-15 12:10:14.644
false,false,8433,7931,502,156,00:00:30.000,2025-04-15 12:10:23.655
false,true,8442,7940,502,0,00:00:00.000,2025-04-15 12:10:37.667
false,true,8453,7951,502,0,00:00:00.000,2025-04-15 12:10:54.683
false,false,8454,7952,502,33,00:00:33.000,2025-04-15 12:10:56.687
false,false,8458,7956,502,161,00:00:32.000,2025-04-15 12:11:00.689
false,false,8215,7727,488,283,00:00:32.000,2025-04-15 12:05:27.374
false,false,8221,7732,489,468,00:00:32.000,2025-04-15 12:05:33.379
false,false,8237,7746,491,156,00:00:30.000,2025-04-15 12:05:55.402
false,true,8246,7754,492,0,00:00:00.000,2025-04-15 12:06:06.412
false,false,8261,7768,493,407,00:00:33.000,2025-04-15 12:06:31.432
false,false,8591,8084,507,128,00:00:33.000,2025-04-15 12:14:01.867
false,true,8594,8087,507,0,00:00:00.000,2025-04-15 12:14:12.877
false,false,8621,8112,509,846,00:00:30.000,2025-04-15 12:14:43.910
false,false,8630,8119,511,160,00:00:32.000,2025-04-15 12:14:58.921
false,false,8633,8122,511,254,00:00:30.000,2025-04-15 12:15:01.924
false,false,8636,8124,512,345,00:00:30.000,2025-04-15 12:15:04.927
false,false,8697,8184,513,154,00:00:30.000,2025-04-15 12:16:54.033
false,false,8713,8198,515,247,00:00:30.000,2025-04-15 12:17:16.055
false,false,8732,8217,515,848,00:00:30.000,2025-04-15 12:17:35.073
false,false,8750,8232,518,1419,00:00:33.000,2025-04-15 12:17:53.094
false,false,8754,8236,518,126,00:00:32.000,2025-04-15 12:18:03.106
false,false,8759,8241,518,282,00:00:30.000,2025-04-15 12:18:08.110
false,false,8768,8250,518,566,00:00:32.000,2025-04-15 12:18:17.117
false,true,8774,8256,518,0,00:00:00.000,2025-04-15 12:18:24.125
false,false,8662,8150,512,190,00:00:33.000,2025-04-15 12:15:48.971
false,false,8664,8152,512,255,00:00:33.000,2025-04-15 12:15:50.972
false,true,8674,8162,512,0,00:00:00.000,2025-04-15 12:16:10.991
false,true,8686,8173,513,0,00:00:00.000,2025-04-15 12:16:30.011
false,false,8498,7994,504,287,00:00:33.000,2025-04-15 12:11:52.746
false,false,8504,8000,504,475,00:00:32.000,2025-04-15 12:11:58.751
false,false,8505,8001,504,507,00:00:32.000,2025-04-15 12:11:59.751
false,false,8529,8024,505,94,00:00:33.000,2025-04-15 12:12:35.783
false,false,8555,8050,505,280,00:00:30.000,2025-04-15 12:13:07.818
false,false,8557,8052,505,344,00:00:33.000,2025-04-15 12:13:09.821
false,false,8784,8265,519,319,00:00:30.000,2025-04-15 12:18:39.140
false,false,8800,8281,519,33,00:00:33.000,2025-04-15 12:19:07.165
false,true,8800,8281,519,0,00:00:00.000,2025-04-15 12:19:08.166
false,false,8808,8288,520,249,00:00:30.000,2025-04-15 12:19:21.184
false,false,8840,8317,523,721,00:00:33.000,2025-04-15 12:19:59.222
false,false,8845,8321,524,156,00:00:32.000,2025-04-15 12:20:10.236
false,true,8956,8425,531,0,00:00:00.000,2025-04-15 12:22:38.390
false,true,8964,8433,531,0,00:00:00.000,2025-04-15 12:22:53.406
false,false,8972,8439,533,253,00:00:31.000,2025-04-15 12:23:05.417
false,false,8989,8456,533,778,00:00:30.000,2025-04-15 12:23:22.434
false,true,8855,8331,524,0,00:00:00.000,2025-04-15 12:20:22.249
false,true,8855,8331,524,0,00:00:00.000,2025-04-15 12:20:26.254
false,false,8862,8336,526,224,00:00:30.000,2025-04-15 12:20:33.263
false,true,8893,8364,529,0,00:00:00.000,2025-04-15 12:21:23.317
false,false,8905,8375,530,251,00:00:32.000,2025-04-15 12:21:46.337
false,false,9248,8696,552,157,00:00:30.000,2025-04-15 12:28:53.757
false,false,9250,8698,552,61,00:00:30.000,2025-04-15 12:29:01.765
false,false,9254,8702,552,186,00:00:30.000,2025-04-15 12:29:05.769
false,false,9256,8704,552,249,00:00:32.000,2025-04-15 12:29:07.771
false,false,9258,8706,552,314,00:00:32.000,2025-04-15 12:29:09.775
false,false,9261,8708,553,31,00:00:31.000,2025-04-15 12:29:18.785
false,false,9264,8711,553,127,00:00:32.000,2025-04-15 12:29:21.787
false,false,9268,8713,555,254,00:00:33.000,2025-04-15 12:29:25.793
false,false,9273,8717,556,410,00:00:31.000,2025-04-15 12:29:30.798
false,true,9277,8721,556,0,00:00:00.000,2025-04-15 12:29:36.806
false,false,9286,8730,556,284,00:00:31.000,2025-04-15 12:29:55.823
false,false,9082,8542,540,794,00:00:30.000,2025-04-15 12:25:25.545
false,false,9100,8558,542,1363,00:00:30.000,2025-04-15 12:25:43.566
false,false,9105,8561,544,1521,00:00:32.000,2025-04-15 12:25:48.571
false,false,9108,8564,544,1614,00:00:31.000,2025-04-15 12:25:51.573
false,false,9112,8568,544,1737,00:00:31.000,2025-04-15 12:25:55.576
false,false,9124,8580,544,2113,00:00:30.000,2025-04-15 12:26:07.586
false,false,9145,8600,545,2767,00:00:31.000,2025-04-15 12:26:28.607
false,false,9154,8609,545,64,00:00:32.000,2025-04-15 12:26:43.622
false,true,9166,8621,545,0,00:00:00.000,2025-04-15 12:26:57.636
false,false,9168,8623,545,62,00:00:31.000,2025-04-15 12:27:03.641
false,false,9173,8627,546,157,00:00:32.000,2025-04-15 12:27:14.651
false,false,9185,8637,548,536,00:00:30.000,2025-04-15 12:27:26.661
false,false,9218,8668,550,317,00:00:33.000,2025-04-15 12:28:11.712
false,false,9351,8790,561,880,00:00:32.000,2025-04-15 12:31:30.913
false,false,9353,8792,561,942,00:00:32.000,2025-04-15 12:31:32.913
false,false,9354,8793,561,973,00:00:31.000,2025-04-15 12:31:33.915
false,true,9354,8793,561,0,00:00:00.000,2025-04-15 12:31:42.923
false,true,9364,8802,562,0,00:00:00.000,2025-04-15 12:31:58.941
false,true,9364,8802,562,0,00:00:00.000,2025-04-15 12:31:59.942
false,true,9368,8806,562,0,00:00:00.000,2025-04-15 12:32:13.956
false,false,9397,8835,562,419,00:00:32.000,2025-04-15 12:32:59.006
false,false,9398,8836,562,449,00:00:30.000,2025-04-15 12:33:00.007
false,false,9014,8481,533,376,00:00:30.000,2025-04-15 12:23:53.462
false,true,9014,8481,533,0,00:00:00.000,2025-04-15 12:23:54.462
false,true,9014,8481,533,0,00:00:00.000,2025-04-15 12:23:55.464
false,false,9018,8484,534,127,00:00:32.000,2025-04-15 12:24:03.469
false,false,9023,8488,535,282,00:00:31.000,2025-04-15 12:24:08.475
false,true,9028,8493,535,0,00:00:00.000,2025-04-15 12:24:19.483
false,false,9029,8493,536,30,00:00:30.000,2025-04-15 12:24:20.485
false,false,9054,8517,537,310,00:00:31.000,2025-04-15 12:24:51.512
false,false,9486,8922,564,284,00:00:31.000,2025-04-15 12:34:58.133
false,false,9504,8936,568,97,00:00:32.000,2025-04-15 12:35:22.159
false,false,9541,8970,571,910,00:00:33.000,2025-04-15 12:36:05.199
false,false,9544,8972,572,1001,00:00:30.000,2025-04-15 12:36:08.202
false,false,9545,8973,572,1034,00:00:33.000,2025-04-15 12:36:09.202
false,true,9553,8981,572,0,00:00:00.000,2025-04-15 12:36:30.224
false,true,9581,9008,573,0,00:00:00.000,2025-04-15 12:37:06.262
false,false,9592,9019,573,349,00:00:33.000,2025-04-15 12:37:20.277
false,false,9598,9024,574,541,00:00:33.000,2025-04-15 12:37:26.286
false,false,9628,9053,575,849,00:00:32.000,2025-04-15 12:38:02.319
false,false,9402,8840,562,31,00:00:31.000,2025-04-15 12:33:16.026
false,false,9410,8848,562,288,00:00:33.000,2025-04-15 12:33:24.036
false,false,9448,8885,563,634,00:00:32.000,2025-04-15 12:34:08.087
false,false,9449,8886,563,667,00:00:33.000,2025-04-15 12:34:09.089
false,false,9451,8888,563,728,00:00:30.000,2025-04-15 12:34:11.091
false,false,9454,8891,563,819,00:00:30.000,2025-04-15 12:34:14.093
false,false,9457,8893,564,910,00:00:31.000,2025-04-15 12:34:17.097
false,false,9458,8894,564,940,00:00:30.000,2025-04-15 12:34:18.098
false,false,9459,8895,564,971,00:00:31.000,2025-04-15 12:34:19.098
false,false,9463,8899,564,1092,00:00:31.000,2025-04-15 12:34:23.102
false,false,9477,8913,564,31,00:00:31.000,2025-04-15 12:34:43.118
false,false,9350,8789,561,848,00:00:30.000,2025-04-15 12:31:29.913
false,false,9637,9062,575,1135,00:00:30.000,2025-04-15 12:38:11.332
false,false,9648,9073,575,1480,00:00:31.000,2025-04-15 12:38:22.345
false,false,9657,9081,576,253,00:00:31.000,2025-04-15 12:38:37.362
false,false,9668,9090,578,597,00:00:30.000,2025-04-15 12:38:48.376
false,false,9675,9097,578,820,00:00:33.000,2025-04-15 12:38:55.383
false,false,9676,9097,579,33,00:00:33.000,2025-04-15 12:39:02.388
false,false,9679,9100,579,124,00:00:30.000,2025-04-15 12:39:05.391
false,false,1603,1508,95,498,00:00:31.000,2025-04-14 11:38:55.093
false,false,1643,1545,98,535,00:00:33.000,2025-04-14 11:40:51.184
false,false,1649,1551,98,720,00:00:31.000,2025-04-14 11:41:03.196
false,false,1656,1558,98,940,00:00:31.000,2025-04-14 11:41:17.209
false,true,1816,1711,105,0,00:00:00.000,2025-04-14 11:49:19.553
false,true,1816,1711,105,0,00:00:00.000,2025-04-14 11:49:21.554
false,false,1820,1714,106,130,00:00:33.000,2025-04-14 11:49:33.561
false,true,1839,1731,108,0,00:00:00.000,2025-04-14 11:50:17.589
false,false,1866,1755,111,783,00:00:30.000,2025-04-14 11:51:29.648
false,true,1950,1835,115,0,00:00:00.000,2025-04-14 11:55:31.825
false,true,1950,1835,115,0,00:00:00.000,2025-04-14 11:55:49.837
false,false,1979,1863,116,63,00:00:33.000,2025-04-14 11:57:39.923
false,false,1984,1868,116,221,00:00:32.000,2025-04-14 11:57:49.931
false,false,1986,1870,116,282,00:00:30.000,2025-04-14 11:57:53.933
false,false,2003,1886,117,822,00:00:31.000,2025-04-14 11:58:27.965
false,true,2003,1886,117,0,00:00:00.000,2025-04-14 11:58:31.969
false,true,2003,1886,117,0,00:00:00.000,2025-04-14 11:58:33.970
false,true,2003,1886,117,0,00:00:00.000,2025-04-14 11:58:35.972
false,true,1763,1659,104,0,00:00:00.000,2025-04-14 11:46:11.421
false,true,1773,1669,104,0,00:00:00.000,2025-04-14 11:46:45.447
false,true,1777,1673,104,0,00:00:00.000,2025-04-14 11:47:21.472
false,true,1777,1673,104,0,00:00:00.000,2025-04-14 11:47:27.478
false,true,1779,1675,104,0,00:00:00.000,2025-04-14 11:47:47.488
false,false,1781,1677,104,60,00:00:30.000,2025-04-14 11:47:51.490
false,false,1783,1679,104,122,00:00:31.000,2025-04-14 11:47:55.491
false,false,1785,1681,104,185,00:00:32.000,2025-04-14 11:47:59.495
false,false,1793,1689,104,444,00:00:33.000,2025-04-14 11:48:15.505
false,true,1902,1789,113,0,00:00:00.000,2025-04-14 11:53:27.730
false,false,1914,1801,113,377,00:00:33.000,2025-04-14 11:53:53.749
false,false,1916,1803,113,438,00:00:31.000,2025-04-14 11:53:57.754
false,true,1926,1812,114,0,00:00:00.000,2025-04-14 11:54:31.781
false,false,1941,1827,114,474,00:00:31.000,2025-04-14 11:55:11.808
false,false,1686,1585,101,563,00:00:33.000,2025-04-14 11:42:53.276
false,false,1696,1594,102,879,00:00:30.000,2025-04-14 11:43:13.291
false,false,1717,1615,102,557,00:00:33.000,2025-04-14 11:44:07.335
false,true,1717,1615,102,0,00:00:00.000,2025-04-14 11:44:13.340
false,false,1739,1635,104,694,00:00:30.000,2025-04-14 11:45:03.379
false,false,2274,2145,129,506,00:00:30.000,2025-04-14 12:09:18.412
false,false,2285,2156,129,221,00:00:31.000,2025-04-14 12:09:52.437
false,false,2293,2164,129,95,00:00:31.000,2025-04-14 12:10:20.461
false,false,2294,2165,129,125,00:00:30.000,2025-04-14 12:10:22.464
false,false,2167,2044,123,155,00:00:31.000,2025-04-14 12:05:20.254
false,false,2193,2068,125,251,00:00:32.000,2025-04-14 12:06:24.294
false,false,2225,2097,128,1262,00:00:32.000,2025-04-14 12:07:28.336
false,false,2226,2098,128,1292,00:00:30.000,2025-04-14 12:07:30.337
false,false,2245,2116,129,1894,00:00:31.000,2025-04-14 12:08:08.364
false,false,2249,2120,129,2020,00:00:32.000,2025-04-14 12:08:16.367
false,true,2258,2129,129,0,00:00:00.000,2025-04-14 12:08:38.379
false,false,2013,1896,117,311,00:00:33.000,2025-04-14 11:58:59.988
false,false,2016,1899,117,403,00:00:32.000,2025-04-14 11:59:05.992
false,false,2034,1916,118,972,00:00:30.000,2025-04-14 11:59:42.016
false,false,2042,1924,118,1223,00:00:32.000,2025-04-14 11:59:58.031
false,false,2049,1931,118,219,00:00:30.000,2025-04-14 12:00:24.050
false,true,2062,1944,118,0,00:00:00.000,2025-04-14 12:00:56.076
false,true,2407,2273,134,0,00:00:00.000,2025-04-14 12:15:30.690
false,false,2410,2276,134,93,00:00:32.000,2025-04-14 12:15:38.693
false,false,2420,2285,135,408,00:00:31.000,2025-04-14 12:15:58.710
false,false,2432,2296,136,793,00:00:32.000,2025-04-14 12:16:22.726
false,false,2433,2297,136,823,00:00:30.000,2025-04-14 12:16:24.729
false,true,2464,2326,138,0,00:00:00.000,2025-04-14 12:18:18.814
false,false,2466,2328,138,65,00:00:33.000,2025-04-14 12:18:30.821
false,false,2365,2233,132,194,00:00:31.000,2025-04-14 12:13:44.604
false,false,2389,2255,134,61,00:00:30.000,2025-04-14 12:14:44.654
false,false,2396,2262,134,284,00:00:33.000,2025-04-14 12:14:58.664
false,false,2404,2270,134,540,00:00:33.000,2025-04-14 12:15:14.677
false,false,2097,1978,119,1114,00:00:32.000,2025-04-14 12:02:12.125
false,false,2104,1985,119,1333,00:00:31.000,2025-04-14 12:02:26.131
false,false,2105,1986,119,1363,00:00:30.000,2025-04-14 12:02:28.133
false,false,2116,1997,119,156,00:00:33.000,2025-04-14 12:03:02.162
false,true,2137,2017,120,0,00:00:00.000,2025-04-14 12:03:46.191
false,true,2137,2017,120,0,00:00:00.000,2025-04-14 12:03:56.195
false,false,2154,2033,121,535,00:00:33.000,2025-04-14 12:04:30.215
false,true,2158,2036,122,0,00:00:00.000,2025-04-14 12:04:42.225
false,true,2162,2040,122,0,00:00:00.000,2025-04-14 12:05:02.243
false,false,2482,2344,138,568,00:00:33.000,2025-04-14 12:19:02.840
false,false,2499,2360,139,1100,00:00:30.000,2025-04-14 12:19:36.854
false,false,2508,2367,141,1388,00:00:33.000,2025-04-14 12:19:54.866
false,true,2510,2368,142,0,00:00:00.000,2025-04-14 12:20:00.873
false,false,2529,2387,142,595,00:00:33.000,2025-04-14 12:20:48.903
false,false,2536,2394,142,819,00:00:32.000,2025-04-14 12:21:02.914
false,false,2555,2410,145,1427,00:00:31.000,2025-04-14 12:21:40.949
false,true,2567,2421,146,0,00:00:00.000,2025-04-14 12:22:06.976
false,false,2592,2445,147,129,00:00:33.000,2025-04-14 12:23:19.030
false,false,2632,2480,152,694,00:00:32.000,2025-04-14 12:25:03.104
false,false,2723,2561,162,496,00:00:33.000,2025-04-14 12:28:41.274
false,false,2725,2563,162,559,00:00:32.000,2025-04-14 12:28:45.278
false,false,2731,2569,162,746,00:00:30.000,2025-04-14 12:28:57.286
false,false,2741,2579,162,91,00:00:30.000,2025-04-14 12:29:41.315
false,true,2758,2595,163,0,00:00:00.000,2025-04-14 12:30:51.368
false,false,2761,2598,163,98,00:00:33.000,2025-04-14 12:31:09.383
false,false,2642,2490,152,1007,00:00:33.000,2025-04-14 12:25:23.116
false,false,2651,2496,155,1290,00:00:31.000,2025-04-14 12:25:41.126
false,false,2654,2498,156,1386,00:00:33.000,2025-04-14 12:25:47.132
false,true,2660,2504,156,0,00:00:00.000,2025-04-14 12:26:03.143
false,false,2706,2547,159,1015,00:00:30.000,2025-04-14 12:27:55.236
false,false,2707,2548,159,1045,00:00:30.000,2025-04-14 12:27:57.238
false,false,2715,2554,161,248,00:00:30.000,2025-04-14 12:28:25.259
false,false,2718,2557,161,339,00:00:31.000,2025-04-14 12:28:31.266
false,false,2720,2558,162,400,00:00:31.000,2025-04-14 12:28:35.269
false,false,2781,2618,163,223,00:00:33.000,2025-04-14 12:32:13.425
false,false,2810,2643,167,350,00:00:32.000,2025-04-14 12:33:23.473
false,false,2818,2651,167,601,00:00:33.000,2025-04-14 12:33:39.483
false,false,2822,2655,167,31,00:00:31.000,2025-04-14 12:33:59.495
false,false,2824,2657,167,93,00:00:32.000,2025-04-14 12:34:03.500
false,false,2837,2670,167,253,00:00:32.000,2025-04-14 12:34:41.527
false,false,2849,2682,167,633,00:00:30.000,2025-04-14 12:35:05.548
false,true,2851,2683,168,0,00:00:00.000,2025-04-14 12:35:29.568
false,false,2854,2685,169,96,00:00:31.000,2025-04-14 12:35:39.573
false,false,2867,2697,170,505,00:00:30.000,2025-04-14 12:36:05.586
false,false,2871,2701,170,629,00:00:30.000,2025-04-14 12:36:13.594
false,false,2876,2706,170,97,00:00:32.000,2025-04-14 12:36:35.607
false,true,2876,2706,170,0,00:00:00.000,2025-04-14 12:36:39.612
false,false,8053,7574,479,566,00:00:32.000,2025-04-15 12:01:27.132
false,false,8134,7649,485,406,00:00:32.000,2025-04-15 12:03:48.272
false,false,8138,7653,485,531,00:00:31.000,2025-04-15 12:03:52.277
false,false,8179,7692,487,661,00:00:30.000,2025-04-15 12:04:39.329
false,true,8071,7589,482,0,00:00:00.000,2025-04-15 12:01:57.159
false,false,8072,7590,482,32,00:00:32.000,2025-04-15 12:01:58.159
false,false,8078,7596,482,225,00:00:33.000,2025-04-15 12:02:04.164
false,false,8086,7603,483,474,00:00:32.000,2025-04-15 12:02:12.172
false,true,8091,7607,484,0,00:00:00.000,2025-04-15 12:02:26.183
false,true,8091,7607,484,0,00:00:00.000,2025-04-15 12:02:29.185
false,false,8097,7613,484,190,00:00:32.000,2025-04-15 12:02:35.194
false,false,8107,7623,484,221,00:00:31.000,2025-04-15 12:02:51.212
false,true,8121,7637,484,0,00:00:00.000,2025-04-15 12:03:28.251
false,true,7936,7461,475,0,00:00:00.000,2025-04-15 11:58:42.967
false,true,7949,7474,475,0,00:00:00.000,2025-04-15 11:59:12.995
false,false,7953,7478,475,129,00:00:33.000,2025-04-15 11:59:17.001
false,false,7965,7490,475,511,00:00:33.000,2025-04-15 11:59:29.015
false,false,7979,7501,478,253,00:00:30.000,2025-04-15 11:59:49.036
false,true,7993,7515,478,0,00:00:00.000,2025-04-15 12:00:09.054
false,true,8304,7810,494,0,00:00:00.000,2025-04-15 12:07:16.480
false,false,8307,7811,496,98,00:00:32.000,2025-04-15 12:07:23.488
false,false,8315,7819,496,354,00:00:32.000,2025-04-15 12:07:31.493
false,false,8334,7838,496,124,00:00:30.000,2025-04-15 12:08:02.521
false,false,8352,7855,497,345,00:00:31.000,2025-04-15 12:08:26.545
false,true,8356,7859,497,0,00:00:00.000,2025-04-15 12:08:31.551
false,false,8374,7876,498,559,00:00:30.000,2025-04-15 12:08:54.571
false,false,8396,7896,500,30,00:00:30.000,2025-04-15 12:09:22.598
false,true,8412,7911,501,0,00:00:00.000,2025-04-15 12:09:52.626
false,false,8418,7917,501,191,00:00:33.000,2025-04-15 12:10:02.634
false,false,8419,7917,502,221,00:00:30.000,2025-04-15 12:10:03.635
false,false,8423,7921,502,350,00:00:32.000,2025-04-15 12:10:07.641
false,false,8450,7948,502,256,00:00:31.000,2025-04-15 12:10:46.674
false,true,8453,7951,502,0,00:00:00.000,2025-04-15 12:10:55.684
false,false,8486,7983,503,714,00:00:30.000,2025-04-15 12:11:34.725
false,true,8489,7986,503,0,00:00:00.000,2025-04-15 12:11:43.736
false,false,8212,7724,488,188,00:00:30.000,2025-04-15 12:05:24.370
false,false,8223,7734,489,532,00:00:32.000,2025-04-15 12:05:35.380
false,false,8224,7735,489,564,00:00:32.000,2025-04-15 12:05:36.381
false,true,8232,7741,491,0,00:00:00.000,2025-04-15 12:05:46.393
false,false,8246,7754,492,435,00:00:31.000,2025-04-15 12:06:04.409
false,true,8246,7754,492,0,00:00:00.000,2025-04-15 12:06:05.410
false,false,8258,7765,493,310,00:00:31.000,2025-04-15 12:06:28.430
false,true,8578,8073,505,0,00:00:00.000,2025-04-15 12:13:32.844
false,true,8578,8073,505,0,00:00:00.000,2025-04-15 12:13:36.846
false,false,8588,8082,506,31,00:00:31.000,2025-04-15 12:13:58.863
false,false,8705,8191,514,406,00:00:30.000,2025-04-15 12:17:02.042
false,false,8711,8196,515,187,00:00:33.000,2025-04-15 12:17:14.054
false,true,8639,8127,512,0,00:00:00.000,2025-04-15 12:15:13.936
false,false,8646,8134,512,222,00:00:32.000,2025-04-15 12:15:20.945
false,true,8651,8139,512,0,00:00:00.000,2025-04-15 12:15:27.949
false,false,8509,8005,504,632,00:00:30.000,2025-04-15 12:12:03.754
false,true,8513,8009,504,0,00:00:00.000,2025-04-15 12:12:10.762
false,true,8526,8021,505,0,00:00:00.000,2025-04-15 12:12:28.776
false,false,8541,8036,505,473,00:00:31.000,2025-04-15 12:12:47.797
false,false,8552,8047,505,188,00:00:33.000,2025-04-15 12:13:04.815
false,false,8566,8061,505,624,00:00:32.000,2025-04-15 12:13:18.831
false,false,8574,8069,505,883,00:00:33.000,2025-04-15 12:13:26.839
false,false,8794,8275,519,250,00:00:30.000,2025-04-15 12:18:55.155
false,false,8807,8287,520,219,00:00:32.000,2025-04-15 12:19:20.183
false,false,8815,8294,521,472,00:00:32.000,2025-04-15 12:19:28.190
false,false,8825,8304,521,248,00:00:30.000,2025-04-15 12:19:44.208
false,false,8832,8309,523,470,00:00:33.000,2025-04-15 12:19:51.216
false,false,8915,8385,530,565,00:00:32.000,2025-04-15 12:21:56.350
false,false,8944,8413,531,1473,00:00:33.000,2025-04-15 12:22:25.376
false,true,8964,8433,531,0,00:00:00.000,2025-04-15 12:22:56.408
false,false,8973,8440,533,285,00:00:32.000,2025-04-15 12:23:06.418
false,false,8983,8450,533,594,00:00:30.000,2025-04-15 12:23:16.427
false,false,8991,8458,533,841,00:00:32.000,2025-04-15 12:23:24.436
false,false,8873,8347,526,566,00:00:32.000,2025-04-15 12:20:44.274
false,false,8875,8349,526,630,00:00:33.000,2025-04-15 12:20:46.277
false,false,8884,8356,528,916,00:00:31.000,2025-04-15 12:20:55.286
false,false,8896,8367,529,96,00:00:30.000,2025-04-15 12:21:31.321
false,false,8903,8373,530,188,00:00:33.000,2025-04-15 12:21:44.336
false,true,9243,8691,552,0,00:00:00.000,2025-04-15 12:28:45.750
false,true,9248,8696,552,0,00:00:00.000,2025-04-15 12:28:59.763
false,false,9249,8697,552,31,00:00:31.000,2025-04-15 12:29:00.764
false,false,9272,8717,555,379,00:00:31.000,2025-04-15 12:29:29.797
false,false,9284,8728,556,222,00:00:33.000,2025-04-15 12:29:53.821
false,false,9290,8733,557,33,00:00:33.000,2025-04-15 12:30:05.833
false,false,9296,8738,558,225,00:00:32.000,2025-04-15 12:30:11.841
false,false,9069,8532,537,384,00:00:32.000,2025-04-15 12:25:12.535
false,false,9083,8542,541,826,00:00:32.000,2025-04-15 12:25:26.546
false,false,9092,8550,542,1113,00:00:33.000,2025-04-15 12:25:35.556
false,false,9109,8565,544,1645,00:00:31.000,2025-04-15 12:25:52.573
false,false,9152,8607,545,2990,00:00:33.000,2025-04-15 12:26:35.615
false,false,9189,8641,548,662,00:00:32.000,2025-04-15 12:27:30.664
false,false,9206,8657,549,499,00:00:31.000,2025-04-15 12:27:53.691
false,true,9208,8659,549,0,00:00:00.000,2025-04-15 12:28:01.700
false,false,9211,8662,549,94,00:00:33.000,2025-04-15 12:28:04.703
false,false,9228,8676,552,632,00:00:32.000,2025-04-15 12:28:21.724
false,false,9234,8682,552,819,00:00:33.000,2025-04-15 12:28:27.730
false,false,9237,8685,552,916,00:00:33.000,2025-04-15 12:28:30.734
false,false,9362,8801,561,251,00:00:30.000,2025-04-15 12:31:53.936
false,true,9368,8806,562,0,00:00:00.000,2025-04-15 12:32:09.953
false,false,9377,8815,562,222,00:00:31.000,2025-04-15 12:32:32.977
false,true,9384,8822,562,0,00:00:00.000,2025-04-15 12:32:43.990
false,false,9400,8838,562,512,00:00:30.000,2025-04-15 12:33:02.010
false,true,9401,8839,562,0,00:00:00.000,2025-04-15 12:33:07.017
false,false,9022,8487,535,251,00:00:30.000,2025-04-15 12:24:07.474
false,false,9025,8490,535,343,00:00:31.000,2025-04-15 12:24:10.477
false,true,9028,8493,535,0,00:00:00.000,2025-04-15 12:24:16.481
false,false,9036,8500,536,247,00:00:30.000,2025-04-15 12:24:27.492
false,false,9037,8501,536,280,00:00:33.000,2025-04-15 12:24:28.493
false,false,9039,8503,536,342,00:00:30.000,2025-04-15 12:24:30.495
false,false,9044,8507,537,497,00:00:30.000,2025-04-15 12:24:35.497
false,true,9044,8507,537,0,00:00:00.000,2025-04-15 12:24:41.503
false,false,9067,8530,537,320,00:00:33.000,2025-04-15 12:25:10.534
false,false,9482,8918,564,158,00:00:33.000,2025-04-15 12:34:54.130
false,false,9488,8923,565,346,00:00:31.000,2025-04-15 12:35:00.135
false,false,9499,8932,567,692,00:00:31.000,2025-04-15 12:35:11.147
false,true,9501,8933,568,0,00:00:00.000,2025-04-15 12:35:14.152
false,true,9512,8944,568,0,00:00:00.000,2025-04-15 12:35:34.167
false,false,9514,8946,568,63,00:00:32.000,2025-04-15 12:35:38.172
false,false,9517,8949,568,155,00:00:30.000,2025-04-15 12:35:41.175
false,false,9526,8957,569,436,00:00:30.000,2025-04-15 12:35:50.186
false,true,9550,8978,572,0,00:00:00.000,2025-04-15 12:36:19.213
false,false,9551,8979,572,30,00:00:30.000,2025-04-15 12:36:27.221
false,false,9591,9018,573,316,00:00:30.000,2025-04-15 12:37:19.276
false,false,9596,9022,574,476,00:00:32.000,2025-04-15 12:37:24.282
false,true,9601,9027,574,0,00:00:00.000,2025-04-15 12:37:34.294
false,false,9422,8859,563,670,00:00:32.000,2025-04-15 12:33:36.051
false,false,9426,8863,563,796,00:00:30.000,2025-04-15 12:33:40.056
false,false,9452,8889,563,758,00:00:30.000,2025-04-15 12:34:12.092
false,true,9477,8913,564,0,00:00:00.000,2025-04-15 12:34:49.125
false,false,9638,9063,575,1166,00:00:31.000,2025-04-15 12:38:12.334
false,false,9674,9096,578,787,00:00:30.000,2025-04-15 12:38:54.382
false,true,9675,9097,578,0,00:00:00.000,2025-04-15 12:38:56.383
false,false,9677,9098,579,64,00:00:31.000,2025-04-15 12:39:03.389
false,true,9692,9113,579,0,00:00:00.000,2025-04-15 12:39:19.406
false,true,9701,9120,581,0,00:00:00.000,2025-04-15 12:39:36.428
false,false,9707,9126,581,189,00:00:33.000,2025-04-15 12:39:45.437
false,false,9708,9127,581,219,00:00:30.000,2025-04-15 12:39:46.439
false,false,1602,1507,95,467,00:00:30.000,2025-04-14 11:38:53.090
false,false,1606,1511,95,591,00:00:30.000,2025-04-14 11:39:01.098
false,false,1623,1526,97,160,00:00:32.000,2025-04-14 11:39:59.144
false,false,1800,1695,105,94,00:00:31.000,2025-04-14 11:48:41.524
false,false,1802,1697,105,157,00:00:32.000,2025-04-14 11:48:45.526
false,false,1803,1698,105,188,00:00:31.000,2025-04-14 11:48:47.526
false,false,1806,1701,105,282,00:00:31.000,2025-04-14 11:48:53.528
false,false,1819,1713,106,97,00:00:33.000,2025-04-14 11:49:31.560
false,true,1839,1731,108,0,00:00:00.000,2025-04-14 11:50:19.589
false,false,1845,1736,109,126,00:00:31.000,2025-04-14 11:50:47.613
false,false,1855,1745,110,437,00:00:33.000,2025-04-14 11:51:07.630
false,false,1872,1761,111,965,00:00:31.000,2025-04-14 11:51:41.656
false,false,1880,1769,111,1215,00:00:33.000,2025-04-14 11:51:57.666
false,true,1951,1836,115,0,00:00:00.000,2025-04-14 11:56:01.844
false,true,1977,1861,116,0,00:00:00.000,2025-04-14 11:57:27.916
false,true,1977,1861,116,0,00:00:00.000,2025-04-14 11:57:31.918
false,false,1988,1872,116,344,00:00:30.000,2025-04-14 11:57:57.938
false,true,1752,1648,104,0,00:00:00.000,2025-04-14 11:45:41.405
false,false,1758,1654,104,187,00:00:33.000,2025-04-14 11:45:53.413
false,true,1763,1659,104,0,00:00:00.000,2025-04-14 11:46:05.416
false,false,1765,1661,104,64,00:00:32.000,2025-04-14 11:46:19.426
false,false,1768,1664,104,162,00:00:33.000,2025-04-14 11:46:25.431
false,false,1776,1672,104,98,00:00:33.000,2025-04-14 11:46:53.452
false,false,1778,1674,104,30,00:00:30.000,2025-04-14 11:47:33.481
false,false,1779,1675,104,61,00:00:31.000,2025-04-14 11:47:35.482
false,false,1889,1776,113,287,00:00:33.000,2025-04-14 11:52:39.693
false,true,1894,1781,113,0,00:00:00.000,2025-04-14 11:52:53.699
false,false,1897,1784,113,94,00:00:32.000,2025-04-14 11:53:07.713
false,false,1900,1787,113,189,00:00:32.000,2025-04-14 11:53:13.718
false,false,1918,1805,113,502,00:00:31.000,2025-04-14 11:54:01.759
false,true,1924,1811,113,0,00:00:00.000,2025-04-14 11:54:17.771
false,true,1924,1811,113,0,00:00:00.000,2025-04-14 11:54:23.777
false,false,1925,1811,114,33,00:00:33.000,2025-04-14 11:54:27.780
false,true,1668,1569,99,0,00:00:00.000,2025-04-14 11:42:07.245
false,false,1680,1579,101,375,00:00:30.000,2025-04-14 11:42:41.268
false,false,1683,1582,101,467,00:00:30.000,2025-04-14 11:42:47.273
false,false,1701,1599,102,61,00:00:31.000,2025-04-14 11:43:35.312
false,false,1706,1604,102,214,00:00:33.000,2025-04-14 11:43:45.318
false,false,1729,1625,104,376,00:00:31.000,2025-04-14 11:44:43.361
false,false,1733,1629,104,504,00:00:32.000,2025-04-14 11:44:51.366
false,true,2258,2129,129,0,00:00:00.000,2025-04-14 12:08:42.382
false,true,2258,2129,129,0,00:00:00.000,2025-04-14 12:08:46.384
false,false,2262,2133,129,129,00:00:33.000,2025-04-14 12:08:54.392
false,false,2279,2150,129,32,00:00:32.000,2025-04-14 12:09:40.428
false,false,2287,2158,129,283,00:00:31.000,2025-04-14 12:09:56.440
false,false,2288,2159,129,315,00:00:32.000,2025-04-14 12:09:58.442
false,true,2304,2174,130,0,00:00:00.000,2025-04-14 12:10:46.483
false,true,2304,2174,130,0,00:00:00.000,2025-04-14 12:10:48.483
false,false,2309,2179,130,154,00:00:30.000,2025-04-14 12:11:04.491
false,false,2320,2190,130,502,00:00:31.000,2025-04-14 12:11:26.509
false,false,2331,2200,131,856,00:00:33.000,2025-04-14 12:11:48.525
false,true,2185,2061,124,0,00:00:00.000,2025-04-14 12:05:58.278
false,false,2194,2069,125,283,00:00:32.000,2025-04-14 12:06:26.296
false,false,2200,2074,126,473,00:00:33.000,2025-04-14 12:06:38.301
false,false,2237,2109,128,1637,00:00:33.000,2025-04-14 12:07:52.349
false,false,2255,2126,129,2211,00:00:32.000,2025-04-14 12:08:28.374
false,false,2004,1887,117,30,00:00:30.000,2025-04-14 11:58:41.976
false,false,2028,1911,117,786,00:00:33.000,2025-04-14 11:59:30.007
false,false,2030,1913,117,848,00:00:32.000,2025-04-14 11:59:34.009
false,false,2046,1928,118,127,00:00:33.000,2025-04-14 12:00:18.045
false,false,2055,1937,118,411,00:00:32.000,2025-04-14 12:00:36.062
false,false,2056,1938,118,442,00:00:31.000,2025-04-14 12:00:38.062
false,false,2061,1943,118,600,00:00:32.000,2025-04-14 12:00:48.069
false,false,2066,1947,119,126,00:00:33.000,2025-04-14 12:01:10.088
false,false,2408,2274,134,30,00:00:30.000,2025-04-14 12:15:34.691
false,false,2450,2312,138,30,00:00:30.000,2025-04-14 12:17:22.776
false,true,2451,2313,138,0,00:00:00.000,2025-04-14 12:17:32.786
false,true,2455,2317,138,0,00:00:00.000,2025-04-14 12:17:52.797
false,false,2457,2319,138,60,00:00:30.000,2025-04-14 12:18:00.804
false,false,2464,2326,138,281,00:00:30.000,2025-04-14 12:18:14.812
false,true,2347,2216,131,0,00:00:00.000,2025-04-14 12:12:40.559
false,false,2350,2219,131,60,00:00:30.000,2025-04-14 12:13:02.574
false,false,2351,2220,131,93,00:00:33.000,2025-04-14 12:13:04.575
false,false,2124,2004,120,411,00:00:33.000,2025-04-14 12:03:18.174
false,true,2137,2017,120,0,00:00:00.000,2025-04-14 12:03:52.193
false,true,2162,2040,122,0,00:00:00.000,2025-04-14 12:05:00.241
false,true,2162,2040,122,0,00:00:00.000,2025-04-14 12:05:08.246
false,false,2477,2339,138,411,00:00:31.000,2025-04-14 12:18:52.837
false,false,2507,2367,140,1355,00:00:33.000,2025-04-14 12:19:52.863
false,false,2541,2399,142,978,00:00:32.000,2025-04-14 12:21:12.924
false,false,2554,2409,145,1396,00:00:31.000,2025-04-14 12:21:38.948
false,false,2559,2413,146,1555,00:00:33.000,2025-04-14 12:21:48.958
false,false,2586,2439,147,602,00:00:33.000,2025-04-14 12:22:55.013
false,false,2611,2461,150,30,00:00:30.000,2025-04-14 12:24:21.076
false,false,2629,2479,150,601,00:00:32.000,2025-04-14 12:24:57.099
false,false,2727,2565,162,621,00:00:32.000,2025-04-14 12:28:49.279
false,false,2730,2568,162,716,00:00:30.000,2025-04-14 12:28:55.284
false,false,2750,2588,162,252,00:00:31.000,2025-04-14 12:30:11.337
false,false,2751,2589,162,282,00:00:30.000,2025-04-14 12:30:13.340
false,true,2758,2595,163,0,00:00:00.000,2025-04-14 12:30:57.372
false,true,2758,2595,163,0,00:00:00.000,2025-04-14 12:31:01.377
false,false,2773,2610,163,30,00:00:30.000,2025-04-14 12:31:45.405
false,false,2644,2492,152,1069,00:00:32.000,2025-04-14 12:25:27.119
false,false,2656,2500,156,1449,00:00:33.000,2025-04-14 12:25:51.135
false,true,2660,2504,156,0,00:00:00.000,2025-04-14 12:26:07.144
false,false,2666,2510,156,192,00:00:33.000,2025-04-14 12:26:23.156
false,false,2667,2510,157,223,00:00:31.000,2025-04-14 12:26:25.158
false,false,2668,2511,157,254,00:00:31.000,2025-04-14 12:26:27.160
false,false,2676,2519,157,66,00:00:33.000,2025-04-14 12:26:55.185
false,false,2719,2558,161,369,00:00:30.000,2025-04-14 12:28:33.268
false,false,2798,2634,164,756,00:00:32.000,2025-04-14 12:32:47.447
false,false,2803,2638,165,127,00:00:32.000,2025-04-14 12:33:09.465
false,false,2804,2638,166,158,00:00:31.000,2025-04-14 12:33:11.466
false,false,2819,2652,167,633,00:00:32.000,2025-04-14 12:33:41.484
false,false,2835,2668,167,189,00:00:33.000,2025-04-14 12:34:37.525
false,false,2839,2672,167,315,00:00:30.000,2025-04-14 12:34:45.530
false,false,2869,2699,170,567,00:00:32.000,2025-04-14 12:36:09.589
false,false,8052,7573,479,534,00:00:30.000,2025-04-15 12:01:26.131
false,true,8121,7637,484,0,00:00:00.000,2025-04-15 12:03:31.255
false,true,8121,7637,484,0,00:00:00.000,2025-04-15 12:03:32.257
false,false,8124,7639,485,92,00:00:32.000,2025-04-15 12:03:38.264
false,false,8136,7651,485,467,00:00:31.000,2025-04-15 12:03:50.275
false,false,8145,7659,486,751,00:00:33.000,2025-04-15 12:03:59.284
false,false,8153,7667,486,1008,00:00:33.000,2025-04-15 12:04:07.293
false,false,8186,7699,487,882,00:00:32.000,2025-04-15 12:04:46.339
false,false,8199,7712,487,125,00:00:30.000,2025-04-15 12:05:05.355
false,false,8076,7594,482,159,00:00:33.000,2025-04-15 12:02:02.161
false,true,8087,7604,483,0,00:00:00.000,2025-04-15 12:02:18.176
false,false,8091,7607,484,128,00:00:32.000,2025-04-15 12:02:23.181
false,true,8091,7607,484,0,00:00:00.000,2025-04-15 12:02:28.185
false,true,8108,7624,484,0,00:00:00.000,2025-04-15 12:02:54.215
false,false,8111,7627,484,94,00:00:31.000,2025-04-15 12:03:01.222
false,true,8121,7637,484,0,00:00:00.000,2025-04-15 12:03:21.242
false,false,7939,7464,475,92,00:00:30.000,2025-04-15 11:58:50.975
false,false,7940,7465,475,123,00:00:31.000,2025-04-15 11:58:51.976
false,false,7945,7470,475,97,00:00:33.000,2025-04-15 11:59:02.989
false,true,7949,7474,475,0,00:00:00.000,2025-04-15 11:59:11.994
false,false,7951,7476,475,66,00:00:33.000,2025-04-15 11:59:14.999
false,false,7952,7477,475,96,00:00:30.000,2025-04-15 11:59:16.000
false,false,7972,7496,476,32,00:00:32.000,2025-04-15 11:59:42.030
false,false,7974,7498,476,94,00:00:31.000,2025-04-15 11:59:44.032
false,false,8297,7803,494,1532,00:00:30.000,2025-04-15 12:07:07.473
false,false,8322,7826,496,576,00:00:30.000,2025-04-15 12:07:38.502
false,true,8325,7829,496,0,00:00:00.000,2025-04-15 12:07:47.508
false,false,8328,7832,496,95,00:00:32.000,2025-04-15 12:07:50.510
false,true,8330,7834,496,0,00:00:00.000,2025-04-15 12:07:56.515
false,false,8333,7837,496,94,00:00:33.000,2025-04-15 12:08:01.520
false,false,8335,7839,496,157,00:00:33.000,2025-04-15 12:08:03.521
false,false,8348,7851,497,223,00:00:30.000,2025-04-15 12:08:22.543
false,false,8364,7867,497,246,00:00:33.000,2025-04-15 12:08:44.563
false,false,8388,7888,500,996,00:00:33.000,2025-04-15 12:09:08.584
false,true,8395,7895,500,0,00:00:00.000,2025-04-15 12:09:16.590
false,false,8405,7905,500,314,00:00:32.000,2025-04-15 12:09:31.605
false,false,8420,7918,502,253,00:00:32.000,2025-04-15 12:10:04.636
false,true,8428,7926,502,0,00:00:00.000,2025-04-15 12:10:13.644
false,true,8442,7940,502,0,00:00:00.000,2025-04-15 12:10:33.663
false,false,8472,7970,502,280,00:00:30.000,2025-04-15 12:11:20.707
false,true,8489,7986,503,0,00:00:00.000,2025-04-15 12:11:40.732
false,false,8493,7990,503,125,00:00:30.000,2025-04-15 12:11:47.738
false,false,8230,7739,491,754,00:00:33.000,2025-04-15 12:05:42.388
false,false,8243,7751,492,342,00:00:32.000,2025-04-15 12:06:01.407
false,false,8249,7757,492,30,00:00:30.000,2025-04-15 12:06:19.421
false,false,8262,7769,493,440,00:00:33.000,2025-04-15 12:06:32.434
false,false,8270,7777,493,685,00:00:31.000,2025-04-15 12:06:40.445
false,false,8273,7780,493,780,00:00:32.000,2025-04-15 12:06:43.449
false,false,8276,7783,493,874,00:00:32.000,2025-04-15 12:06:46.452
false,false,8277,7783,494,904,00:00:30.000,2025-04-15 12:06:47.453
false,true,8580,8075,505,0,00:00:00.000,2025-04-15 12:13:39.847
false,false,8582,8077,505,60,00:00:30.000,2025-04-15 12:13:46.854
false,false,8583,8078,505,91,00:00:31.000,2025-04-15 12:13:47.855
false,false,8586,8080,506,185,00:00:31.000,2025-04-15 12:13:50.857
false,true,8594,8087,507,0,00:00:00.000,2025-04-15 12:14:08.874
false,false,8617,8108,509,719,00:00:33.000,2025-04-15 12:14:39.905
false,true,8625,8115,510,0,00:00:00.000,2025-04-15 12:14:51.913
false,false,8716,8201,515,340,00:00:31.000,2025-04-15 12:17:19.059
false,false,8758,8240,518,252,00:00:31.000,2025-04-15 12:18:07.109
false,false,8640,8128,512,31,00:00:31.000,2025-04-15 12:15:14.937
false,false,8650,8138,512,346,00:00:30.000,2025-04-15 12:15:24.948
false,false,8679,8166,513,155,00:00:30.000,2025-04-15 12:16:17.997
false,true,8686,8173,513,0,00:00:00.000,2025-04-15 12:16:37.017
false,true,8692,8179,513,0,00:00:00.000,2025-04-15 12:16:46.027
false,true,8692,8179,513,0,00:00:00.000,2025-04-15 12:16:48.029
false,false,8550,8045,505,123,00:00:31.000,2025-04-15 12:13:02.812
false,false,8575,8070,505,914,00:00:31.000,2025-04-15 12:13:27.839
false,true,8786,8267,519,0,00:00:00.000,2025-04-15 12:18:46.147
false,false,8793,8274,519,220,00:00:30.000,2025-04-15 12:18:54.154
false,false,8795,8276,519,283,00:00:33.000,2025-04-15 12:18:56.156
false,false,8804,8284,520,124,00:00:32.000,2025-04-15 12:19:17.179
false,false,8817,8296,521,533,00:00:31.000,2025-04-15 12:19:30.194
false,true,8817,8296,521,0,00:00:00.000,2025-04-15 12:19:33.196
false,true,8817,8296,521,0,00:00:00.000,2025-04-15 12:19:34.197
false,false,8829,8307,522,372,00:00:31.000,2025-04-15 12:19:48.213
false,true,8840,8317,523,0,00:00:00.000,2025-04-15 12:20:01.225
false,false,8843,8320,523,93,00:00:32.000,2025-04-15 12:20:08.233
false,false,8913,8383,530,502,00:00:32.000,2025-04-15 12:21:54.347
false,false,8929,8399,530,1000,00:00:30.000,2025-04-15 12:22:10.364
false,false,8937,8406,531,1251,00:00:30.000,2025-04-15 12:22:18.371
false,false,8960,8429,531,124,00:00:31.000,2025-04-15 12:22:47.398
false,false,8961,8430,531,154,00:00:30.000,2025-04-15 12:22:48.399
false,false,8992,8459,533,873,00:00:32.000,2025-04-15 12:23:25.438
false,false,8848,8324,524,251,00:00:33.000,2025-04-15 12:20:13.241
false,false,8858,8334,524,97,00:00:33.000,2025-04-15 12:20:29.258
false,false,8864,8338,526,287,00:00:30.000,2025-04-15 12:20:35.266
false,false,8889,8360,529,96,00:00:32.000,2025-04-15 12:21:06.297
false,true,8890,8361,529,0,00:00:00.000,2025-04-15 12:21:10.303
false,true,8893,8364,529,0,00:00:00.000,2025-04-15 12:21:26.318
false,false,8901,8372,529,124,00:00:31.000,2025-04-15 12:21:42.333
false,true,9243,8691,552,0,00:00:00.000,2025-04-15 12:28:46.751
false,true,9277,8721,556,0,00:00:00.000,2025-04-15 12:29:40.811
false,false,9080,8541,539,731,00:00:31.000,2025-04-15 12:25:23.542
false,false,9091,8549,542,1080,00:00:33.000,2025-04-15 12:25:34.553
false,false,9111,8567,544,1706,00:00:30.000,2025-04-15 12:25:54.574
false,false,9130,8586,544,2297,00:00:30.000,2025-04-15 12:26:13.594
false,false,9144,8599,545,2736,00:00:32.000,2025-04-15 12:26:27.606
false,false,9163,8618,545,339,00:00:30.000,2025-04-15 12:26:52.632
false,false,9178,8630,548,315,00:00:32.000,2025-04-15 12:27:19.655
false,true,9190,8642,548,0,00:00:00.000,2025-04-15 12:27:33.668
false,true,9190,8642,548,0,00:00:00.000,2025-04-15 12:27:35.670
false,true,9208,8659,549,0,00:00:00.000,2025-04-15 12:27:58.695
false,false,9236,8684,552,883,00:00:31.000,2025-04-15 12:28:29.733
false,false,9352,8791,561,910,00:00:30.000,2025-04-15 12:31:31.913
false,true,9354,8793,561,0,00:00:00.000,2025-04-15 12:31:40.921
false,true,9354,8793,561,0,00:00:00.000,2025-04-15 12:31:43.925
false,false,9358,8797,561,125,00:00:32.000,2025-04-15 12:31:49.932
false,true,9364,8802,562,0,00:00:00.000,2025-04-15 12:32:01.945
false,true,9370,8808,562,0,00:00:00.000,2025-04-15 12:32:23.967
false,false,9371,8809,562,30,00:00:30.000,2025-04-15 12:32:26.971
false,false,9376,8814,562,191,00:00:33.000,2025-04-15 12:32:31.976
false,false,9381,8819,562,348,00:00:32.000,2025-04-15 12:32:36.981
false,true,9384,8822,562,0,00:00:00.000,2025-04-15 12:32:42.988
false,true,9401,8839,562,0,00:00:00.000,2025-04-15 12:33:04.013
false,false,9000,8467,533,1129,00:00:31.000,2025-04-15 12:23:33.445
false,true,9002,8469,533,0,00:00:00.000,2025-04-15 12:23:41.451
false,true,9057,8520,537,0,00:00:00.000,2025-04-15 12:24:58.520
false,false,9058,8521,537,31,00:00:31.000,2025-04-15 12:25:01.523
false,false,9063,8526,537,191,00:00:33.000,2025-04-15 12:25:06.528
false,false,9502,8934,568,33,00:00:33.000,2025-04-15 12:35:20.157
false,false,9519,8951,568,218,00:00:31.000,2025-04-15 12:35:43.177
false,true,9550,8978,572,0,00:00:00.000,2025-04-15 12:36:16.209
false,true,9550,8978,572,0,00:00:00.000,2025-04-15 12:36:17.210
false,false,9559,8987,572,187,00:00:30.000,2025-04-15 12:36:41.238
false,false,9567,8995,572,439,00:00:32.000,2025-04-15 12:36:49.244
false,false,9570,8998,572,534,00:00:31.000,2025-04-15 12:36:52.248
false,false,9575,9002,573,693,00:00:31.000,2025-04-15 12:36:57.253
false,false,9600,9026,574,601,00:00:30.000,2025-04-15 12:37:28.287
false,true,9601,9027,574,0,00:00:00.000,2025-04-15 12:37:33.293
false,false,9604,9030,574,94,00:00:32.000,2025-04-15 12:37:38.299
false,false,9616,9041,575,470,00:00:30.000,2025-04-15 12:37:50.309
false,true,9401,8839,562,0,00:00:00.000,2025-04-15 12:33:11.021
false,true,9401,8839,562,0,00:00:00.000,2025-04-15 12:33:12.022
false,true,9401,8839,562,0,00:00:00.000,2025-04-15 12:33:15.025
false,false,9428,8865,563,860,00:00:32.000,2025-04-15 12:33:42.056
false,true,9428,8865,563,0,00:00:00.000,2025-04-15 12:33:43.058
false,false,9429,8866,563,32,00:00:32.000,2025-04-15 12:33:49.066
false,false,9431,8868,563,94,00:00:31.000,2025-04-15 12:33:51.069
false,true,9477,8913,564,0,00:00:00.000,2025-04-15 12:34:46.123
false,false,9645,9070,575,1386,00:00:31.000,2025-04-15 12:38:19.345
false,true,9649,9074,575,0,00:00:00.000,2025-04-15 12:38:24.347
false,true,9649,9074,575,0,00:00:00.000,2025-04-15 12:38:26.351
false,false,9681,9102,579,184,00:00:30.000,2025-04-15 12:39:07.393
false,true,9692,9113,579,0,00:00:00.000,2025-04-15 12:39:20.409
false,false,9698,9119,579,189,00:00:31.000,2025-04-15 12:39:30.419
false,false,1604,1509,95,528,00:00:30.000,2025-04-14 11:38:57.095
false,false,1630,1532,98,123,00:00:30.000,2025-04-14 11:40:25.163
false,false,1633,1535,98,219,00:00:33.000,2025-04-14 11:40:31.171
false,false,1639,1541,98,407,00:00:31.000,2025-04-14 11:40:43.180
false,true,1657,1559,98,0,00:00:00.000,2025-04-14 11:41:21.209
false,false,1658,1560,98,33,00:00:33.000,2025-04-14 11:41:33.217
false,false,1664,1565,99,224,00:00:31.000,2025-04-14 11:41:45.226
false,false,1808,1703,105,347,00:00:32.000,2025-04-14 11:48:57.533
false,false,1830,1724,106,442,00:00:31.000,2025-04-14 11:49:53.574
false,true,1841,1732,109,0,00:00:00.000,2025-04-14 11:50:29.599
false,true,1841,1732,109,0,00:00:00.000,2025-04-14 11:50:37.606
false,false,1847,1737,110,189,00:00:33.000,2025-04-14 11:50:51.617
false,false,1851,1741,110,314,00:00:31.000,2025-04-14 11:50:59.624
false,false,1856,1746,110,470,00:00:33.000,2025-04-14 11:51:09.631
false,false,1861,1751,110,627,00:00:31.000,2025-04-14 11:51:19.639
false,false,1874,1763,111,1026,00:00:30.000,2025-04-14 11:51:45.657
false,true,1950,1835,115,0,00:00:00.000,2025-04-14 11:55:35.827
false,true,1950,1835,115,0,00:00:00.000,2025-04-14 11:55:37.830
false,false,1751,1647,104,1079,00:00:32.000,2025-04-14 11:45:27.396
false,true,1752,1648,104,0,00:00:00.000,2025-04-14 11:45:33.401
false,true,1752,1648,104,0,00:00:00.000,2025-04-14 11:45:39.404
false,false,1772,1668,104,286,00:00:30.000,2025-04-14 11:46:33.436
false,true,1776,1672,104,0,00:00:00.000,2025-04-14 11:47:05.459
false,true,1777,1673,104,0,00:00:00.000,2025-04-14 11:47:17.470
false,true,1777,1673,104,0,00:00:00.000,2025-04-14 11:47:31.481
false,false,1882,1771,111,60,00:00:30.000,2025-04-14 11:52:25.683
false,false,1892,1779,113,380,00:00:33.000,2025-04-14 11:52:45.696
false,false,1893,1780,113,411,00:00:31.000,2025-04-14 11:52:47.698
false,true,1894,1781,113,0,00:00:00.000,2025-04-14 11:52:57.704
false,true,1894,1781,113,0,00:00:00.000,2025-04-14 11:53:01.708
false,false,1915,1802,113,407,00:00:30.000,2025-04-14 11:53:55.752
false,true,1926,1812,114,0,00:00:00.000,2025-04-14 11:54:41.787
false,true,1667,1568,99,0,00:00:00.000,2025-04-14 11:41:59.238
false,false,1700,1598,102,30,00:00:30.000,2025-04-14 11:43:33.310
false,false,1702,1600,102,91,00:00:30.000,2025-04-14 11:43:37.313
false,false,1711,1609,102,367,00:00:30.000,2025-04-14 11:43:55.327
false,false,1714,1612,102,460,00:00:30.000,2025-04-14 11:44:01.331
false,false,1724,1621,103,223,00:00:33.000,2025-04-14 11:44:33.355
false,false,1727,1624,103,314,00:00:30.000,2025-04-14 11:44:39.359
false,false,2304,2174,130,439,00:00:33.000,2025-04-14 12:10:42.479
false,false,2315,2185,130,341,00:00:30.000,2025-04-14 12:11:16.499
false,false,2325,2195,130,661,00:00:32.000,2025-04-14 12:11:36.516
false,false,2327,2197,130,725,00:00:33.000,2025-04-14 12:11:40.519
false,false,2336,2205,131,1017,00:00:31.000,2025-04-14 12:11:58.531
false,false,2172,2049,123,312,00:00:30.000,2025-04-14 12:05:30.263
false,false,2182,2059,123,627,00:00:33.000,2025-04-14 12:05:50.274
false,false,2186,2062,124,31,00:00:31.000,2025-04-14 12:06:10.286
false,false,2195,2070,125,315,00:00:32.000,2025-04-14 12:06:28.297
false,false,2206,2079,127,663,00:00:33.000,2025-04-14 12:06:50.310
false,false,2243,2115,128,1830,00:00:33.000,2025-04-14 12:08:04.360
false,false,2017,1900,117,434,00:00:31.000,2025-04-14 11:59:07.992
false,false,2019,1902,117,499,00:00:33.000,2025-04-14 11:59:11.995
false,false,2031,1914,117,879,00:00:31.000,2025-04-14 11:59:36.013
false,false,2047,1929,118,158,00:00:31.000,2025-04-14 12:00:20.046
false,false,2058,1940,118,504,00:00:31.000,2025-04-14 12:00:42.065
false,true,2062,1944,118,0,00:00:00.000,2025-04-14 12:00:54.073
false,false,2067,1948,119,157,00:00:31.000,2025-04-14 12:01:12.089
false,false,2072,1953,119,319,00:00:31.000,2025-04-14 12:01:22.096
false,false,2080,1961,119,576,00:00:33.000,2025-04-14 12:01:38.102
false,false,2431,2295,136,761,00:00:33.000,2025-04-14 12:16:20.725
false,false,2435,2298,137,887,00:00:33.000,2025-04-14 12:16:28.731
false,true,2435,2298,137,0,00:00:00.000,2025-04-14 12:16:30.734
false,false,2436,2299,137,31,00:00:31.000,2025-04-14 12:16:42.742
false,false,2445,2307,138,314,00:00:32.000,2025-04-14 12:17:00.758
false,true,2451,2313,138,0,00:00:00.000,2025-04-14 12:17:36.787
false,true,2340,2209,131,0,00:00:00.000,2025-04-14 12:12:16.544
false,true,2359,2228,131,0,00:00:00.000,2025-04-14 12:13:28.593
false,false,2368,2236,132,289,00:00:32.000,2025-04-14 12:13:50.608
false,false,2373,2241,132,448,00:00:30.000,2025-04-14 12:14:00.615
false,false,2405,2271,134,572,00:00:32.000,2025-04-14 12:15:16.680
false,false,2103,1984,119,1302,00:00:31.000,2025-04-14 12:02:24.130
false,true,2111,1992,119,0,00:00:00.000,2025-04-14 12:02:42.146
false,false,2159,2037,122,33,00:00:33.000,2025-04-14 12:04:52.236
false,true,2162,2040,122,0,00:00:00.000,2025-04-14 12:05:10.246
false,false,2474,2336,138,318,00:00:32.000,2025-04-14 12:18:46.834
false,false,2502,2363,139,1196,00:00:32.000,2025-04-14 12:19:42.857
false,false,2506,2367,139,1322,00:00:33.000,2025-04-14 12:19:50.862
false,false,2516,2374,142,186,00:00:30.000,2025-04-14 12:20:22.883
false,false,2558,2412,146,1522,00:00:32.000,2025-04-14 12:21:46.955
false,false,2590,2443,147,63,00:00:32.000,2025-04-14 12:23:15.027
false,false,2597,2449,148,285,00:00:30.000,2025-04-14 12:23:29.037
false,true,2608,2458,150,0,00:00:00.000,2025-04-14 12:23:57.057
false,false,2610,2460,150,60,00:00:30.000,2025-04-14 12:24:07.066
false,true,2610,2460,150,0,00:00:00.000,2025-04-14 12:24:13.070
false,false,2613,2463,150,93,00:00:32.000,2025-04-14 12:24:25.077
false,false,2733,2571,162,806,00:00:30.000,2025-04-14 12:29:01.289
false,true,2733,2571,162,0,00:00:00.000,2025-04-14 12:29:11.294
false,false,2643,2491,152,1037,00:00:30.000,2025-04-14 12:25:25.117
false,false,2646,2494,152,1132,00:00:31.000,2025-04-14 12:25:31.119
false,false,2665,2509,156,159,00:00:32.000,2025-04-14 12:26:21.153
false,true,2674,2517,157,0,00:00:00.000,2025-04-14 12:26:41.171
false,false,2692,2534,158,575,00:00:30.000,2025-04-14 12:27:27.213
false,false,2778,2615,163,127,00:00:31.000,2025-04-14 12:32:07.421
false,false,2793,2629,164,594,00:00:33.000,2025-04-14 12:32:37.439
false,true,2799,2635,164,0,00:00:00.000,2025-04-14 12:32:51.450
false,true,2799,2635,164,0,00:00:00.000,2025-04-14 12:32:53.452
false,false,2805,2639,166,188,00:00:30.000,2025-04-14 12:33:13.467
false,false,2823,2656,167,61,00:00:30.000,2025-04-14 12:34:01.497
false,false,2827,2660,167,189,00:00:31.000,2025-04-14 12:34:09.505
false,true,8121,7637,484,0,00:00:00.000,2025-04-15 12:03:34.258
false,false,8125,7640,485,124,00:00:32.000,2025-04-15 12:03:39.266
false,false,8143,7657,486,686,00:00:30.000,2025-04-15 12:03:57.282
false,true,8158,7672,486,0,00:00:00.000,2025-04-15 12:04:17.306
false,false,8159,7673,486,32,00:00:32.000,2025-04-15 12:04:19.308
false,false,8167,7680,487,287,00:00:33.000,2025-04-15 12:04:27.316
false,false,8180,7693,487,691,00:00:30.000,2025-04-15 12:04:40.332
false,true,8195,7708,487,0,00:00:00.000,2025-04-15 12:04:56.349
false,false,8088,7604,484,32,00:00:32.000,2025-04-15 12:02:20.178
false,false,8115,7631,484,221,00:00:32.000,2025-04-15 12:03:05.225
false,true,8119,7635,484,0,00:00:00.000,2025-04-15 12:03:15.236
false,true,8121,7637,484,0,00:00:00.000,2025-04-15 12:03:20.241
false,false,7942,7467,475,185,00:00:32.000,2025-04-15 11:58:53.978
false,false,7962,7487,475,414,00:00:33.000,2025-04-15 11:59:26.012
false,false,7985,7507,478,442,00:00:33.000,2025-04-15 11:59:55.043
false,false,7987,7509,478,504,00:00:32.000,2025-04-15 11:59:57.044
false,false,7988,7510,478,534,00:00:30.000,2025-04-15 11:59:58.045
false,false,7993,7515,478,694,00:00:33.000,2025-04-15 12:00:03.048
false,false,8281,7787,494,1030,00:00:31.000,2025-04-15 12:06:51.457
false,false,8300,7806,494,1624,00:00:31.000,2025-04-15 12:07:10.475
false,false,8329,7833,496,127,00:00:32.000,2025-04-15 12:07:51.510
false,true,8341,7845,496,0,00:00:00.000,2025-04-15 12:08:10.529
false,false,8350,7853,497,284,00:00:31.000,2025-04-15 12:08:24.544
false,false,8353,7856,497,376,00:00:31.000,2025-04-15 12:08:27.546
false,false,8378,7879,499,684,00:00:33.000,2025-04-15 12:08:58.575
false,false,8395,7895,500,1214,00:00:30.000,2025-04-15 12:09:15.590
false,true,8409,7908,501,0,00:00:00.000,2025-04-15 12:09:41.615
false,false,8430,7928,502,64,00:00:33.000,2025-04-15 12:10:20.651
false,true,8442,7940,502,0,00:00:00.000,2025-04-15 12:10:34.663
false,false,8451,7949,502,286,00:00:30.000,2025-04-15 12:10:47.676
false,false,8492,7989,503,95,00:00:31.000,2025-04-15 12:11:46.738
false,false,8210,7722,488,126,00:00:30.000,2025-04-15 12:05:22.368
false,true,8246,7754,492,0,00:00:00.000,2025-04-15 12:06:08.412
false,false,8271,7778,493,717,00:00:32.000,2025-04-15 12:06:41.445
false,false,8279,7785,494,966,00:00:32.000,2025-04-15 12:06:49.453
false,false,8584,8078,506,124,00:00:33.000,2025-04-15 12:13:48.856
false,true,8587,8081,506,0,00:00:00.000,2025-04-15 12:13:54.859
false,true,8594,8087,507,0,00:00:00.000,2025-04-15 12:14:13.877
false,true,8594,8087,507,0,00:00:00.000,2025-04-15 12:14:14.879
false,false,8599,8091,508,158,00:00:33.000,2025-04-15 12:14:21.887
false,false,8626,8116,510,33,00:00:33.000,2025-04-15 12:14:54.918
false,true,8705,8191,514,0,00:00:00.000,2025-04-15 12:17:04.044
false,true,8705,8191,514,0,00:00:00.000,2025-04-15 12:17:07.048
false,false,8731,8216,515,818,00:00:31.000,2025-04-15 12:17:34.072
false,false,8734,8219,515,911,00:00:31.000,2025-04-15 12:17:37.074
false,false,8746,8228,518,1291,00:00:31.000,2025-04-15 12:17:49.090
false,false,8769,8251,518,598,00:00:32.000,2025-04-15 12:18:18.118
false,false,8645,8133,512,190,00:00:33.000,2025-04-15 12:15:19.942
false,true,8651,8139,512,0,00:00:00.000,2025-04-15 12:15:30.952
false,false,8688,8175,513,64,00:00:31.000,2025-04-15 12:16:39.021
false,false,8524,8019,505,345,00:00:33.000,2025-04-15 12:12:24.772
false,false,8527,8022,505,30,00:00:30.000,2025-04-15 12:12:33.781
false,false,8578,8073,505,1011,00:00:33.000,2025-04-15 12:13:30.843
false,true,8799,8280,519,0,00:00:00.000,2025-04-15 12:19:03.160
false,true,8799,8280,519,0,00:00:00.000,2025-04-15 12:19:05.161
false,true,8800,8281,519,0,00:00:00.000,2025-04-15 12:19:11.170
false,false,8914,8384,530,533,00:00:31.000,2025-04-15 12:21:55.349
false,false,8923,8393,530,811,00:00:31.000,2025-04-15 12:22:04.357
false,false,8950,8419,531,1664,00:00:30.000,2025-04-15 12:22:31.383
false,true,8956,8425,531,0,00:00:00.000,2025-04-15 12:22:42.395
false,true,8956,8425,531,0,00:00:00.000,2025-04-15 12:22:43.395
false,false,8958,8427,531,63,00:00:31.000,2025-04-15 12:22:45.396
false,false,8959,8428,531,93,00:00:30.000,2025-04-15 12:22:46.397
false,false,8965,8433,532,32,00:00:32.000,2025-04-15 12:22:58.410
false,false,8853,8329,524,411,00:00:32.000,2025-04-15 12:20:18.245
false,false,8869,8343,526,441,00:00:30.000,2025-04-15 12:20:40.271
false,false,8886,8357,529,979,00:00:33.000,2025-04-15 12:20:57.289
false,true,8886,8357,529,0,00:00:00.000,2025-04-15 12:21:00.290
false,false,8898,8369,529,30,00:00:30.000,2025-04-15 12:21:39.330
false,false,8908,8378,530,343,00:00:31.000,2025-04-15 12:21:49.342
false,true,9243,8691,552,0,00:00:00.000,2025-04-15 12:28:43.749
false,false,9252,8700,552,126,00:00:33.000,2025-04-15 12:29:03.767
false,true,9260,8708,552,0,00:00:00.000,2025-04-15 12:29:17.783
false,false,9266,8712,554,190,00:00:32.000,2025-04-15 12:29:23.790
false,false,9278,8722,556,30,00:00:30.000,2025-04-15 12:29:47.817
false,false,9292,8735,557,97,00:00:32.000,2025-04-15 12:30:07.836
false,false,9073,8535,538,513,00:00:32.000,2025-04-15 12:25:16.537
false,false,9076,8538,538,605,00:00:31.000,2025-04-15 12:25:19.539
false,false,9078,8540,538,667,00:00:30.000,2025-04-15 12:25:21.540
false,false,9118,8574,544,1925,00:00:30.000,2025-04-15 12:26:01.581
false,false,9136,8592,544,2486,00:00:31.000,2025-04-15 12:26:19.599
false,false,9141,8597,544,2643,00:00:32.000,2025-04-15 12:26:24.603
false,false,9146,8601,545,2798,00:00:31.000,2025-04-15 12:26:29.607
false,false,9162,8617,545,309,00:00:31.000,2025-04-15 12:26:51.631
false,false,9166,8621,545,434,00:00:30.000,2025-04-15 12:26:55.635
false,false,9172,8626,546,125,00:00:31.000,2025-04-15 12:27:13.650
false,true,9208,8659,549,0,00:00:00.000,2025-04-15 12:28:00.697
false,false,9214,8664,550,190,00:00:32.000,2025-04-15 12:28:07.707
false,false,9220,8669,551,377,00:00:30.000,2025-04-15 12:28:13.714
false,false,9364,8802,562,313,00:00:31.000,2025-04-15 12:31:55.938
false,false,9367,8805,562,92,00:00:31.000,2025-04-15 12:32:04.949
false,true,9368,8806,562,0,00:00:00.000,2025-04-15 12:32:15.958
false,false,9369,8807,562,33,00:00:33.000,2025-04-15 12:32:18.962
false,true,9370,8808,562,0,00:00:00.000,2025-04-15 12:32:21.964
false,false,9373,8811,562,93,00:00:33.000,2025-04-15 12:32:28.974
false,false,9384,8822,562,441,00:00:30.000,2025-04-15 12:32:39.985
false,false,9386,8824,562,64,00:00:31.000,2025-04-15 12:32:47.995
false,true,9002,8469,533,0,00:00:00.000,2025-04-15 12:23:39.450
false,false,9011,8478,533,285,00:00:31.000,2025-04-15 12:23:50.460
false,true,9044,8507,537,0,00:00:00.000,2025-04-15 12:24:40.501
false,false,9050,8513,537,187,00:00:31.000,2025-04-15 12:24:47.508
false,false,9061,8524,537,127,00:00:32.000,2025-04-15 12:25:04.526
false,false,9065,8528,537,255,00:00:33.000,2025-04-15 12:25:08.531
false,false,9498,8932,566,661,00:00:32.000,2025-04-15 12:35:10.146
false,false,9512,8944,568,349,00:00:31.000,2025-04-15 12:35:30.164
false,false,9518,8950,568,187,00:00:32.000,2025-04-15 12:35:42.176
false,false,9523,8954,569,343,00:00:30.000,2025-04-15 12:35:47.180
false,false,9529,8958,571,527,00:00:30.000,2025-04-15 12:35:53.190
false,true,9550,8978,572,0,00:00:00.000,2025-04-15 12:36:26.221
false,true,9553,8981,572,0,00:00:00.000,2025-04-15 12:36:31.225
false,false,9558,8986,572,157,00:00:30.000,2025-04-15 12:36:40.237
false,false,9568,8996,572,471,00:00:32.000,2025-04-15 12:36:50.245
false,false,9574,9002,572,662,00:00:33.000,2025-04-15 12:36:56.252
false,false,9597,9023,574,508,00:00:32.000,2025-04-15 12:37:25.285
false,false,9617,9042,575,502,00:00:32.000,2025-04-15 12:37:51.310
false,false,9415,8853,562,449,00:00:33.000,2025-04-15 12:33:29.042
false,false,9427,8864,563,828,00:00:32.000,2025-04-15 12:33:41.056
false,false,9434,8871,563,192,00:00:32.000,2025-04-15 12:33:54.074
false,false,9437,8874,563,282,00:00:30.000,2025-04-15 12:33:57.078
false,false,9339,8778,561,505,00:00:31.000,2025-04-15 12:31:18.905
false,false,9343,8782,561,626,00:00:31.000,2025-04-15 12:31:22.908
false,false,9345,8784,561,688,00:00:31.000,2025-04-15 12:31:24.909
false,true,9649,9074,575,0,00:00:00.000,2025-04-15 12:38:27.352
false,true,9649,9074,575,0,00:00:00.000,2025-04-15 12:38:28.353
false,false,9653,9077,576,128,00:00:32.000,2025-04-15 12:38:33.359
false,false,9663,9085,578,442,00:00:33.000,2025-04-15 12:38:43.370
false,true,9675,9097,578,0,00:00:00.000,2025-04-15 12:38:58.384
false,true,9675,9097,578,0,00:00:00.000,2025-04-15 12:38:59.384
false,false,9696,9117,579,126,00:00:32.000,2025-04-15 12:39:28.417
false,false,9710,9129,581,280,00:00:30.000,2025-04-15 12:39:48.440
false,false,1607,1512,95,622,00:00:31.000,2025-04-14 11:39:03.100
false,true,1614,1518,96,0,00:00:00.000,2025-04-14 11:39:21.117
false,false,1618,1521,97,125,00:00:30.000,2025-04-14 11:39:37.129
false,false,1651,1553,98,783,00:00:31.000,2025-04-14 11:41:07.201
false,true,1657,1559,98,0,00:00:00.000,2025-04-14 11:41:25.213
false,false,1660,1562,98,98,00:00:32.000,2025-04-14 11:41:37.222
false,false,1665,1566,99,256,00:00:32.000,2025-04-14 11:41:47.227
false,false,1824,1718,106,256,00:00:31.000,2025-04-14 11:49:41.565
false,false,1840,1732,108,30,00:00:30.000,2025-04-14 11:50:25.596
false,false,1852,1742,110,344,00:00:30.000,2025-04-14 11:51:01.627
false,false,1859,1749,110,565,00:00:30.000,2025-04-14 11:51:15.637
false,false,1864,1754,110,720,00:00:31.000,2025-04-14 11:51:25.643
false,false,1945,1831,114,600,00:00:33.000,2025-04-14 11:55:19.816
false,true,1950,1835,115,0,00:00:00.000,2025-04-14 11:55:41.832
false,true,1951,1836,115,0,00:00:00.000,2025-04-14 11:56:03.846
false,true,1951,1836,115,0,00:00:00.000,2025-04-14 11:56:05.848
false,false,1958,1843,115,221,00:00:33.000,2025-04-14 11:56:21.861
false,true,1959,1844,115,0,00:00:00.000,2025-04-14 11:56:43.881
false,true,1959,1844,115,0,00:00:00.000,2025-04-14 11:56:45.883
false,false,1962,1846,116,94,00:00:30.000,2025-04-14 11:56:53.891
false,false,1968,1852,116,285,00:00:32.000,2025-04-14 11:57:05.900
false,false,1972,1856,116,412,00:00:32.000,2025-04-14 11:57:13.905
false,false,1981,1865,116,127,00:00:33.000,2025-04-14 11:57:43.925
false,true,1752,1648,104,0,00:00:00.000,2025-04-14 11:45:35.402
false,false,1762,1658,104,309,00:00:31.000,2025-04-14 11:46:01.415
false,true,1763,1659,104,0,00:00:00.000,2025-04-14 11:46:07.417
false,true,1763,1659,104,0,00:00:00.000,2025-04-14 11:46:09.419
false,true,1763,1659,104,0,00:00:00.000,2025-04-14 11:46:15.424
false,false,1774,1670,104,32,00:00:32.000,2025-04-14 11:46:49.448
false,true,1797,1693,104,0,00:00:00.000,2025-04-14 11:48:25.516
false,true,1797,1693,104,0,00:00:00.000,2025-04-14 11:48:31.520
false,false,1798,1694,104,30,00:00:30.000,2025-04-14 11:48:37.523
false,true,1880,1769,111,0,00:00:00.000,2025-04-14 11:52:07.670
false,true,1894,1781,113,0,00:00:00.000,2025-04-14 11:52:55.701
false,false,1899,1786,113,157,00:00:31.000,2025-04-14 11:53:11.715
false,true,1902,1789,113,0,00:00:00.000,2025-04-14 11:53:23.727
false,false,1907,1794,113,155,00:00:33.000,2025-04-14 11:53:39.738
false,true,1668,1569,99,0,00:00:00.000,2025-04-14 11:42:15.250
false,false,1710,1608,102,337,00:00:30.000,2025-04-14 11:43:53.326
false,false,1712,1610,102,399,00:00:32.000,2025-04-14 11:43:57.328
false,false,2267,2138,129,287,00:00:33.000,2025-04-14 12:09:04.401
false,false,2272,2143,129,445,00:00:33.000,2025-04-14 12:09:14.409
false,true,2290,2161,129,0,00:00:00.000,2025-04-14 12:10:06.448
false,false,2295,2165,130,156,00:00:31.000,2025-04-14 12:10:24.466
false,false,2305,2175,130,31,00:00:31.000,2025-04-14 12:10:56.489
false,false,2310,2180,130,187,00:00:33.000,2025-04-14 12:11:06.492
false,false,2323,2193,130,596,00:00:31.000,2025-04-14 12:11:32.512
false,false,2204,2077,127,597,00:00:30.000,2025-04-14 12:06:46.306
false,false,2205,2078,127,630,00:00:33.000,2025-04-14 12:06:48.307
false,false,2212,2085,127,851,00:00:31.000,2025-04-14 12:07:02.318
false,false,2216,2089,127,979,00:00:33.000,2025-04-14 12:07:10.321
false,false,2221,2094,127,1137,00:00:32.000,2025-04-14 12:07:20.328
false,false,2228,2100,128,1353,00:00:31.000,2025-04-14 12:07:34.339
false,false,2231,2103,128,1446,00:00:31.000,2025-04-14 12:07:40.342
false,false,2244,2116,128,1863,00:00:33.000,2025-04-14 12:08:06.361
false,false,2248,2119,129,1988,00:00:32.000,2025-04-14 12:08:14.366
false,false,2250,2121,129,2051,00:00:31.000,2025-04-14 12:08:18.370
false,false,2254,2125,129,2179,00:00:33.000,2025-04-14 12:08:26.373
false,false,2057,1939,118,473,00:00:31.000,2025-04-14 12:00:40.062
false,false,2413,2278,135,187,00:00:31.000,2025-04-14 12:15:44.699
false,false,2430,2295,135,728,00:00:32.000,2025-04-14 12:16:18.723
false,false,2444,2306,138,282,00:00:31.000,2025-04-14 12:16:58.757
false,true,2449,2311,138,0,00:00:00.000,2025-04-14 12:17:18.773
false,false,2455,2317,138,126,00:00:33.000,2025-04-14 12:17:44.794
false,false,2456,2318,138,30,00:00:30.000,2025-04-14 12:17:58.803
false,false,2460,2322,138,155,00:00:32.000,2025-04-14 12:18:06.808
false,true,2340,2209,131,0,00:00:00.000,2025-04-14 12:12:18.545
false,false,2354,2223,131,190,00:00:32.000,2025-04-14 12:13:10.578
false,false,2358,2227,131,315,00:00:30.000,2025-04-14 12:13:18.584
false,false,2364,2232,132,163,00:00:33.000,2025-04-14 12:13:42.603
false,true,2387,2253,134,0,00:00:00.000,2025-04-14 12:14:30.644
false,false,2094,1975,119,1020,00:00:31.000,2025-04-14 12:02:06.120
false,false,2114,1995,119,93,00:00:31.000,2025-04-14 12:02:58.159
false,false,2132,2012,120,662,00:00:30.000,2025-04-14 12:03:34.186
false,false,2135,2015,120,757,00:00:30.000,2025-04-14 12:03:40.189
false,false,2143,2023,120,187,00:00:33.000,2025-04-14 12:04:08.203
false,false,2161,2039,122,95,00:00:31.000,2025-04-14 12:04:56.238
false,true,2162,2040,122,0,00:00:00.000,2025-04-14 12:05:06.245
false,false,2163,2041,122,33,00:00:33.000,2025-04-14 12:05:12.248
false,false,2479,2341,138,474,00:00:31.000,2025-04-14 12:18:56.838
false,false,2487,2348,139,724,00:00:30.000,2025-04-14 12:19:12.845
false,false,2509,2368,141,1421,00:00:33.000,2025-04-14 12:19:56.869
false,true,2510,2368,142,0,00:00:00.000,2025-04-14 12:20:04.875
false,false,2514,2372,142,124,00:00:31.000,2025-04-14 12:20:18.881
false,false,2517,2375,142,217,00:00:31.000,2025-04-14 12:20:24.884
false,false,2523,2381,142,405,00:00:30.000,2025-04-14 12:20:36.897
false,false,2572,2425,147,161,00:00:33.000,2025-04-14 12:22:26.991
false,false,2575,2428,147,254,00:00:31.000,2025-04-14 12:22:32.995
false,false,2587,2440,147,634,00:00:32.000,2025-04-14 12:22:57.015
false,true,2588,2441,147,0,00:00:00.000,2025-04-14 12:23:03.020
false,true,2610,2460,150,0,00:00:00.000,2025-04-14 12:24:09.066
false,false,2623,2473,150,411,00:00:33.000,2025-04-14 12:24:45.091
false,false,2624,2474,150,441,00:00:30.000,2025-04-14 12:24:47.092
false,false,2758,2595,163,219,00:00:30.000,2025-04-14 12:30:39.359
false,true,2660,2504,156,0,00:00:00.000,2025-04-14 12:26:09.146
false,false,2684,2526,158,324,00:00:31.000,2025-04-14 12:27:11.197
false,false,2691,2533,158,545,00:00:30.000,2025-04-14 12:27:25.210
false,false,2695,2537,158,672,00:00:33.000,2025-04-14 12:27:33.217
false,false,2698,2540,158,766,00:00:31.000,2025-04-14 12:27:39.221
false,false,2703,2544,159,922,00:00:31.000,2025-04-14 12:27:49.229
false,false,2782,2619,163,253,00:00:30.000,2025-04-14 12:32:15.426
false,false,2807,2641,166,253,00:00:33.000,2025-04-14 12:33:17.468
false,true,2829,2662,167,0,00:00:00.000,2025-04-14 12:34:23.515
false,false,2845,2678,167,507,00:00:33.000,2025-04-14 12:34:57.541
false,true,2850,2683,167,0,00:00:00.000,2025-04-14 12:35:19.560
false,false,2863,2693,170,377,00:00:32.000,2025-04-14 12:35:57.582
false,false,2872,2702,170,661,00:00:32.000,2025-04-14 12:36:15.594
false,true,2873,2703,170,0,00:00:00.000,2025-04-14 12:36:21.598
false,true,2873,2703,170,0,00:00:00.000,2025-04-14 12:36:23.600
false,true,2873,2703,170,0,00:00:00.000,2025-04-14 12:36:25.601
false,false,2882,2712,170,185,00:00:31.000,2025-04-14 12:36:59.622
true,false,7967,7492,475,577,00:00:33.000,2025-04-15 11:59:31.018
true,false,8426,7924,502,444,00:00:32.000,2025-04-15 12:10:10.642
true,false,8770,8252,518,628,00:00:30.000,2025-04-15 12:18:19.120
true,true,8786,8267,519,0,00:00:00.000,2025-04-15 12:18:43.143
true,false,9260,8708,552,378,00:00:31.000,2025-04-15 12:29:11.777
true,false,1624,1527,97,193,00:00:33.000,2025-04-14 11:40:01.145
true,false,1848,1738,110,220,00:00:31.000,2025-04-14 11:50:53.618
true,false,2238,2110,128,1668,00:00:31.000,2025-04-14 12:07:54.351
true,false,2085,1966,119,732,00:00:31.000,2025-04-14 12:01:48.107
true,false,2438,2301,137,92,00:00:31.000,2025-04-14 12:16:46.744
true,true,2567,2421,146,0,00:00:00.000,2025-04-14 12:22:10.980
true,false,2791,2627,164,531,00:00:30.000,2025-04-14 12:32:33.437
true,true,2850,2683,167,0,00:00:00.000,2025-04-14 12:35:15.556
true,false,7930,7455,475,1896,00:00:31.000,2025-04-15 11:58:35.956
true,false,8637,8125,512,376,00:00:31.000,2025-04-15 12:15:05.929
true,true,8672,8160,512,0,00:00:00.000,2025-04-15 12:16:04.983
true,false,8826,8305,521,278,00:00:30.000,2025-04-15 12:19:45.209
true,false,9277,8721,556,536,00:00:31.000,2025-04-15 12:29:34.803
true,true,9289,8732,557,0,00:00:00.000,2025-04-15 12:30:01.830
true,false,9225,8673,552,536,00:00:33.000,2025-04-15 12:28:18.720
true,false,9393,8831,562,289,00:00:31.000,2025-04-15 12:32:55.003
true,false,9464,8900,564,1124,00:00:32.000,2025-04-15 12:34:24.103
true,false,9466,8902,564,1190,00:00:33.000,2025-04-15 12:34:26.104
true,true,1626,1529,97,0,00:00:00.000,2025-04-14 11:40:17.155
true,true,1839,1731,108,0,00:00:00.000,2025-04-14 11:50:21.592
true,false,2500,2361,139,1131,00:00:31.000,2025-04-14 12:19:38.855
true,false,2501,2362,139,1164,00:00:33.000,2025-04-14 12:19:40.855
true,false,2776,2613,163,64,00:00:31.000,2025-04-14 12:32:03.416
true,false,8181,7694,487,723,00:00:32.000,2025-04-15 12:04:41.334
true,false,8287,7793,494,1217,00:00:32.000,2025-04-15 12:06:57.461
true,true,8750,8232,518,0,00:00:00.000,2025-04-15 12:17:54.096
true,false,8893,8364,529,31,00:00:31.000,2025-04-15 12:21:22.317
true,true,9014,8481,533,0,00:00:00.000,2025-04-15 12:23:56.465
true,false,9060,8523,537,95,00:00:31.000,2025-04-15 12:25:03.525
true,true,1614,1518,96,0,00:00:00.000,2025-04-14 11:39:19.115
true,false,1635,1537,98,282,00:00:31.000,2025-04-14 11:40:35.175
true,false,1769,1665,104,194,00:00:32.000,2025-04-14 11:46:27.432
true,true,1777,1673,104,0,00:00:00.000,2025-04-14 11:47:13.466
true,false,2376,2244,132,544,00:00:31.000,2025-04-14 12:14:06.619
true,false,2564,2418,146,1714,00:00:32.000,2025-04-14 12:21:58.967
true,false,2589,2442,147,31,00:00:31.000,2025-04-14 12:23:13.026
true,false,2622,2472,150,378,00:00:33.000,2025-04-14 12:24:43.088
true,false,2671,2514,157,347,00:00:30.000,2025-04-14 12:26:33.165
true,false,7941,7466,475,153,00:00:30.000,2025-04-15 11:58:52.977
true,false,8314,7818,496,322,00:00:31.000,2025-04-15 12:07:30.493
true,false,8242,7750,492,310,00:00:32.000,2025-04-15 12:06:00.405
true,false,9372,8810,562,60,00:00:30.000,2025-04-15 12:32:27.972
true,true,9028,8493,535,0,00:00:00.000,2025-04-15 12:24:14.479
true,false,9590,9017,573,286,00:00:30.000,2025-04-15 12:37:18.275
true,false,9641,9066,575,1258,00:00:30.000,2025-04-15 12:38:15.338
true,false,1836,1728,108,629,00:00:30.000,2025-04-14 11:50:05.580
true,false,1850,1740,110,283,00:00:32.000,2025-04-14 11:50:57.622
true,true,2435,2298,137,0,00:00:00.000,2025-04-14 12:16:32.735
true,false,2515,2373,142,156,00:00:32.000,2025-04-14 12:20:20.882
true,true,2829,2662,167,0,00:00:00.000,2025-04-14 12:34:21.513
true,false,7959,7484,475,316,00:00:30.000,2025-04-15 11:59:23.009
true,false,8467,7965,502,126,00:00:30.000,2025-04-15 12:11:15.704
true,false,8658,8146,512,63,00:00:32.000,2025-04-15 12:15:44.965
true,true,9277,8721,556,0,00:00:00.000,2025-04-15 12:29:41.812
true,false,9053,8516,537,279,00:00:30.000,2025-04-15 12:24:50.511
true,false,9439,8876,563,346,00:00:33.000,2025-04-15 12:33:59.080
true,false,9678,9099,579,94,00:00:30.000,2025-04-15 12:39:04.391
true,true,2185,2061,124,0,00:00:00.000,2025-04-14 12:06:00.280
true,false,2369,2237,132,321,00:00:32.000,2025-04-14 12:13:52.610
true,false,2615,2465,150,154,00:00:31.000,2025-04-14 12:24:29.078
true,false,8391,7891,500,1089,00:00:30.000,2025-04-15 12:09:11.586
true,false,8449,7947,502,225,00:00:32.000,2025-04-15 12:10:45.673
true,false,8659,8147,512,95,00:00:32.000,2025-04-15 12:15:45.966
true,false,8997,8464,533,1035,00:00:32.000,2025-04-15 12:23:30.442
true,false,9418,8856,562,541,00:00:30.000,2025-04-15 12:33:32.046
true,false,2429,2294,135,696,00:00:32.000,2025-04-14 12:16:16.721
true,false,2145,2025,120,250,00:00:31.000,2025-04-14 12:04:12.205
true,false,2518,2376,142,249,00:00:32.000,2025-04-14 12:20:26.886
true,false,8120,7636,484,30,00:00:30.000,2025-04-15 12:03:16.237
true,false,8321,7825,496,546,00:00:32.000,2025-04-15 12:07:37.501
true,false,8489,7986,503,811,00:00:32.000,2025-04-15 12:11:37.727
true,false,8756,8238,518,189,00:00:33.000,2025-04-15 12:18:05.108
true,false,9171,8625,546,94,00:00:33.000,2025-04-15 12:27:12.649
true,false,9357,8796,561,93,00:00:30.000,2025-04-15 12:31:48.931
true,false,9470,8906,564,1317,00:00:33.000,2025-04-15 12:34:30.107
true,false,1829,1723,106,411,00:00:30.000,2025-04-14 11:49:51.572
true,true,2742,2580,162,0,00:00:00.000,2025-04-14 12:29:45.317
true,false,7968,7493,475,608,00:00:31.000,2025-04-15 11:59:32.020
true,false,8437,7935,502,283,00:00:31.000,2025-04-15 12:10:27.658
true,true,8625,8115,510,0,00:00:00.000,2025-04-15 12:14:52.915
true,false,8684,8171,513,310,00:00:31.000,2025-04-15 12:16:23.004
true,true,8840,8317,523,0,00:00:00.000,2025-04-15 12:20:04.229
true,true,9260,8708,552,0,00:00:00.000,2025-04-15 12:29:14.779
true,false,9226,8674,552,568,00:00:32.000,2025-04-15 12:28:19.721
true,false,9004,8471,533,66,00:00:33.000,2025-04-15 12:23:43.454
true,false,9610,9035,575,284,00:00:32.000,2025-04-15 12:37:44.303
true,false,1777,1673,104,32,00:00:32.000,2025-04-14 11:47:07.461
true,false,1734,1630,104,536,00:00:32.000,2025-04-14 11:44:53.367
true,false,2185,2061,124,724,00:00:31.000,2025-04-14 12:05:56.276
true,false,2246,2117,129,1925,00:00:31.000,2025-04-14 12:08:10.363
true,true,2464,2326,138,0,00:00:00.000,2025-04-14 12:18:20.815
true,false,2151,2030,121,439,00:00:30.000,2025-04-14 12:04:24.212
true,false,2806,2640,166,220,00:00:32.000,2025-04-14 12:33:15.467
true,false,8344,7848,496,96,00:00:33.000,2025-04-15 12:08:18.539
true,true,8639,8127,512,0,00:00:00.000,2025-04-15 12:15:09.933
true,false,8712,8197,515,217,00:00:30.000,2025-04-15 12:17:15.055
true,false,8834,8311,523,532,00:00:32.000,2025-04-15 12:19:53.217
true,true,9675,9097,578,0,00:00:00.000,2025-04-15 12:39:01.386
true,false,9684,9105,579,282,00:00:32.000,2025-04-15 12:39:10.397
true,true,1839,1731,108,0,00:00:00.000,2025-04-14 11:50:23.593
true,true,1777,1673,104,0,00:00:00.000,2025-04-14 11:47:19.470
true,false,1678,1577,101,314,00:00:33.000,2025-04-14 11:42:37.266
true,false,2414,2279,135,217,00:00:30.000,2025-04-14 12:15:46.701
true,false,2386,2253,133,862,00:00:31.000,2025-04-14 12:14:26.640
true,false,2522,2380,142,375,00:00:30.000,2025-04-14 12:20:34.895
true,false,2638,2486,152,882,00:00:33.000,2025-04-14 12:25:15.110
true,false,2724,2562,162,527,00:00:31.000,2025-04-14 12:28:43.274
true,true,8108,7624,484,0,00:00:00.000,2025-04-15 12:02:58.218
true,false,8375,7877,498,590,00:00:31.000,2025-04-15 12:08:55.573
true,true,8409,7908,501,0,00:00:00.000,2025-04-15 12:09:39.613
true,true,8412,7911,501,0,00:00:00.000,2025-04-15 12:09:54.628
true,false,8714,8199,515,278,00:00:31.000,2025-04-15 12:17:17.056
true,false,8727,8212,515,693,00:00:33.000,2025-04-15 12:17:30.068
true,false,8865,8339,526,317,00:00:30.000,2025-04-15 12:20:36.267
true,false,9153,8608,545,32,00:00:32.000,2025-04-15 12:26:42.620
true,false,1616,1519,97,63,00:00:32.000,2025-04-14 11:39:33.127
true,false,2054,1936,118,379,00:00:32.000,2025-04-14 12:00:34.060
true,true,2359,2228,131,0,00:00:00.000,2025-04-14 12:13:24.589
true,false,2164,2041,123,63,00:00:30.000,2025-04-14 12:05:14.249
true,true,2742,2580,162,0,00:00:00.000,2025-04-14 12:29:47.319
true,true,2758,2595,163,0,00:00:00.000,2025-04-14 12:31:03.378
true,false,2759,2596,163,33,00:00:33.000,2025-04-14 12:31:05.380
true,false,2722,2560,162,463,00:00:33.000,2025-04-14 12:28:39.271
true,true,8195,7708,487,0,00:00:00.000,2025-04-15 12:05:00.353
true,false,8682,8169,513,249,00:00:31.000,2025-04-15 12:16:21.000
true,false,8946,8415,531,1537,00:00:32.000,2025-04-15 12:22:27.379
true,false,9114,8570,544,1801,00:00:32.000,2025-04-15 12:25:57.578
true,false,9191,8643,548,30,00:00:30.000,2025-04-15 12:27:38.673
true,true,9368,8806,562,0,00:00:00.000,2025-04-15 12:32:11.954
true,true,9401,8839,562,0,00:00:00.000,2025-04-15 12:33:08.019
true,true,9002,8469,533,0,00:00:00.000,2025-04-15 12:23:40.451
true,false,9561,8989,572,249,00:00:30.000,2025-04-15 12:36:43.240
true,false,1908,1795,113,187,00:00:32.000,2025-04-14 11:53:41.740
true,false,1693,1591,102,785,00:00:33.000,2025-04-14 11:43:07.287
true,false,2201,2075,126,503,00:00:30.000,2025-04-14 12:06:40.302
true,true,2435,2298,137,0,00:00:00.000,2025-04-14 12:16:40.740
true,false,2123,2003,120,378,00:00:30.000,2025-04-14 12:03:16.173
true,false,2483,2345,138,600,00:00:32.000,2025-04-14 12:19:04.841
true,true,2510,2368,142,0,00:00:00.000,2025-04-14 12:20:02.874
true,true,2738,2576,162,0,00:00:00.000,2025-04-14 12:29:29.307
true,false,8377,7878,499,651,00:00:30.000,2025-04-15 12:08:57.575
true,true,8453,7951,502,0,00:00:00.000,2025-04-15 12:10:52.680
true,false,8745,8228,517,1260,00:00:33.000,2025-04-15 12:17:48.088
true,true,8893,8364,529,0,00:00:00.000,2025-04-15 12:21:27.319
true,false,9170,8624,546,61,00:00:31.000,2025-04-15 12:27:11.647
true,false,9374,8812,562,126,00:00:33.000,2025-04-15 12:32:29.975
true,true,9512,8944,568,0,00:00:00.000,2025-04-15 12:35:32.167
true,false,9565,8993,572,376,00:00:33.000,2025-04-15 12:36:47.242
true,true,1618,1521,97,0,00:00:00.000,2025-04-14 11:39:39.130
true,false,1807,1702,105,315,00:00:33.000,2025-04-14 11:48:55.530
true,true,1958,1843,115,0,00:00:00.000,2025-04-14 11:56:33.870
true,true,1926,1812,114,0,00:00:00.000,2025-04-14 11:54:39.785
true,false,2178,2055,123,501,00:00:30.000,2025-04-14 12:05:42.268
true,true,2042,1924,118,0,00:00:00.000,2025-04-14 12:00:06.036
true,false,2087,1968,119,798,00:00:33.000,2025-04-14 12:01:52.111
true,false,2418,2283,135,346,00:00:32.000,2025-04-14 12:15:54.707
true,false,2356,2225,131,253,00:00:33.000,2025-04-14 12:13:14.582
true,true,2387,2253,134,0,00:00:00.000,2025-04-14 12:14:38.649
true,true,2510,2368,142,0,00:00:00.000,2025-04-14 12:20:10.877
true,false,2576,2429,147,287,00:00:33.000,2025-04-14 12:22:34.996
true,false,2760,2597,163,65,00:00:32.000,2025-04-14 12:31:07.383
true,true,2774,2611,163,0,00:00:00.000,2025-04-14 12:31:53.410
true,false,2796,2632,164,691,00:00:32.000,2025-04-14 12:32:43.445
true,true,2851,2683,168,0,00:00:00.000,2025-04-14 12:35:31.568
true,false,8622,8113,509,878,00:00:32.000,2025-04-15 12:14:44.910
true,false,8707,8193,514,60,00:00:30.000,2025-04-15 12:17:10.051
true,true,8513,8009,504,0,00:00:00.000,2025-04-15 12:12:13.764
true,false,9263,8710,553,95,00:00:32.000,2025-04-15 12:29:20.787
true,false,9049,8512,537,156,00:00:30.000,2025-04-15 12:24:46.507
true,true,9581,9008,573,0,00:00:00.000,2025-04-15 12:37:04.259
true,false,9593,9020,573,381,00:00:32.000,2025-04-15 12:37:21.279
true,false,9602,9028,574,32,00:00:32.000,2025-04-15 12:37:36.297
true,true,1776,1672,104,0,00:00:00.000,2025-04-14 11:46:55.453
true,false,1674,1573,101,188,00:00:31.000,2025-04-14 11:42:29.261
true,false,2023,1906,117,624,00:00:30.000,2025-04-14 11:59:19.998
true,true,2407,2273,134,0,00:00:00.000,2025-04-14 12:15:32.691
true,false,2446,2308,138,344,00:00:30.000,2025-04-14 12:17:02.759
true,false,2393,2259,134,188,00:00:32.000,2025-04-14 12:14:52.661
true,false,2115,1996,119,123,00:00:30.000,2025-04-14 12:03:00.161
true,true,2158,2036,122,0,00:00:00.000,2025-04-14 12:04:48.233
true,false,2481,2343,138,535,00:00:30.000,2025-04-14 12:19:00.839
true,false,2612,2462,150,61,00:00:31.000,2025-04-14 12:24:23.077
true,true,2876,2706,170,0,00:00:00.000,2025-04-14 12:36:37.609
true,false,2879,2709,170,93,00:00:30.000,2025-04-14 12:36:53.621
true,false,8066,7585,481,973,00:00:31.000,2025-04-15 12:01:40.145
true,false,8140,7655,485,594,00:00:33.000,2025-04-15 12:03:54.279
true,true,8639,8127,512,0,00:00:00.000,2025-04-15 12:15:08.932
true,false,8835,8312,523,562,00:00:30.000,2025-04-15 12:19:54.218
true,true,9057,8520,537,0,00:00:00.000,2025-04-15 12:24:56.518
true,true,2003,1886,117,0,00:00:00.000,2025-04-14 11:58:37.974
true,false,1931,1817,114,159,00:00:33.000,2025-04-14 11:54:51.793
true,false,2289,2160,129,348,00:00:33.000,2025-04-14 12:10:00.443
true,false,2458,2320,138,93,00:00:33.000,2025-04-14 12:18:02.806
true,true,2347,2216,131,0,00:00:00.000,2025-04-14 12:12:42.560
true,false,8104,7620,484,124,00:00:31.000,2025-04-15 12:02:48.211
true,false,8304,7810,494,1750,00:00:32.000,2025-04-15 12:07:14.479
true,true,8578,8073,505,0,00:00:00.000,2025-04-15 12:13:31.844
true,false,8806,8286,520,187,00:00:32.000,2025-04-15 12:19:19.182
true,false,9293,8736,557,130,00:00:33.000,2025-04-15 12:30:08.837
true,true,9401,8839,562,0,00:00:00.000,2025-04-15 12:33:06.016
true,false,9577,9004,573,754,00:00:31.000,2025-04-15 12:36:59.254
true,false,9417,8855,562,511,00:00:31.000,2025-04-15 12:33:31.044
true,false,1646,1548,98,626,00:00:30.000,2025-04-14 11:40:57.189
true,true,1950,1835,115,0,00:00:00.000,2025-04-14 11:55:53.841
true,false,1993,1877,116,505,00:00:32.000,2025-04-14 11:58:07.947
true,false,1688,1587,101,627,00:00:33.000,2025-04-14 11:42:57.278
true,true,2278,2149,129,0,00:00:00.000,2025-04-14 12:09:34.426
true,false,2484,2345,139,631,00:00:31.000,2025-04-14 12:19:06.842
true,true,7971,7495,476,0,00:00:00.000,2025-04-15 11:59:40.028
true,false,8453,7951,502,350,00:00:33.000,2025-04-15 12:10:49.678
true,true,8625,8115,510,0,00:00:00.000,2025-04-15 12:14:48.912
true,false,8657,8145,512,31,00:00:31.000,2025-04-15 12:15:43.964
true,false,8539,8034,505,410,00:00:32.000,2025-04-15 12:12:45.794
true,true,9241,8689,552,0,00:00:00.000,2025-04-15 12:28:39.745
true,false,9188,8640,548,630,00:00:30.000,2025-04-15 12:27:29.663
true,true,9368,8806,562,0,00:00:00.000,2025-04-15 12:32:08.952
true,false,9391,8829,562,225,00:00:33.000,2025-04-15 12:32:53.000
true,false,9587,9014,573,191,00:00:33.000,2025-04-15 12:37:15.273
true,true,9428,8865,563,0,00:00:00.000,2025-04-15 12:33:47.064
true,true,1777,1673,104,0,00:00:00.000,2025-04-14 11:47:25.476
true,false,2232,2104,128,1476,00:00:30.000,2025-04-14 12:07:42.343
true,false,2070,1951,119,255,00:00:32.000,2025-04-14 12:01:18.095
true,false,2075,1956,119,414,00:00:31.000,2025-04-14 12:01:28.098
true,false,2342,2211,131,64,00:00:33.000,2025-04-14 12:12:22.547
true,true,2510,2368,142,0,00:00:00.000,2025-04-14 12:20:08.876
true,false,2812,2645,167,411,00:00:31.000,2025-04-14 12:33:27.476
true,false,2883,2713,170,215,00:00:30.000,2025-04-14 12:37:01.623
false,false,2886,2716,170,309,00:00:31.000,2025-04-14 12:37:07.626
false,false,2889,2719,170,401,00:00:30.000,2025-04-14 12:37:13.630
false,true,2907,2737,170,0,00:00:00.000,2025-04-14 12:38:21.695
false,false,2908,2738,170,33,00:00:33.000,2025-04-14 12:38:27.701
false,false,2943,2772,171,1137,00:00:33.000,2025-04-14 12:39:37.754
false,false,2944,2773,171,1170,00:00:33.000,2025-04-14 12:39:39.755
false,true,2957,2784,173,0,00:00:00.000,2025-04-14 12:40:07.772
false,true,2957,2784,173,0,00:00:00.000,2025-04-14 12:40:11.773
false,true,2962,2789,173,0,00:00:00.000,2025-04-14 12:40:35.791
false,false,2981,2807,174,288,00:00:33.000,2025-04-14 12:41:41.851
false,false,2982,2807,175,321,00:00:33.000,2025-04-14 12:41:43.853
false,true,2987,2812,175,0,00:00:00.000,2025-04-14 12:41:57.864
false,false,2994,2818,176,30,00:00:30.000,2025-04-14 12:42:43.905
false,true,3020,2842,178,0,00:00:00.000,2025-04-14 12:43:53.960
false,false,3027,2849,178,221,00:00:32.000,2025-04-14 12:44:13.975
false,false,3037,2858,179,319,00:00:31.000,2025-04-14 12:44:45.996
false,true,3045,2866,179,0,00:00:00.000,2025-04-14 12:45:12.017
false,false,9795,9208,587,95,00:00:32.000,2025-04-15 12:41:49.551
false,false,9841,9250,591,1549,00:00:31.000,2025-04-15 12:42:35.600
false,true,9852,9260,592,0,00:00:00.000,2025-04-15 12:42:59.622
false,false,9950,9354,596,316,00:00:33.000,2025-04-15 12:45:12.757
false,false,9956,9360,596,62,00:00:30.000,2025-04-15 12:45:24.773
false,false,9971,9373,598,320,00:00:32.000,2025-04-15 12:45:51.804
false,false,9982,9383,599,308,00:00:30.000,2025-04-15 12:46:14.828
false,false,9992,9392,600,625,00:00:33.000,2025-04-15 12:46:24.837
false,false,9997,9397,600,783,00:00:32.000,2025-04-15 12:46:29.842
false,false,10066,9462,604,31,00:00:31.000,2025-04-15 12:48:20.952
false,false,10068,9464,604,94,00:00:32.000,2025-04-15 12:48:22.954
false,false,10071,9467,604,189,00:00:33.000,2025-04-15 12:48:25.956
false,false,10081,9477,604,503,00:00:33.000,2025-04-15 12:48:35.967
false,false,10109,9502,607,1386,00:00:31.000,2025-04-15 12:49:03.999
false,false,10139,9531,608,351,00:00:32.000,2025-04-15 12:49:40.039
false,false,10148,9540,608,632,00:00:30.000,2025-04-15 12:49:49.051
false,false,9866,9273,593,65,00:00:32.000,2025-04-15 12:43:24.648
false,false,9871,9278,593,221,00:00:32.000,2025-04-15 12:43:29.654
false,false,9888,9294,594,756,00:00:30.000,2025-04-15 12:43:46.672
false,false,9891,9296,595,852,00:00:31.000,2025-04-15 12:43:49.676
false,false,9898,9303,595,1074,00:00:32.000,2025-04-15 12:43:56.684
false,false,9910,9314,596,1456,00:00:31.000,2025-04-15 12:44:08.696
false,false,9912,9316,596,1517,00:00:31.000,2025-04-15 12:44:10.697
false,true,9912,9316,596,0,00:00:00.000,2025-04-15 12:44:11.697
false,false,9919,9323,596,222,00:00:33.000,2025-04-15 12:44:23.707
false,false,9920,9324,596,253,00:00:31.000,2025-04-15 12:44:24.709
false,false,9935,9339,596,256,00:00:30.000,2025-04-15 12:44:45.728
false,false,9717,9134,583,497,00:00:30.000,2025-04-15 12:39:55.447
false,false,9737,9154,583,279,00:00:32.000,2025-04-15 12:40:27.475
false,false,9740,9157,583,373,00:00:30.000,2025-04-15 12:40:30.477
false,true,9751,9167,584,0,00:00:00.000,2025-04-15 12:40:53.497
false,true,9756,9172,584,0,00:00:00.000,2025-04-15 12:40:59.503
false,false,10010,9409,601,1190,00:00:32.000,2025-04-15 12:46:42.852
false,false,10022,9420,602,282,00:00:31.000,2025-04-15 12:47:06.876
false,true,10024,9421,603,0,00:00:00.000,2025-04-15 12:47:14.884
false,true,10056,9453,603,0,00:00:00.000,2025-04-15 12:48:00.931
false,true,10056,9453,603,0,00:00:00.000,2025-04-15 12:48:03.935
false,true,10223,9606,617,0,00:00:00.000,2025-04-15 12:51:36.158
false,false,10229,9612,617,188,00:00:32.000,2025-04-15 12:51:46.167
false,false,10235,9617,618,372,00:00:31.000,2025-04-15 12:51:52.175
false,false,10294,9674,620,349,00:00:33.000,2025-04-15 12:52:57.245
false,false,10398,9771,627,538,00:00:30.000,2025-04-15 12:55:11.385
false,false,10405,9778,627,758,00:00:30.000,2025-04-15 12:55:18.393
false,true,10424,9797,627,0,00:00:00.000,2025-04-15 12:56:05.434
false,true,10450,9820,630,0,00:00:00.000,2025-04-15 12:56:42.473
false,false,10456,9826,630,186,00:00:33.000,2025-04-15 12:56:51.484
false,false,10458,9828,630,248,00:00:31.000,2025-04-15 12:56:53.486
false,false,10464,9833,631,440,00:00:33.000,2025-04-15 12:56:59.490
false,false,10466,9835,631,504,00:00:32.000,2025-04-15 12:57:01.492
false,false,10476,9844,632,825,00:00:33.000,2025-04-15 12:57:11.501
false,false,10490,9857,633,1263,00:00:32.000,2025-04-15 12:57:25.518
false,true,10507,9874,633,0,00:00:00.000,2025-04-15 12:57:48.542
false,true,10515,9881,634,0,00:00:00.000,2025-04-15 12:58:00.557
false,false,10517,9883,634,63,00:00:30.000,2025-04-15 12:58:04.563
false,false,10519,9885,634,124,00:00:31.000,2025-04-15 12:58:06.565
false,false,10523,9889,634,252,00:00:33.000,2025-04-15 12:58:10.570
false,false,10527,9892,635,379,00:00:30.000,2025-04-15 12:58:14.575
false,true,10527,9892,635,0,00:00:00.000,2025-04-15 12:58:15.576
false,false,10530,9895,635,96,00:00:32.000,2025-04-15 12:58:23.582
false,false,10531,9896,635,128,00:00:32.000,2025-04-15 12:58:24.583
false,true,10539,9904,635,0,00:00:00.000,2025-04-15 12:58:33.588
false,false,10546,9910,636,221,00:00:31.000,2025-04-15 12:58:45.600
false,true,10555,9919,636,0,00:00:00.000,2025-04-15 12:58:55.610
false,false,10556,9920,636,30,00:00:30.000,2025-04-15 12:59:01.618
false,false,10570,9933,637,349,00:00:32.000,2025-04-15 12:59:21.641
false,false,10577,9940,637,566,00:00:32.000,2025-04-15 12:59:28.647
false,false,10580,9943,637,663,00:00:33.000,2025-04-15 12:59:31.650
false,false,10581,9944,637,695,00:00:32.000,2025-04-15 12:59:32.650
false,false,10582,9945,637,725,00:00:30.000,2025-04-15 12:59:33.651
false,false,10585,9948,637,818,00:00:30.000,2025-04-15 12:59:36.654
false,false,10596,9956,640,1167,00:00:32.000,2025-04-15 12:59:47.667
false,false,10325,9703,622,1306,00:00:30.000,2025-04-15 12:53:28.278
false,true,10333,9710,623,0,00:00:00.000,2025-04-15 12:53:37.287
false,false,10338,9715,623,156,00:00:32.000,2025-04-15 12:53:47.294
false,true,10357,9733,624,0,00:00:00.000,2025-04-15 12:54:08.317
false,true,10357,9733,624,0,00:00:00.000,2025-04-15 12:54:09.317
false,false,10362,9738,624,156,00:00:30.000,2025-04-15 12:54:17.324
false,false,10369,9744,625,62,00:00:32.000,2025-04-15 12:54:36.347
false,false,10373,9748,625,188,00:00:32.000,2025-04-15 12:54:40.350
false,true,10599,9959,640,0,00:00:00.000,2025-04-15 12:59:53.673
false,true,10599,9959,640,0,00:00:00.000,2025-04-15 12:59:55.675
false,true,10599,9959,640,0,00:00:00.000,2025-04-15 12:59:56.676
false,true,10778,10129,649,0,00:00:00.000,2025-04-15 13:03:57.903
false,true,10778,10129,649,0,00:00:00.000,2025-04-15 13:03:58.905
false,false,10802,10152,650,31,00:00:31.000,2025-04-15 13:04:31.943
false,false,10812,10162,650,345,00:00:32.000,2025-04-15 13:04:41.952
false,true,10818,10168,650,0,00:00:00.000,2025-04-15 13:04:50.961
false,false,10918,10262,656,410,00:00:30.000,2025-04-15 13:07:16.108
false,true,10924,10268,656,0,00:00:00.000,2025-04-15 13:07:25.117
false,false,10948,10291,657,752,00:00:33.000,2025-04-15 13:07:52.147
false,false,10950,10293,657,814,00:00:32.000,2025-04-15 13:07:54.147
false,false,10959,10302,657,1093,00:00:32.000,2025-04-15 13:08:03.153
false,true,10960,10303,657,0,00:00:00.000,2025-04-15 13:08:05.157
false,true,10960,10303,657,0,00:00:00.000,2025-04-15 13:08:06.157
false,true,10966,10309,657,0,00:00:00.000,2025-04-15 13:08:19.169
false,false,10967,10310,657,32,00:00:32.000,2025-04-15 13:08:23.176
false,true,10975,10318,657,0,00:00:00.000,2025-04-15 13:08:40.192
false,false,10979,10322,657,62,00:00:32.000,2025-04-15 13:08:53.203
false,true,10991,10334,657,0,00:00:00.000,2025-04-15 13:09:10.219
false,false,10993,10336,657,62,00:00:30.000,2025-04-15 13:09:13.221
false,false,11006,10349,657,411,00:00:30.000,2025-04-15 13:09:32.240
false,true,11009,10352,657,0,00:00:00.000,2025-04-15 13:09:36.244
false,false,10676,10033,643,162,00:00:33.000,2025-04-15 13:01:43.779
false,false,10690,10046,644,610,00:00:33.000,2025-04-15 13:01:57.790
false,false,10693,10048,645,708,00:00:32.000,2025-04-15 13:02:00.792
false,false,10701,10055,646,91,00:00:30.000,2025-04-15 13:02:14.806
false,false,10707,10061,646,280,00:00:32.000,2025-04-15 13:02:20.813
false,false,10722,10074,648,745,00:00:30.000,2025-04-15 13:02:35.828
false,false,10736,10087,649,1192,00:00:32.000,2025-04-15 13:02:49.844
false,true,10818,10168,650,0,00:00:00.000,2025-04-15 13:04:53.964
false,false,10834,10183,651,31,00:00:31.000,2025-04-15 13:05:15.988
false,false,10860,10208,652,130,00:00:33.000,2025-04-15 13:05:54.025
false,true,10864,10212,652,0,00:00:00.000,2025-04-15 13:06:00.031
false,false,10871,10218,653,220,00:00:32.000,2025-04-15 13:06:11.043
false,false,10873,10220,653,283,00:00:31.000,2025-04-15 13:06:13.046
false,false,10877,10224,653,409,00:00:30.000,2025-04-15 13:06:17.050
false,true,10881,10226,655,0,00:00:00.000,2025-04-15 13:06:25.057
false,false,10886,10231,655,159,00:00:33.000,2025-04-15 13:06:32.063
false,false,10167,9556,611,347,00:00:32.000,2025-04-15 12:50:14.077
false,false,10190,9577,613,1068,00:00:32.000,2025-04-15 12:50:37.101
false,true,10196,9580,616,0,00:00:00.000,2025-04-15 12:50:45.110
false,true,10196,9580,616,0,00:00:00.000,2025-04-15 12:50:48.112
false,true,10202,9586,616,0,00:00:00.000,2025-04-15 12:51:03.122
false,false,10217,9601,616,156,00:00:30.000,2025-04-15 12:51:28.149
false,false,11035,10376,659,411,00:00:31.000,2025-04-15 13:10:13.276
false,true,11035,10376,659,0,00:00:00.000,2025-04-15 13:10:16.279
false,false,11053,10394,659,443,00:00:31.000,2025-04-15 13:10:43.304
false,false,11059,10400,659,33,00:00:33.000,2025-04-15 13:10:55.316
false,false,11176,10512,664,756,00:00:30.000,2025-04-15 13:13:28.471
false,false,11205,10541,664,63,00:00:30.000,2025-04-15 13:14:15.522
false,false,11209,10545,664,184,00:00:30.000,2025-04-15 13:14:19.526
false,true,11220,10553,667,0,00:00:00.000,2025-04-15 13:14:33.541
false,true,11352,10678,674,0,00:00:00.000,2025-04-15 13:17:28.719
false,true,11353,10679,674,0,00:00:00.000,2025-04-15 13:17:34.723
false,false,11355,10681,674,60,00:00:30.000,2025-04-15 13:17:39.729
false,false,11363,10689,674,308,00:00:32.000,2025-04-15 13:17:47.742
false,false,11281,10612,669,66,00:00:33.000,2025-04-15 13:15:49.618
false,false,11282,10613,669,98,00:00:32.000,2025-04-15 13:15:50.619
false,false,11285,10616,669,188,00:00:30.000,2025-04-15 13:15:53.622
false,false,11096,10433,663,222,00:00:30.000,2025-04-15 13:11:44.362
false,false,11108,10445,663,596,00:00:33.000,2025-04-15 13:11:56.377
false,false,11115,10452,663,812,00:00:30.000,2025-04-15 13:12:03.384
false,false,11116,10453,663,845,00:00:33.000,2025-04-15 13:12:04.386
false,true,11120,10457,663,0,00:00:00.000,2025-04-15 13:12:14.397
false,true,11121,10458,663,0,00:00:00.000,2025-04-15 13:12:16.399
false,true,11121,10458,663,0,00:00:00.000,2025-04-15 13:12:18.402
false,false,11135,10472,663,123,00:00:31.000,2025-04-15 13:12:41.424
false,false,11136,10473,663,154,00:00:31.000,2025-04-15 13:12:42.425
false,false,11140,10476,664,279,00:00:31.000,2025-04-15 13:12:46.429
false,false,11155,10491,664,94,00:00:33.000,2025-04-15 13:13:07.450
false,true,11403,10723,680,0,00:00:00.000,2025-04-15 13:18:48.796
false,true,11406,10726,680,0,00:00:00.000,2025-04-15 13:18:56.802
false,false,11420,10739,681,317,00:00:33.000,2025-04-15 13:19:20.823
false,false,11426,10745,681,506,00:00:31.000,2025-04-15 13:19:26.829
false,false,11440,10759,681,944,00:00:31.000,2025-04-15 13:19:40.843
false,false,11554,10866,688,65,00:00:32.000,2025-04-15 13:22:17.024
false,false,11572,10883,689,633,00:00:30.000,2025-04-15 13:22:35.038
false,false,11577,10888,689,156,00:00:31.000,2025-04-15 13:22:46.049
false,false,11586,10897,689,438,00:00:32.000,2025-04-15 13:22:55.057
false,false,11598,10909,689,313,00:00:33.000,2025-04-15 13:23:13.075
false,false,11457,10775,682,1489,00:00:30.000,2025-04-15 13:19:57.865
false,false,11459,10777,682,1551,00:00:30.000,2025-04-15 13:19:59.867
false,false,11460,10778,682,1583,00:00:32.000,2025-04-15 13:20:00.869
false,true,11473,10791,682,0,00:00:00.000,2025-04-15 13:20:18.892
false,false,11479,10796,683,189,00:00:31.000,2025-04-15 13:20:25.901
false,false,11496,10813,683,723,00:00:33.000,2025-04-15 13:20:42.915
false,true,11511,10828,683,0,00:00:00.000,2025-04-15 13:21:08.950
false,true,11598,10909,689,0,00:00:00.000,2025-04-15 13:23:19.080
false,false,11601,10912,689,61,00:00:30.000,2025-04-15 13:23:28.091
false,true,11611,10921,690,0,00:00:00.000,2025-04-15 13:23:43.106
false,false,11614,10924,690,33,00:00:33.000,2025-04-15 13:23:53.117
false,false,11640,10947,693,849,00:00:31.000,2025-04-15 13:24:19.140
false,false,11645,10952,693,158,00:00:30.000,2025-04-15 13:24:30.150
false,false,11654,10961,693,446,00:00:33.000,2025-04-15 13:24:39.159
false,false,11656,10962,694,509,00:00:33.000,2025-04-15 13:24:41.162
false,false,11666,10972,694,820,00:00:31.000,2025-04-15 13:24:51.174
false,false,11738,11040,698,222,00:00:33.000,2025-04-15 13:26:51.300
false,true,11742,11044,698,0,00:00:00.000,2025-04-15 13:27:01.309
false,false,11753,11054,699,349,00:00:32.000,2025-04-15 13:27:12.318
false,false,11761,11061,700,96,00:00:33.000,2025-04-15 13:27:26.334
false,false,11766,11065,701,250,00:00:32.000,2025-04-15 13:27:31.339
false,false,11774,11073,701,506,00:00:30.000,2025-04-15 13:27:39.347
false,false,11792,11091,701,1069,00:00:33.000,2025-04-15 13:27:57.363
false,false,11798,11096,702,1263,00:00:31.000,2025-04-15 13:28:03.367
false,false,11803,11101,702,1419,00:00:32.000,2025-04-15 13:28:08.369
false,false,11819,11116,703,248,00:00:31.000,2025-04-15 13:28:30.394
false,false,11821,11118,703,312,00:00:32.000,2025-04-15 13:28:32.397
false,false,11836,11132,704,781,00:00:32.000,2025-04-15 13:28:47.410
false,false,11844,11139,705,1037,00:00:32.000,2025-04-15 13:28:55.417
false,true,11845,11140,705,0,00:00:00.000,2025-04-15 13:28:57.419
false,true,11854,11149,705,0,00:00:00.000,2025-04-15 13:29:16.438
false,true,11866,11161,705,0,00:00:00.000,2025-04-15 13:29:44.471
false,true,11866,11161,705,0,00:00:00.000,2025-04-15 13:29:47.472
false,false,11672,10978,694,1008,00:00:31.000,2025-04-15 13:24:57.180
false,true,11712,11015,697,0,00:00:00.000,2025-04-15 13:26:11.260
false,true,11932,11223,709,0,00:00:00.000,2025-04-15 13:31:51.608
false,true,11937,11228,709,0,00:00:00.000,2025-04-15 13:32:05.622
false,true,11983,11269,714,0,00:00:00.000,2025-04-15 13:33:10.697
false,true,11867,11162,705,0,00:00:00.000,2025-04-15 13:29:54.482
false,false,11873,11168,705,192,00:00:30.000,2025-04-15 13:30:00.487
false,false,11875,11169,706,33,00:00:33.000,2025-04-15 13:30:08.497
false,true,11878,11172,706,0,00:00:00.000,2025-04-15 13:30:15.505
false,false,11883,11177,706,156,00:00:30.000,2025-04-15 13:30:22.514
false,false,11885,11178,707,217,00:00:30.000,2025-04-15 13:30:24.518
false,true,11887,11180,707,0,00:00:00.000,2025-04-15 13:30:34.530
false,false,11894,11185,709,32,00:00:32.000,2025-04-15 13:30:51.546
false,false,2887,2717,170,340,00:00:31.000,2025-04-14 12:37:09.629
false,true,2891,2721,170,0,00:00:00.000,2025-04-14 12:37:27.642
false,false,2905,2735,170,440,00:00:31.000,2025-04-14 12:37:57.667
false,true,2905,2735,170,0,00:00:00.000,2025-04-14 12:38:09.682
false,true,2907,2737,170,0,00:00:00.000,2025-04-14 12:38:23.697
false,false,2914,2744,170,224,00:00:33.000,2025-04-14 12:38:39.713
false,false,2918,2748,170,346,00:00:30.000,2025-04-14 12:38:47.720
false,false,2926,2756,170,598,00:00:32.000,2025-04-14 12:39:03.735
false,false,2930,2759,171,720,00:00:31.000,2025-04-14 12:39:11.739
false,false,2972,2798,174,310,00:00:30.000,2025-04-14 12:41:11.823
false,false,2983,2808,175,354,00:00:33.000,2025-04-14 12:41:45.855
false,false,2985,2810,175,417,00:00:30.000,2025-04-14 12:41:49.856
false,true,2987,2812,175,0,00:00:00.000,2025-04-14 12:42:01.868
false,true,2987,2812,175,0,00:00:00.000,2025-04-14 12:42:03.871
false,false,2990,2814,176,95,00:00:32.000,2025-04-14 12:42:11.876
false,true,2990,2814,176,0,00:00:00.000,2025-04-14 12:42:15.880
false,false,2995,2819,176,61,00:00:31.000,2025-04-14 12:42:45.906
false,false,2998,2822,176,154,00:00:31.000,2025-04-14 12:42:51.909
false,false,3006,2830,176,405,00:00:30.000,2025-04-14 12:43:07.924
false,false,3014,2838,176,659,00:00:30.000,2025-04-14 12:43:23.937
false,true,3018,2841,177,0,00:00:00.000,2025-04-14 12:43:39.952
false,false,3032,2854,178,161,00:00:31.000,2025-04-14 12:44:35.990
false,false,3043,2864,179,512,00:00:33.000,2025-04-14 12:44:58.003
false,false,3048,2869,179,96,00:00:30.000,2025-04-14 12:45:20.024
false,false,9787,9200,587,982,00:00:30.000,2025-04-15 12:41:35.536
false,false,9789,9202,587,1044,00:00:30.000,2025-04-15 12:41:37.539
false,false,9812,9224,588,635,00:00:33.000,2025-04-15 12:42:06.566
false,false,9843,9251,592,1614,00:00:33.000,2025-04-15 12:42:37.601
false,false,9855,9263,592,92,00:00:32.000,2025-04-15 12:43:07.631
false,false,9858,9266,592,186,00:00:32.000,2025-04-15 12:43:10.633
false,true,9954,9358,596,0,00:00:00.000,2025-04-15 12:45:22.770
false,false,9968,9370,598,225,00:00:33.000,2025-04-15 12:45:48.802
false,false,9969,9371,598,255,00:00:30.000,2025-04-15 12:45:49.803
false,false,9980,9381,599,246,00:00:31.000,2025-04-15 12:46:12.826
false,false,9983,9384,599,338,00:00:30.000,2025-04-15 12:46:15.830
false,false,10063,9459,604,225,00:00:33.000,2025-04-15 12:48:11.943
false,false,10082,9478,604,536,00:00:33.000,2025-04-15 12:48:36.968
false,false,10111,9504,607,1449,00:00:30.000,2025-04-15 12:49:06.001
false,false,10122,9514,608,1796,00:00:31.000,2025-04-15 12:49:17.014
false,false,10135,9527,608,225,00:00:33.000,2025-04-15 12:49:36.036
false,false,10138,9530,608,319,00:00:30.000,2025-04-15 12:49:39.037
false,false,9868,9275,593,126,00:00:31.000,2025-04-15 12:43:26.650
false,false,9873,9280,593,285,00:00:32.000,2025-04-15 12:43:31.656
false,false,9884,9290,594,629,00:00:30.000,2025-04-15 12:43:42.668
false,false,9913,9317,596,30,00:00:30.000,2025-04-15 12:44:17.702
false,false,9917,9321,596,156,00:00:30.000,2025-04-15 12:44:21.705
false,false,9932,9336,596,162,00:00:33.000,2025-04-15 12:44:42.725
false,false,9937,9341,596,321,00:00:33.000,2025-04-15 12:44:47.730
false,false,9723,9140,583,190,00:00:32.000,2025-04-15 12:40:07.458
false,true,9728,9145,583,0,00:00:00.000,2025-04-15 12:40:16.467
false,false,9731,9148,583,93,00:00:32.000,2025-04-15 12:40:21.472
false,false,9743,9160,583,465,00:00:30.000,2025-04-15 12:40:33.479
false,true,9751,9167,584,0,00:00:00.000,2025-04-15 12:40:48.493
false,false,9756,9172,584,159,00:00:33.000,2025-04-15 12:40:58.502
false,false,9765,9180,585,286,00:00:30.000,2025-04-15 12:41:13.515
false,false,9774,9188,586,572,00:00:32.000,2025-04-15 12:41:22.524
false,true,10013,9411,602,0,00:00:00.000,2025-04-15 12:46:54.862
false,true,10013,9411,602,0,00:00:00.000,2025-04-15 12:46:56.864
false,false,10015,9413,602,62,00:00:31.000,2025-04-15 12:46:59.866
false,true,10024,9421,603,0,00:00:00.000,2025-04-15 12:47:09.879
false,false,10033,9430,603,192,00:00:31.000,2025-04-15 12:47:29.903
false,false,10037,9434,603,317,00:00:33.000,2025-04-15 12:47:33.906
false,false,10046,9443,603,604,00:00:32.000,2025-04-15 12:47:42.915
false,false,10048,9445,603,31,00:00:31.000,2025-04-15 12:47:50.922
false,false,10050,9447,603,91,00:00:30.000,2025-04-15 12:47:52.923
false,false,10054,9451,603,216,00:00:32.000,2025-04-15 12:47:56.927
false,false,10060,9456,604,128,00:00:31.000,2025-04-15 12:48:08.939
false,true,10223,9606,617,0,00:00:00.000,2025-04-15 12:51:37.159
false,false,10245,9627,618,689,00:00:32.000,2025-04-15 12:52:02.188
false,false,10272,9654,618,1547,00:00:32.000,2025-04-15 12:52:29.218
false,false,10273,9655,618,1579,00:00:32.000,2025-04-15 12:52:30.219
false,false,10288,9668,620,155,00:00:32.000,2025-04-15 12:52:51.242
false,false,10306,9685,621,718,00:00:30.000,2025-04-15 12:53:09.259
false,false,10307,9686,621,748,00:00:30.000,2025-04-15 12:53:10.259
false,false,10382,9757,625,32,00:00:32.000,2025-04-15 12:54:55.369
false,false,10415,9788,627,94,00:00:30.000,2025-04-15 12:55:34.406
false,true,10433,9805,628,0,00:00:00.000,2025-04-15 12:56:22.452
false,false,10452,9822,630,60,00:00:30.000,2025-04-15 12:56:47.478
false,false,10481,9849,632,985,00:00:32.000,2025-04-15 12:57:16.505
false,false,10486,9853,633,1140,00:00:30.000,2025-04-15 12:57:21.514
false,true,10507,9874,633,0,00:00:00.000,2025-04-15 12:57:43.538
false,false,10508,9875,633,30,00:00:30.000,2025-04-15 12:57:49.542
false,true,10527,9892,635,0,00:00:00.000,2025-04-15 12:58:18.578
false,false,10533,9898,635,191,00:00:30.000,2025-04-15 12:58:26.584
false,false,10534,9899,635,222,00:00:31.000,2025-04-15 12:58:27.585
false,true,10539,9904,635,0,00:00:00.000,2025-04-15 12:58:35.591
false,false,10553,9917,636,441,00:00:33.000,2025-04-15 12:58:52.609
false,true,10555,9919,636,0,00:00:00.000,2025-04-15 12:59:00.615
false,true,10559,9922,637,0,00:00:00.000,2025-04-15 12:59:07.624
false,true,10559,9922,637,0,00:00:00.000,2025-04-15 12:59:10.628
false,false,10584,9947,637,788,00:00:32.000,2025-04-15 12:59:35.652
false,false,10310,9689,621,844,00:00:32.000,2025-04-15 12:53:13.261
false,false,10314,9692,622,968,00:00:31.000,2025-04-15 12:53:17.263
false,false,10324,9702,622,1276,00:00:30.000,2025-04-15 12:53:27.277
false,false,10337,9714,623,124,00:00:31.000,2025-04-15 12:53:46.294
false,false,10360,9736,624,93,00:00:31.000,2025-04-15 12:54:15.322
false,false,10365,9741,624,250,00:00:31.000,2025-04-15 12:54:20.329
false,true,10367,9743,624,0,00:00:00.000,2025-04-15 12:54:29.339
false,true,10367,9743,624,0,00:00:00.000,2025-04-15 12:54:32.342
false,false,10631,9989,642,1005,00:00:32.000,2025-04-15 13:00:28.705
false,true,10637,9995,642,0,00:00:00.000,2025-04-15 13:00:39.717
false,false,10648,10005,643,348,00:00:32.000,2025-04-15 13:00:51.731
false,true,10653,10010,643,0,00:00:00.000,2025-04-15 13:01:04.744
false,false,10661,10018,643,254,00:00:33.000,2025-04-15 13:01:16.753
false,true,10661,10018,643,0,00:00:00.000,2025-04-15 13:01:18.754
false,false,10663,10020,643,62,00:00:30.000,2025-04-15 13:01:24.757
false,false,10761,10112,649,32,00:00:32.000,2025-04-15 13:03:32.881
false,false,10763,10114,649,95,00:00:32.000,2025-04-15 13:03:34.882
false,false,10764,10115,649,125,00:00:30.000,2025-04-15 13:03:35.884
false,false,10770,10121,649,319,00:00:33.000,2025-04-15 13:03:41.892
false,true,10818,10168,650,0,00:00:00.000,2025-04-15 13:04:48.959
false,false,10893,10238,655,378,00:00:31.000,2025-04-15 13:06:39.068
false,false,10938,10281,657,437,00:00:32.000,2025-04-15 13:07:42.135
false,false,10949,10292,657,782,00:00:30.000,2025-04-15 13:07:53.147
false,true,10974,10317,657,0,00:00:00.000,2025-04-15 13:08:32.187
false,true,10974,10317,657,0,00:00:00.000,2025-04-15 13:08:36.190
false,false,10981,10324,657,122,00:00:30.000,2025-04-15 13:08:55.205
false,false,10989,10332,657,374,00:00:30.000,2025-04-15 13:09:03.214
false,false,10990,10333,657,405,00:00:31.000,2025-04-15 13:09:04.216
false,false,10999,10342,657,189,00:00:31.000,2025-04-15 13:09:25.234
false,false,11017,10360,657,255,00:00:33.000,2025-04-15 13:09:49.259
false,false,10684,10040,644,415,00:00:30.000,2025-04-15 13:01:51.786
false,false,10695,10049,646,771,00:00:31.000,2025-04-15 13:02:02.794
false,false,10698,10052,646,866,00:00:33.000,2025-04-15 13:02:05.797
false,true,10698,10052,646,0,00:00:00.000,2025-04-15 13:02:09.801
false,false,10728,10079,649,936,00:00:31.000,2025-04-15 13:02:41.835
false,false,10734,10085,649,1128,00:00:33.000,2025-04-15 13:02:47.842
false,true,10736,10087,649,0,00:00:00.000,2025-04-15 13:02:53.849
false,false,10742,10093,649,190,00:00:32.000,2025-04-15 13:03:01.858
false,false,10743,10094,649,222,00:00:32.000,2025-04-15 13:03:02.860
false,false,10831,10180,651,406,00:00:30.000,2025-04-15 13:05:06.976
false,false,10832,10181,651,437,00:00:31.000,2025-04-15 13:05:07.977
false,false,10856,10204,652,406,00:00:32.000,2025-04-15 13:05:44.010
false,true,10881,10226,655,0,00:00:00.000,2025-04-15 13:06:26.059
false,false,10883,10228,655,65,00:00:33.000,2025-04-15 13:06:29.061
false,false,10884,10229,655,95,00:00:30.000,2025-04-15 13:06:30.061
false,true,10156,9547,609,0,00:00:00.000,2025-04-15 12:49:58.060
false,true,10156,9547,609,0,00:00:00.000,2025-04-15 12:50:02.066
false,false,10168,9557,611,380,00:00:33.000,2025-04-15 12:50:15.077
false,false,10169,9558,611,412,00:00:32.000,2025-04-15 12:50:16.079
false,false,10184,9573,611,879,00:00:31.000,2025-04-15 12:50:31.094
false,false,10197,9581,616,31,00:00:31.000,2025-04-15 12:50:50.113
false,true,10212,9596,616,0,00:00:00.000,2025-04-15 12:51:21.143
false,true,10212,9596,616,0,00:00:00.000,2025-04-15 12:51:22.145
false,true,11035,10376,659,0,00:00:00.000,2025-04-15 13:10:15.278
false,true,11039,10380,659,0,00:00:00.000,2025-04-15 13:10:24.290
false,false,11045,10386,659,188,00:00:31.000,2025-04-15 13:10:35.294
false,false,11046,10387,659,221,00:00:33.000,2025-04-15 13:10:36.297
false,false,11060,10401,659,66,00:00:33.000,2025-04-15 13:10:56.317
false,false,11066,10407,659,254,00:00:31.000,2025-04-15 13:11:02.323
false,false,11077,10418,659,154,00:00:31.000,2025-04-15 13:11:19.339
false,false,11078,10419,659,187,00:00:33.000,2025-04-15 13:11:20.341
false,true,11089,10429,660,0,00:00:00.000,2025-04-15 13:11:32.351
false,false,11161,10497,664,282,00:00:31.000,2025-04-15 13:13:13.458
false,false,11164,10500,664,377,00:00:33.000,2025-04-15 13:13:16.460
false,false,11171,10507,664,598,00:00:30.000,2025-04-15 13:13:23.465
false,false,11187,10523,664,346,00:00:32.000,2025-04-15 13:13:45.490
false,false,11193,10529,664,533,00:00:31.000,2025-04-15 13:13:51.496
false,true,11196,10532,664,0,00:00:00.000,2025-04-15 13:13:55.501
false,false,11206,10542,664,94,00:00:31.000,2025-04-15 13:14:16.522
false,false,11208,10544,664,154,00:00:30.000,2025-04-15 13:14:18.525
false,false,11214,10549,665,341,00:00:32.000,2025-04-15 13:14:24.532
false,false,11232,10565,667,378,00:00:31.000,2025-04-15 13:14:48.554
false,false,11320,10646,674,757,00:00:30.000,2025-04-15 13:16:34.658
false,false,11329,10655,674,1039,00:00:32.000,2025-04-15 13:16:43.669
false,false,11351,10677,674,399,00:00:30.000,2025-04-15 13:17:23.713
false,false,11365,10691,674,370,00:00:31.000,2025-04-15 13:17:49.744
false,false,11376,10702,674,224,00:00:30.000,2025-04-15 13:18:06.758
false,false,11274,10607,667,1696,00:00:33.000,2025-04-15 13:15:30.597
false,false,11276,10609,667,1758,00:00:30.000,2025-04-15 13:15:32.601
false,true,11279,10611,668,0,00:00:00.000,2025-04-15 13:15:47.616
false,false,11306,10633,673,315,00:00:30.000,2025-04-15 13:16:20.647
false,false,11316,10642,674,634,00:00:33.000,2025-04-15 13:16:30.654
false,false,11098,10435,663,283,00:00:30.000,2025-04-15 13:11:46.363
false,false,11114,10451,663,782,00:00:31.000,2025-04-15 13:12:02.383
false,true,11131,10468,663,0,00:00:00.000,2025-04-15 13:12:33.416
false,false,11150,10486,664,600,00:00:33.000,2025-04-15 13:12:56.439
false,false,11391,10716,675,98,00:00:32.000,2025-04-15 13:18:33.783
false,true,11403,10723,680,0,00:00:00.000,2025-04-15 13:18:46.794
false,true,11403,10723,680,0,00:00:00.000,2025-04-15 13:18:50.799
false,false,11430,10749,681,633,00:00:32.000,2025-04-15 13:19:30.832
false,false,11451,10769,682,1297,00:00:31.000,2025-04-15 13:19:51.858
false,false,11536,10852,684,408,00:00:31.000,2025-04-15 13:21:40.986
false,false,11548,10863,685,30,00:00:30.000,2025-04-15 13:21:59.004
false,true,11549,10863,686,0,00:00:00.000,2025-04-15 13:22:05.010
false,true,11552,10864,688,0,00:00:00.000,2025-04-15 13:22:11.015
false,false,11567,10879,688,477,00:00:33.000,2025-04-15 13:22:30.033
false,false,11462,10780,682,1646,00:00:31.000,2025-04-15 13:20:02.871
false,true,11473,10791,682,0,00:00:00.000,2025-04-15 13:20:15.888
false,false,11480,10797,683,222,00:00:33.000,2025-04-15 13:20:26.902
false,false,11487,10804,683,437,00:00:31.000,2025-04-15 13:20:33.907
false,true,11511,10828,683,0,00:00:00.000,2025-04-15 13:21:06.947
false,true,11511,10828,683,0,00:00:00.000,2025-04-15 13:21:09.951
false,false,11520,10837,683,283,00:00:30.000,2025-04-15 13:21:18.958
false,true,11523,10840,683,0,00:00:00.000,2025-04-15 13:21:25.968
false,false,11525,10842,683,66,00:00:33.000,2025-04-15 13:21:29.974
false,true,11599,10910,689,0,00:00:00.000,2025-04-15 13:23:24.085
false,true,11611,10921,690,0,00:00:00.000,2025-04-15 13:23:40.104
false,true,11613,10923,690,0,00:00:00.000,2025-04-15 13:23:51.114
false,false,11629,10939,690,503,00:00:31.000,2025-04-15 13:24:08.132
false,false,11636,10945,691,725,00:00:32.000,2025-04-15 13:24:15.138
false,false,11638,10946,692,788,00:00:31.000,2025-04-15 13:24:17.139
false,false,11646,10953,693,189,00:00:31.000,2025-04-15 13:24:31.151
false,false,11661,10967,694,668,00:00:32.000,2025-04-15 13:24:46.168
false,false,11663,10969,694,728,00:00:30.000,2025-04-15 13:24:48.169
false,true,11731,11034,697,0,00:00:00.000,2025-04-15 13:26:39.287
false,false,11734,11037,697,95,00:00:32.000,2025-04-15 13:26:47.297
false,false,11745,11047,698,96,00:00:32.000,2025-04-15 13:27:04.313
false,false,11747,11048,699,158,00:00:31.000,2025-04-15 13:27:06.313
false,false,11750,11051,699,254,00:00:33.000,2025-04-15 13:27:09.316
false,true,11758,11058,700,0,00:00:00.000,2025-04-15 13:27:23.331
false,false,11775,11074,701,538,00:00:32.000,2025-04-15 13:27:40.349
false,false,11776,11075,701,570,00:00:32.000,2025-04-15 13:27:41.350
false,false,11790,11089,701,1004,00:00:32.000,2025-04-15 13:27:55.360
false,true,11811,11108,703,0,00:00:00.000,2025-04-15 13:28:18.377
false,false,11824,11120,704,406,00:00:33.000,2025-04-15 13:28:35.400
false,false,11830,11126,704,593,00:00:31.000,2025-04-15 13:28:41.406
false,false,11834,11130,704,717,00:00:30.000,2025-04-15 13:28:45.407
false,false,11839,11135,704,876,00:00:30.000,2025-04-15 13:28:50.412
false,false,11840,11135,705,909,00:00:33.000,2025-04-15 13:28:51.413
false,true,11866,11161,705,0,00:00:00.000,2025-04-15 13:29:45.472
false,true,11867,11162,705,0,00:00:00.000,2025-04-15 13:29:53.481
false,false,11673,10979,694,1040,00:00:32.000,2025-04-15 13:24:58.180
false,false,11679,10985,694,1231,00:00:30.000,2025-04-15 13:25:04.185
false,true,11685,10990,695,0,00:00:00.000,2025-04-15 13:25:16.200
false,false,11686,10991,695,31,00:00:31.000,2025-04-15 13:25:17.200
false,true,11686,10991,695,0,00:00:00.000,2025-04-15 13:25:19.202
false,true,11702,11005,697,0,00:00:00.000,2025-04-15 13:25:47.231
false,false,11723,11026,697,343,00:00:32.000,2025-04-15 13:26:24.274
false,true,11932,11223,709,0,00:00:00.000,2025-04-15 13:31:52.609
false,false,11933,11224,709,30,00:00:30.000,2025-04-15 13:31:54.611
false,false,11934,11225,709,60,00:00:30.000,2025-04-15 13:31:55.611
false,false,11967,11254,713,956,00:00:30.000,2025-04-15 13:32:40.662
false,false,11971,11257,714,30,00:00:30.000,2025-04-15 13:32:50.678
false,false,11973,11259,714,93,00:00:32.000,2025-04-15 13:32:52.680
false,false,11978,11264,714,157,00:00:30.000,2025-04-15 13:33:03.691
false,true,11874,11168,706,0,00:00:00.000,2025-04-15 13:30:07.495
false,false,11876,11170,706,66,00:00:33.000,2025-04-15 13:30:09.498
false,true,11878,11172,706,0,00:00:00.000,2025-04-15 13:30:17.507
false,false,11903,11194,709,284,00:00:33.000,2025-04-15 13:31:06.565
false,false,11917,11208,709,437,00:00:31.000,2025-04-15 13:31:26.583
false,true,2891,2721,170,0,00:00:00.000,2025-04-14 12:37:19.634
false,false,2896,2726,170,157,00:00:30.000,2025-04-14 12:37:39.652
false,false,2911,2741,170,126,00:00:32.000,2025-04-14 12:38:33.707
false,false,2950,2779,171,1363,00:00:30.000,2025-04-14 12:39:51.762
false,false,2959,2786,173,61,00:00:31.000,2025-04-14 12:40:21.782
false,true,2962,2789,173,0,00:00:00.000,2025-04-14 12:40:33.791
false,false,2986,2811,175,447,00:00:30.000,2025-04-14 12:41:51.858
false,true,2987,2812,175,0,00:00:00.000,2025-04-14 12:41:55.862
false,false,3010,2834,176,534,00:00:32.000,2025-04-14 12:43:15.931
false,false,3012,2836,176,597,00:00:33.000,2025-04-14 12:43:19.933
false,true,3018,2841,177,0,00:00:00.000,2025-04-14 12:43:33.946
false,true,3018,2841,177,0,00:00:00.000,2025-04-14 12:43:35.948
false,false,3042,2863,179,479,00:00:33.000,2025-04-14 12:44:56.000
false,false,3047,2868,179,66,00:00:33.000,2025-04-14 12:45:18.023
false,false,9827,9238,589,1104,00:00:30.000,2025-04-15 12:42:21.582
false,false,9829,9240,589,1170,00:00:33.000,2025-04-15 12:42:23.587
false,false,9832,9242,590,1264,00:00:33.000,2025-04-15 12:42:26.590
false,true,9849,9257,592,0,00:00:00.000,2025-04-15 12:42:53.617
false,true,9849,9257,592,0,00:00:00.000,2025-04-15 12:42:54.619
false,false,9850,9258,592,32,00:00:32.000,2025-04-15 12:42:56.621
false,true,9940,9344,596,0,00:00:00.000,2025-04-15 12:44:59.740
false,false,9946,9350,596,188,00:00:30.000,2025-04-15 12:45:08.752
false,false,9954,9358,596,442,00:00:30.000,2025-04-15 12:45:16.761
false,true,9954,9358,596,0,00:00:00.000,2025-04-15 12:45:20.765
false,true,9961,9364,597,0,00:00:00.000,2025-04-15 12:45:39.789
false,true,10065,9461,604,0,00:00:00.000,2025-04-15 12:48:14.945
false,false,10114,9507,607,1543,00:00:30.000,2025-04-15 12:49:09.006
false,false,10120,9512,608,1733,00:00:32.000,2025-04-15 12:49:15.011
false,false,10128,9520,608,1986,00:00:31.000,2025-04-15 12:49:23.022
false,false,10134,9526,608,192,00:00:32.000,2025-04-15 12:49:35.035
false,false,10137,9529,608,289,00:00:32.000,2025-04-15 12:49:38.037
false,false,10145,9537,608,538,00:00:30.000,2025-04-15 12:49:46.047
false,false,9862,9270,592,310,00:00:31.000,2025-04-15 12:43:14.635
false,true,9864,9272,592,0,00:00:00.000,2025-04-15 12:43:17.639
false,false,9894,9299,595,948,00:00:33.000,2025-04-15 12:43:52.679
false,false,9899,9304,595,1106,00:00:32.000,2025-04-15 12:43:57.686
false,true,9927,9331,596,0,00:00:00.000,2025-04-15 12:44:33.718
false,true,9717,9134,583,0,00:00:00.000,2025-04-15 12:39:56.448
false,true,9717,9134,583,0,00:00:00.000,2025-04-15 12:39:58.451
false,false,9742,9159,583,435,00:00:32.000,2025-04-15 12:40:32.479
false,false,9753,9169,584,63,00:00:30.000,2025-04-15 12:40:55.499
false,false,9782,9196,586,824,00:00:33.000,2025-04-15 12:41:30.530
false,true,10012,9410,602,0,00:00:00.000,2025-04-15 12:46:45.853
false,true,10012,9410,602,0,00:00:00.000,2025-04-15 12:46:46.855
false,false,10053,9450,603,184,00:00:31.000,2025-04-15 12:47:55.927
false,true,10056,9453,603,0,00:00:00.000,2025-04-15 12:47:59.931
false,true,10223,9606,617,0,00:00:00.000,2025-04-15 12:51:40.162
false,false,10231,9613,618,248,00:00:30.000,2025-04-15 12:51:48.169
false,false,10233,9615,618,311,00:00:30.000,2025-04-15 12:51:50.172
false,false,10236,9618,618,405,00:00:33.000,2025-04-15 12:51:53.176
false,false,10237,9619,618,437,00:00:32.000,2025-04-15 12:51:54.177
false,false,10238,9620,618,467,00:00:30.000,2025-04-15 12:51:55.178
false,false,10247,9629,618,753,00:00:32.000,2025-04-15 12:52:04.189
false,false,10251,9633,618,881,00:00:32.000,2025-04-15 12:52:08.193
false,false,10256,9638,618,1040,00:00:30.000,2025-04-15 12:52:13.199
false,false,10267,9649,618,1387,00:00:33.000,2025-04-15 12:52:24.212
false,false,10274,9656,618,1610,00:00:31.000,2025-04-15 12:52:31.221
false,false,10276,9657,619,1672,00:00:31.000,2025-04-15 12:52:33.221
false,false,10298,9677,621,471,00:00:31.000,2025-04-15 12:53:01.249
false,false,10300,9679,621,533,00:00:31.000,2025-04-15 12:53:03.250
false,false,10305,9684,621,688,00:00:30.000,2025-04-15 12:53:08.258
false,false,10383,9758,625,65,00:00:33.000,2025-04-15 12:54:56.370
false,false,10395,9768,627,446,00:00:32.000,2025-04-15 12:55:08.380
false,false,10396,9769,627,477,00:00:31.000,2025-04-15 12:55:09.382
false,false,10419,9792,627,221,00:00:32.000,2025-04-15 12:55:38.410
false,true,10423,9796,627,0,00:00:00.000,2025-04-15 12:55:52.421
false,true,10423,9796,627,0,00:00:00.000,2025-04-15 12:55:59.427
false,true,10423,9796,627,0,00:00:00.000,2025-04-15 12:56:00.428
false,true,10424,9797,627,0,00:00:00.000,2025-04-15 12:56:03.431
false,false,10444,9815,629,344,00:00:32.000,2025-04-15 12:56:33.461
false,false,10446,9817,629,406,00:00:31.000,2025-04-15 12:56:35.464
false,false,10469,9838,631,602,00:00:33.000,2025-04-15 12:57:04.495
false,false,10471,9839,632,664,00:00:32.000,2025-04-15 12:57:06.495
false,false,10489,9856,633,1231,00:00:30.000,2025-04-15 12:57:24.516
false,false,10506,9873,633,1757,00:00:32.000,2025-04-15 12:57:41.535
false,true,10515,9881,634,0,00:00:00.000,2025-04-15 12:57:58.556
false,true,10527,9892,635,0,00:00:00.000,2025-04-15 12:58:16.576
false,false,10542,9906,636,96,00:00:32.000,2025-04-15 12:58:41.597
false,false,10576,9939,637,534,00:00:31.000,2025-04-15 12:59:27.646
false,false,10340,9717,623,217,00:00:31.000,2025-04-15 12:53:49.297
false,false,10342,9719,623,281,00:00:33.000,2025-04-15 12:53:51.300
false,false,10346,9723,623,407,00:00:30.000,2025-04-15 12:53:55.305
false,false,10355,9731,624,689,00:00:32.000,2025-04-15 12:54:04.312
false,true,10357,9733,624,0,00:00:00.000,2025-04-15 12:54:12.319
false,false,10361,9737,624,126,00:00:33.000,2025-04-15 12:54:16.324
false,false,10363,9739,624,189,00:00:33.000,2025-04-15 12:54:18.326
false,false,10377,9752,625,315,00:00:31.000,2025-04-15 12:54:44.353
false,false,10604,9963,641,155,00:00:30.000,2025-04-15 13:00:01.680
false,false,10616,9974,642,533,00:00:33.000,2025-04-15 13:00:13.691
false,false,10636,9994,642,1167,00:00:33.000,2025-04-15 13:00:33.711
false,false,10665,10022,643,125,00:00:30.000,2025-04-15 13:01:26.760
false,false,10670,10027,643,281,00:00:30.000,2025-04-15 13:01:31.765
false,false,10757,10108,649,379,00:00:32.000,2025-04-15 13:03:22.872
false,true,10760,10111,649,0,00:00:00.000,2025-04-15 13:03:26.874
false,false,10775,10126,649,475,00:00:32.000,2025-04-15 13:03:46.895
false,true,10778,10129,649,0,00:00:00.000,2025-04-15 13:03:53.900
false,true,10778,10129,649,0,00:00:00.000,2025-04-15 13:04:01.908
false,false,10782,10133,649,124,00:00:30.000,2025-04-15 13:04:05.913
false,false,10783,10134,649,155,00:00:31.000,2025-04-15 13:04:06.914
false,false,10784,10135,649,188,00:00:33.000,2025-04-15 13:04:07.916
false,false,10815,10165,650,441,00:00:32.000,2025-04-15 13:04:44.955
false,false,10816,10166,650,472,00:00:31.000,2025-04-15 13:04:45.956
false,true,10897,10242,655,0,00:00:00.000,2025-04-15 13:06:47.079
false,false,10902,10247,655,158,00:00:31.000,2025-04-15 13:06:54.086
false,false,10909,10254,655,128,00:00:31.000,2025-04-15 13:07:07.098
false,false,10916,10260,656,348,00:00:33.000,2025-04-15 13:07:14.106
false,true,10924,10268,656,0,00:00:00.000,2025-04-15 13:07:28.118
false,false,10936,10279,657,373,00:00:30.000,2025-04-15 13:07:40.132
false,false,10941,10284,657,527,00:00:30.000,2025-04-15 13:07:45.138
false,false,10943,10286,657,592,00:00:32.000,2025-04-15 13:07:47.141
false,false,10945,10288,657,657,00:00:33.000,2025-04-15 13:07:49.143
false,true,10960,10303,657,0,00:00:00.000,2025-04-15 13:08:10.162
false,true,10966,10309,657,0,00:00:00.000,2025-04-15 13:08:17.168
false,true,10974,10317,657,0,00:00:00.000,2025-04-15 13:08:33.188
false,false,10982,10325,657,155,00:00:33.000,2025-04-15 13:08:56.206
false,false,10983,10326,657,186,00:00:31.000,2025-04-15 13:08:57.208
false,false,10985,10328,657,250,00:00:32.000,2025-04-15 13:08:59.209
false,false,10998,10341,657,158,00:00:30.000,2025-04-15 13:09:24.233
false,false,11018,10361,657,286,00:00:31.000,2025-04-15 13:09:50.260
false,false,10686,10042,644,478,00:00:30.000,2025-04-15 13:01:53.787
false,true,10698,10052,646,0,00:00:00.000,2025-04-15 13:02:11.803
false,false,10703,10057,646,154,00:00:30.000,2025-04-15 13:02:16.809
false,false,10706,10060,646,248,00:00:31.000,2025-04-15 13:02:19.811
false,false,10719,10071,648,652,00:00:30.000,2025-04-15 13:02:32.823
false,false,10724,10076,648,811,00:00:33.000,2025-04-15 13:02:37.830
false,false,10725,10077,648,841,00:00:30.000,2025-04-15 13:02:38.831
false,false,10731,10082,649,1032,00:00:33.000,2025-04-15 13:02:44.839
false,false,10735,10086,649,1160,00:00:32.000,2025-04-15 13:02:48.843
false,true,10736,10087,649,0,00:00:00.000,2025-04-15 13:02:50.845
false,true,10745,10096,649,0,00:00:00.000,2025-04-15 13:03:09.863
false,true,10833,10182,651,0,00:00:00.000,2025-04-15 13:05:09.980
false,false,10852,10201,651,283,00:00:32.000,2025-04-15 13:05:40.006
false,false,10857,10205,652,33,00:00:33.000,2025-04-15 13:05:51.022
false,false,10867,10215,652,94,00:00:33.000,2025-04-15 13:06:07.039
false,false,10870,10217,653,188,00:00:32.000,2025-04-15 13:06:10.041
false,true,10881,10226,655,0,00:00:00.000,2025-04-15 13:06:27.059
false,false,10155,9547,608,854,00:00:31.000,2025-04-15 12:49:56.058
false,false,10165,9554,611,283,00:00:32.000,2025-04-15 12:50:12.074
false,false,10175,9564,611,599,00:00:30.000,2025-04-15 12:50:22.085
false,false,10177,9566,611,662,00:00:32.000,2025-04-15 12:50:24.086
false,false,10191,9577,614,1101,00:00:33.000,2025-04-15 12:50:38.102
false,false,10194,9579,615,1194,00:00:30.000,2025-04-15 12:50:41.104
false,false,10216,9600,616,126,00:00:33.000,2025-04-15 12:51:27.148
false,false,11036,10377,659,32,00:00:32.000,2025-04-15 13:10:20.285
false,true,11058,10399,659,0,00:00:00.000,2025-04-15 13:10:53.315
false,false,11062,10403,659,130,00:00:33.000,2025-04-15 13:10:58.320
false,false,11064,10405,659,192,00:00:30.000,2025-04-15 13:11:00.322
false,true,11072,10413,659,0,00:00:00.000,2025-04-15 13:11:10.330
false,false,11075,10416,659,93,00:00:30.000,2025-04-15 13:11:17.337
false,false,11191,10527,664,472,00:00:33.000,2025-04-15 13:13:49.493
false,false,11204,10540,664,33,00:00:33.000,2025-04-15 13:14:14.522
false,false,11215,10550,665,372,00:00:31.000,2025-04-15 13:14:25.533
false,true,11220,10553,667,0,00:00:00.000,2025-04-15 13:14:31.538
false,true,11220,10553,667,0,00:00:00.000,2025-04-15 13:14:35.541
false,false,11235,10568,667,470,00:00:30.000,2025-04-15 13:14:51.557
false,true,11329,10655,674,0,00:00:00.000,2025-04-15 13:16:45.671
false,false,11378,10704,674,285,00:00:31.000,2025-04-15 13:18:08.759
false,false,11379,10705,674,317,00:00:32.000,2025-04-15 13:18:09.761
false,false,11249,10582,667,908,00:00:31.000,2025-04-15 13:15:05.571
false,false,11279,10611,668,62,00:00:31.000,2025-04-15 13:15:41.608
false,true,11279,10611,668,0,00:00:00.000,2025-04-15 13:15:45.614
false,true,11296,10624,672,0,00:00:00.000,2025-04-15 13:16:10.637
false,false,11106,10443,663,530,00:00:31.000,2025-04-15 13:11:54.375
false,false,11107,10444,663,563,00:00:33.000,2025-04-15 13:11:55.376
false,false,11129,10466,663,252,00:00:30.000,2025-04-15 13:12:29.414
false,true,11131,10468,663,0,00:00:00.000,2025-04-15 13:12:37.420
false,false,11151,10487,664,630,00:00:30.000,2025-04-15 13:12:57.440
false,true,11152,10488,664,0,00:00:00.000,2025-04-15 13:13:03.446
false,false,11381,10707,674,32,00:00:32.000,2025-04-15 13:18:17.768
false,true,11406,10726,680,0,00:00:00.000,2025-04-15 13:18:55.802
false,true,11406,10726,680,0,00:00:00.000,2025-04-15 13:18:57.802
false,true,11406,10726,680,0,00:00:00.000,2025-04-15 13:19:00.805
false,true,11410,10729,681,0,00:00:00.000,2025-04-15 13:19:08.811
false,false,11424,10743,681,443,00:00:33.000,2025-04-15 13:19:24.826
false,false,11444,10763,681,1072,00:00:30.000,2025-04-15 13:19:44.848
false,true,11552,10864,688,0,00:00:00.000,2025-04-15 13:22:13.018
false,false,11557,10869,688,156,00:00:30.000,2025-04-15 13:22:20.027
false,false,11559,10871,688,219,00:00:31.000,2025-04-15 13:22:22.028
false,false,11561,10873,688,284,00:00:32.000,2025-04-15 13:22:24.029
false,false,11584,10895,689,376,00:00:30.000,2025-04-15 13:22:53.054
false,false,11461,10779,682,1615,00:00:32.000,2025-04-15 13:20:01.870
false,false,11478,10795,683,158,00:00:32.000,2025-04-15 13:20:24.900
false,false,11484,10801,683,345,00:00:30.000,2025-04-15 13:20:30.906
false,false,11488,10805,683,468,00:00:31.000,2025-04-15 13:20:34.909
false,false,11495,10812,683,690,00:00:33.000,2025-04-15 13:20:41.913
false,false,11503,10820,683,123,00:00:30.000,2025-04-15 13:20:55.934
false,false,11504,10821,683,154,00:00:31.000,2025-04-15 13:20:56.936
false,true,11598,10909,689,0,00:00:00.000,2025-04-15 13:23:17.078
false,true,11611,10921,690,0,00:00:00.000,2025-04-15 13:23:39.103
false,false,11615,10925,690,63,00:00:30.000,2025-04-15 13:23:54.118
false,false,11621,10931,690,255,00:00:30.000,2025-04-15 13:24:00.123
false,false,11633,10943,690,631,00:00:33.000,2025-04-15 13:24:12.136
false,true,11640,10947,693,0,00:00:00.000,2025-04-15 13:24:23.143
false,false,11727,11030,697,31,00:00:31.000,2025-04-15 13:26:34.282
false,false,11730,11033,697,130,00:00:33.000,2025-04-15 13:26:37.285
false,false,11742,11044,698,350,00:00:33.000,2025-04-15 13:26:55.305
false,true,11742,11044,698,0,00:00:00.000,2025-04-15 13:26:57.307
false,true,11742,11044,698,0,00:00:00.000,2025-04-15 13:26:59.308
false,false,11764,11063,701,187,00:00:30.000,2025-04-15 13:27:29.337
false,false,11768,11067,701,315,00:00:32.000,2025-04-15 13:27:33.340
false,false,11785,11084,701,850,00:00:30.000,2025-04-15 13:27:50.356
false,true,11811,11108,703,0,00:00:00.000,2025-04-15 13:28:19.380
false,false,11813,11110,703,63,00:00:33.000,2025-04-15 13:28:24.389
false,false,11814,11111,703,94,00:00:31.000,2025-04-15 13:28:25.389
false,false,11833,11129,704,687,00:00:30.000,2025-04-15 13:28:44.407
false,false,11842,11137,705,972,00:00:32.000,2025-04-15 13:28:53.416
false,false,11852,11147,705,225,00:00:32.000,2025-04-15 13:29:09.430
false,false,11854,11149,705,291,00:00:33.000,2025-04-15 13:29:11.432
false,true,11858,11153,705,0,00:00:00.000,2025-04-15 13:29:24.446
false,true,11858,11153,705,0,00:00:00.000,2025-04-15 13:29:27.449
false,true,11867,11162,705,0,00:00:00.000,2025-04-15 13:29:52.479
false,false,11678,10984,694,1201,00:00:33.000,2025-04-15 13:25:03.185
false,false,11682,10987,695,1325,00:00:32.000,2025-04-15 13:25:07.190
false,true,11685,10990,695,0,00:00:00.000,2025-04-15 13:25:13.196
false,false,11691,10996,695,155,00:00:30.000,2025-04-15 13:25:28.209
false,false,11693,10998,695,218,00:00:30.000,2025-04-15 13:25:30.210
false,false,11700,11003,697,127,00:00:32.000,2025-04-15 13:25:43.226
false,false,11702,11005,697,192,00:00:33.000,2025-04-15 13:25:45.229
false,false,11712,11015,697,318,00:00:32.000,2025-04-15 13:26:01.246
false,true,11712,11015,697,0,00:00:00.000,2025-04-15 13:26:06.252
false,false,11718,11021,697,188,00:00:31.000,2025-04-15 13:26:19.269
false,false,11720,11023,697,250,00:00:32.000,2025-04-15 13:26:21.271
false,false,11726,11029,697,435,00:00:32.000,2025-04-15 13:26:27.276
false,true,11931,11222,709,0,00:00:00.000,2025-04-15 13:31:45.603
false,true,11932,11223,709,0,00:00:00.000,2025-04-15 13:31:53.610
false,true,11937,11228,709,0,00:00:00.000,2025-04-15 13:32:01.618
false,false,11938,11229,709,32,00:00:32.000,2025-04-15 13:32:11.626
false,false,11946,11235,711,291,00:00:33.000,2025-04-15 13:32:19.635
false,false,11955,11242,713,580,00:00:33.000,2025-04-15 13:32:28.643
false,false,11966,11253,713,926,00:00:30.000,2025-04-15 13:32:39.660
false,true,11970,11256,714,0,00:00:00.000,2025-04-15 13:32:46.668
false,true,11973,11259,714,0,00:00:00.000,2025-04-15 13:32:58.687
false,true,11983,11269,714,0,00:00:00.000,2025-04-15 13:33:09.696
false,false,11869,11164,705,64,00:00:31.000,2025-04-15 13:29:56.483
false,false,11872,11167,705,162,00:00:32.000,2025-04-15 13:29:59.486
false,false,11874,11168,706,225,00:00:33.000,2025-04-15 13:30:01.487
false,false,11879,11173,706,30,00:00:30.000,2025-04-15 13:30:18.509
false,true,11887,11180,707,0,00:00:00.000,2025-04-15 13:30:29.524
false,true,11887,11180,707,0,00:00:00.000,2025-04-15 13:30:33.530
false,false,11893,11184,709,192,00:00:33.000,2025-04-15 13:30:44.540
false,true,11893,11184,709,0,00:00:00.000,2025-04-15 13:30:50.546
false,true,11903,11194,709,0,00:00:00.000,2025-04-15 13:31:08.566
false,false,11912,11203,709,276,00:00:33.000,2025-04-15 13:31:21.576
false,false,11923,11214,709,626,00:00:33.000,2025-04-15 13:31:32.588
false,false,2903,2733,170,378,00:00:30.000,2025-04-14 12:37:53.664
false,false,2932,2761,171,782,00:00:32.000,2025-04-14 12:39:15.743
false,false,2942,2771,171,1104,00:00:30.000,2025-04-14 12:39:35.753
false,false,2966,2792,174,125,00:00:32.000,2025-04-14 12:40:59.814
false,false,2989,2813,176,63,00:00:32.000,2025-04-14 12:42:09.874
false,true,2993,2817,176,0,00:00:00.000,2025-04-14 12:42:31.895
false,false,2997,2821,176,123,00:00:32.000,2025-04-14 12:42:49.909
false,false,3005,2829,176,375,00:00:32.000,2025-04-14 12:43:05.923
false,false,3034,2855,179,224,00:00:31.000,2025-04-14 12:44:39.993
false,true,3045,2866,179,0,00:00:00.000,2025-04-14 12:45:10.016
false,false,9792,9205,587,1136,00:00:31.000,2025-04-15 12:41:40.542
false,true,9792,9205,587,0,00:00:00.000,2025-04-15 12:41:42.543
false,false,9802,9215,587,315,00:00:32.000,2025-04-15 12:41:56.560
false,false,9831,9241,590,1231,00:00:30.000,2025-04-15 12:42:25.589
false,false,9838,9247,591,1453,00:00:33.000,2025-04-15 12:42:32.596
false,false,9848,9256,592,1771,00:00:33.000,2025-04-15 12:42:42.606
false,true,9849,9257,592,0,00:00:00.000,2025-04-15 12:42:50.613
false,true,9852,9260,592,0,00:00:00.000,2025-04-15 12:43:04.627
false,true,9937,9341,596,0,00:00:00.000,2025-04-15 12:44:52.734
false,false,9967,9369,598,192,00:00:30.000,2025-04-15 12:45:47.801
false,true,9972,9374,598,0,00:00:00.000,2025-04-15 12:46:01.815
false,true,9972,9374,598,0,00:00:00.000,2025-04-15 12:46:04.819
false,false,9975,9377,598,93,00:00:32.000,2025-04-15 12:46:07.824
false,false,9977,9378,599,154,00:00:30.000,2025-04-15 12:46:09.825
false,false,10075,9471,604,316,00:00:30.000,2025-04-15 12:48:29.959
false,false,10130,9522,608,63,00:00:33.000,2025-04-15 12:49:31.029
false,false,10132,9524,608,127,00:00:32.000,2025-04-15 12:49:33.032
false,false,9877,9284,593,408,00:00:30.000,2025-04-15 12:43:35.661
false,false,9889,9295,594,789,00:00:33.000,2025-04-15 12:43:47.673
false,false,9715,9132,583,434,00:00:30.000,2025-04-15 12:39:53.445
false,true,9717,9134,583,0,00:00:00.000,2025-04-15 12:40:00.452
false,false,9719,9136,583,63,00:00:31.000,2025-04-15 12:40:03.455
false,false,9720,9137,583,96,00:00:33.000,2025-04-15 12:40:04.456
false,true,9728,9145,583,0,00:00:00.000,2025-04-15 12:40:18.469
false,false,9730,9147,583,61,00:00:31.000,2025-04-15 12:40:20.471
false,true,9748,9165,583,0,00:00:00.000,2025-04-15 12:40:41.486
false,true,9751,9167,584,0,00:00:00.000,2025-04-15 12:40:50.494
false,true,9751,9167,584,0,00:00:00.000,2025-04-15 12:40:51.494
false,false,9755,9171,584,126,00:00:30.000,2025-04-15 12:40:57.501
false,false,9771,9186,585,476,00:00:30.000,2025-04-15 12:41:19.520
false,true,10047,9444,603,0,00:00:00.000,2025-04-15 12:47:49.921
false,false,10223,9606,617,346,00:00:31.000,2025-04-15 12:51:34.155
false,false,10234,9616,618,341,00:00:30.000,2025-04-15 12:51:51.173
false,false,10278,9659,619,1735,00:00:33.000,2025-04-15 12:52:35.225
false,false,10291,9671,620,252,00:00:33.000,2025-04-15 12:52:54.244
false,false,10303,9682,621,626,00:00:31.000,2025-04-15 12:53:06.255
false,true,10381,9756,625,0,00:00:00.000,2025-04-15 12:54:53.367
false,false,10384,9759,625,97,00:00:32.000,2025-04-15 12:54:57.372
false,false,10412,9785,627,984,00:00:33.000,2025-04-15 12:55:25.398
false,true,10424,9797,627,0,00:00:00.000,2025-04-15 12:56:02.429
false,false,10431,9803,628,220,00:00:30.000,2025-04-15 12:56:14.443
false,false,10432,9804,628,251,00:00:31.000,2025-04-15 12:56:15.445
false,true,10450,9820,630,0,00:00:00.000,2025-04-15 12:56:43.474
false,false,10480,9848,632,953,00:00:31.000,2025-04-15 12:57:15.505
false,false,10484,9851,633,1078,00:00:30.000,2025-04-15 12:57:19.510
false,false,10503,9870,633,1665,00:00:31.000,2025-04-15 12:57:38.530
false,true,10507,9874,633,0,00:00:00.000,2025-04-15 12:57:44.538
false,false,10513,9880,633,188,00:00:30.000,2025-04-15 12:57:54.550
false,false,10515,9881,634,253,00:00:33.000,2025-04-15 12:57:56.553
false,false,10551,9915,636,376,00:00:33.000,2025-04-15 12:58:50.605
false,true,10555,9919,636,0,00:00:00.000,2025-04-15 12:58:59.614
false,false,10557,9921,636,63,00:00:33.000,2025-04-15 12:59:02.619
false,false,10565,9928,637,187,00:00:32.000,2025-04-15 12:59:16.635
false,false,10573,9936,637,440,00:00:30.000,2025-04-15 12:59:24.645
false,false,10586,9949,637,850,00:00:32.000,2025-04-15 12:59:37.655
false,false,10328,9706,622,1399,00:00:33.000,2025-04-15 12:53:31.282
false,true,10367,9743,624,0,00:00:00.000,2025-04-15 12:54:31.341
false,false,10370,9745,625,92,00:00:30.000,2025-04-15 12:54:37.348
false,false,10624,9982,642,784,00:00:32.000,2025-04-15 13:00:21.699
false,false,10626,9984,642,847,00:00:33.000,2025-04-15 13:00:23.702
false,false,10640,9998,642,92,00:00:31.000,2025-04-15 13:00:43.723
false,false,10642,9999,643,158,00:00:33.000,2025-04-15 13:00:45.727
false,false,10643,10000,643,189,00:00:31.000,2025-04-15 13:00:46.728
false,false,10649,10006,643,380,00:00:32.000,2025-04-15 13:00:52.731
false,true,10653,10010,643,0,00:00:00.000,2025-04-15 13:01:05.744
false,false,10664,10021,643,95,00:00:33.000,2025-04-15 13:01:25.759
false,false,10667,10024,643,188,00:00:32.000,2025-04-15 13:01:28.763
false,false,10751,10102,649,189,00:00:33.000,2025-04-15 13:03:16.868
false,false,10760,10111,649,474,00:00:30.000,2025-04-15 13:03:25.874
false,true,10778,10129,649,0,00:00:00.000,2025-04-15 13:03:55.902
false,false,10780,10131,649,64,00:00:32.000,2025-04-15 13:04:03.910
false,false,10781,10132,649,94,00:00:30.000,2025-04-15 13:04:04.910
false,false,10787,10138,649,285,00:00:33.000,2025-04-15 13:04:10.918
false,false,10789,10140,649,346,00:00:30.000,2025-04-15 13:04:12.922
false,true,10801,10151,650,0,00:00:00.000,2025-04-15 13:04:25.938
false,true,10801,10151,650,0,00:00:00.000,2025-04-15 13:04:28.941
false,true,10801,10151,650,0,00:00:00.000,2025-04-15 13:04:29.942
false,false,10807,10157,650,187,00:00:31.000,2025-04-15 13:04:36.948
false,false,10887,10232,655,189,00:00:30.000,2025-04-15 13:06:33.064
false,true,10905,10250,655,0,00:00:00.000,2025-04-15 13:07:01.092
false,false,10915,10259,656,315,00:00:30.000,2025-04-15 13:07:13.104
false,false,10917,10261,656,380,00:00:32.000,2025-04-15 13:07:15.106
false,true,10924,10268,656,0,00:00:00.000,2025-04-15 13:07:23.117
false,false,10934,10277,657,311,00:00:30.000,2025-04-15 13:07:38.130
false,false,10951,10294,657,845,00:00:31.000,2025-04-15 13:07:55.148
false,false,10957,10300,657,1030,00:00:30.000,2025-04-15 13:08:01.152
false,false,10991,10334,657,438,00:00:33.000,2025-04-15 13:09:05.216
false,true,10991,10334,657,0,00:00:00.000,2025-04-15 13:09:09.218
false,true,10993,10336,657,0,00:00:00.000,2025-04-15 13:09:15.222
false,false,11009,10352,657,505,00:00:31.000,2025-04-15 13:09:35.242
false,false,11012,10355,657,96,00:00:31.000,2025-04-15 13:09:44.252
false,false,10677,10033,644,194,00:00:32.000,2025-04-15 13:01:44.779
false,false,10820,10170,650,63,00:00:31.000,2025-04-15 13:04:55.965
false,false,10827,10177,650,281,00:00:30.000,2025-04-15 13:05:02.972
false,true,10843,10192,651,0,00:00:00.000,2025-04-15 13:05:27.997
false,true,10881,10226,655,0,00:00:00.000,2025-04-15 13:06:22.054
false,false,10187,9575,612,974,00:00:31.000,2025-04-15 12:50:34.097
false,false,10189,9576,613,1036,00:00:30.000,2025-04-15 12:50:36.100
false,true,10202,9586,616,0,00:00:00.000,2025-04-15 12:51:05.124
false,false,10220,9604,616,255,00:00:33.000,2025-04-15 12:51:31.152
false,false,11030,10371,659,250,00:00:32.000,2025-04-15 13:10:08.272
false,false,11037,10378,659,65,00:00:33.000,2025-04-15 13:10:21.286
false,false,11076,10417,659,123,00:00:30.000,2025-04-15 13:11:18.338
false,false,11165,10501,664,409,00:00:32.000,2025-04-15 13:13:17.460
false,false,11168,10504,664,503,00:00:33.000,2025-04-15 13:13:20.462
false,false,11172,10508,664,630,00:00:32.000,2025-04-15 13:13:24.466
false,false,11182,10518,664,188,00:00:33.000,2025-04-15 13:13:40.482
false,false,11199,10535,664,93,00:00:32.000,2025-04-15 13:14:03.507
false,true,11203,10539,664,0,00:00:00.000,2025-04-15 13:14:12.519
false,false,11319,10645,674,727,00:00:30.000,2025-04-15 13:16:33.657
false,false,11331,10657,674,62,00:00:31.000,2025-04-15 13:16:51.680
false,true,11336,10662,674,0,00:00:00.000,2025-04-15 13:17:01.692
false,false,11346,10672,674,245,00:00:30.000,2025-04-15 13:17:18.708
false,false,11358,10684,674,152,00:00:30.000,2025-04-15 13:17:42.736
false,false,11364,10690,674,339,00:00:31.000,2025-04-15 13:17:48.743
false,false,11367,10693,674,432,00:00:30.000,2025-04-15 13:17:51.746
false,true,11369,10695,674,0,00:00:00.000,2025-04-15 13:17:57.751
false,false,11244,10577,667,750,00:00:33.000,2025-04-15 13:15:00.566
false,false,11245,10578,667,780,00:00:30.000,2025-04-15 13:15:01.566
false,false,11262,10595,667,1316,00:00:31.000,2025-04-15 13:15:18.586
false,false,11263,10596,667,1349,00:00:33.000,2025-04-15 13:15:19.588
false,false,11269,10602,667,1537,00:00:32.000,2025-04-15 13:15:25.594
false,false,11270,10603,667,1569,00:00:32.000,2025-04-15 13:15:26.595
false,false,11283,10614,669,128,00:00:30.000,2025-04-15 13:15:51.621
false,false,11299,10626,673,93,00:00:30.000,2025-04-15 13:16:13.641
false,false,11313,10639,674,536,00:00:32.000,2025-04-15 13:16:27.651
false,false,11318,10644,674,697,00:00:32.000,2025-04-15 13:16:32.656
false,true,11089,10429,660,0,00:00:00.000,2025-04-15 13:11:33.352
false,false,11103,10440,663,436,00:00:31.000,2025-04-15 13:11:51.372
false,false,11105,10442,663,499,00:00:32.000,2025-04-15 13:11:53.374
false,false,11112,10449,663,720,00:00:31.000,2025-04-15 13:12:00.380
false,true,11121,10458,663,0,00:00:00.000,2025-04-15 13:12:17.400
false,false,11125,10462,663,128,00:00:30.000,2025-04-15 13:12:25.411
false,false,11137,10474,663,184,00:00:30.000,2025-04-15 13:12:43.426
false,false,11147,10483,664,502,00:00:33.000,2025-04-15 13:12:53.436
false,false,11159,10495,664,220,00:00:32.000,2025-04-15 13:13:11.456
false,true,11380,10706,674,0,00:00:00.000,2025-04-15 13:18:14.764
false,false,11386,10712,674,195,00:00:33.000,2025-04-15 13:18:22.774
false,true,11410,10729,681,0,00:00:00.000,2025-04-15 13:19:06.808
false,true,11410,10729,681,0,00:00:00.000,2025-04-15 13:19:10.812
false,false,11415,10734,681,158,00:00:33.000,2025-04-15 13:19:15.817
false,false,11545,10861,684,690,00:00:30.000,2025-04-15 13:21:49.995
false,true,11549,10863,686,0,00:00:00.000,2025-04-15 13:22:04.009
false,true,11552,10864,688,0,00:00:00.000,2025-04-15 13:22:15.021
false,false,11556,10868,688,126,00:00:30.000,2025-04-15 13:22:19.026
false,true,11572,10883,689,0,00:00:00.000,2025-04-15 13:22:41.044
false,false,11587,10898,689,470,00:00:32.000,2025-04-15 13:22:56.059
false,true,11588,10899,689,0,00:00:00.000,2025-04-15 13:23:03.067
false,false,11497,10814,683,756,00:00:33.000,2025-04-15 13:20:43.917
false,false,11498,10815,683,786,00:00:30.000,2025-04-15 13:20:44.919
false,true,11499,10816,683,0,00:00:00.000,2025-04-15 13:20:48.926
false,false,11506,10823,683,217,00:00:30.000,2025-04-15 13:20:58.938
false,true,11511,10828,683,0,00:00:00.000,2025-04-15 13:21:04.945
false,true,11511,10828,683,0,00:00:00.000,2025-04-15 13:21:05.947
false,false,11515,10832,683,126,00:00:31.000,2025-04-15 13:21:13.953
false,false,11639,10946,693,818,00:00:30.000,2025-04-15 13:24:18.139
false,false,11647,10954,693,222,00:00:33.000,2025-04-15 13:24:32.152
false,true,11731,11034,697,0,00:00:00.000,2025-04-15 13:26:41.290
false,false,11733,11036,697,63,00:00:33.000,2025-04-15 13:26:46.294
false,false,11780,11079,701,696,00:00:33.000,2025-04-15 13:27:45.353
false,false,11796,11094,702,1199,00:00:32.000,2025-04-15 13:28:01.365
false,false,11801,11099,702,1354,00:00:30.000,2025-04-15 13:28:06.368
false,false,11849,11144,705,128,00:00:32.000,2025-04-15 13:29:06.426
false,true,11858,11153,705,0,00:00:00.000,2025-04-15 13:29:30.453
false,false,11861,11156,705,95,00:00:33.000,2025-04-15 13:29:36.462
false,false,11865,11160,705,223,00:00:32.000,2025-04-15 13:29:40.466
false,true,11696,10999,697,0,00:00:00.000,2025-04-15 13:25:34.214
false,false,11698,11001,697,63,00:00:31.000,2025-04-15 13:25:41.223
false,false,11699,11002,697,95,00:00:32.000,2025-04-15 13:25:42.225
false,false,11714,11017,697,64,00:00:33.000,2025-04-15 13:26:15.264
false,false,11719,11022,697,218,00:00:30.000,2025-04-15 13:26:20.270
false,true,11937,11228,709,0,00:00:00.000,2025-04-15 13:32:06.623
false,true,11937,11228,709,0,00:00:00.000,2025-04-15 13:32:07.624
false,false,11948,11237,711,352,00:00:30.000,2025-04-15 13:32:21.637
false,false,11961,11248,713,768,00:00:31.000,2025-04-15 13:32:34.655
false,true,11874,11168,706,0,00:00:00.000,2025-04-15 13:30:03.491
false,false,11899,11190,709,155,00:00:30.000,2025-04-15 13:31:02.559
false,false,11906,11197,709,93,00:00:30.000,2025-04-15 13:31:15.572
false,false,2895,2725,170,127,00:00:33.000,2025-04-14 12:37:37.650
false,false,2901,2731,170,315,00:00:32.000,2025-04-14 12:37:49.661
false,true,2907,2737,170,0,00:00:00.000,2025-04-14 12:38:19.693
false,false,2945,2774,171,1202,00:00:32.000,2025-04-14 12:39:41.756
false,false,2964,2790,174,61,00:00:30.000,2025-04-14 12:40:55.811
false,false,2987,2812,175,480,00:00:33.000,2025-04-14 12:41:53.860
false,false,2993,2817,176,95,00:00:30.000,2025-04-14 12:42:29.895
false,false,3011,2835,176,564,00:00:30.000,2025-04-14 12:43:17.932
false,true,3020,2842,178,0,00:00:00.000,2025-04-14 12:43:51.959
false,false,9804,9217,587,379,00:00:33.000,2025-04-15 12:41:58.561
false,false,9818,9230,588,823,00:00:30.000,2025-04-15 12:42:12.573
false,false,9823,9234,589,977,00:00:31.000,2025-04-15 12:42:17.577
false,false,9847,9255,592,1738,00:00:31.000,2025-04-15 12:42:41.605
false,true,9849,9257,592,0,00:00:00.000,2025-04-15 12:42:52.615
false,true,9852,9260,592,0,00:00:00.000,2025-04-15 12:43:02.623
false,true,9937,9341,596,0,00:00:00.000,2025-04-15 12:44:51.733
false,false,9944,9348,596,125,00:00:33.000,2025-04-15 12:45:06.750
false,true,10065,9461,604,0,00:00:00.000,2025-04-15 12:48:19.951
false,false,10067,9463,604,62,00:00:31.000,2025-04-15 12:48:21.953
false,false,10079,9475,604,440,00:00:30.000,2025-04-15 12:48:33.963
false,false,10100,9494,606,1104,00:00:32.000,2025-04-15 12:48:54.991
false,false,10105,9498,607,1262,00:00:33.000,2025-04-15 12:48:59.995
false,false,10108,9501,607,1355,00:00:33.000,2025-04-15 12:49:02.998
false,false,10110,9503,607,1419,00:00:33.000,2025-04-15 12:49:05.001
false,false,10136,9528,608,257,00:00:32.000,2025-04-15 12:49:37.037
false,false,10149,9541,608,663,00:00:31.000,2025-04-15 12:49:50.052
false,true,9864,9272,592,0,00:00:00.000,2025-04-15 12:43:22.645
false,false,9895,9300,595,978,00:00:30.000,2025-04-15 12:43:53.679
false,false,9901,9306,595,1172,00:00:33.000,2025-04-15 12:43:59.689
false,false,9904,9308,596,1268,00:00:32.000,2025-04-15 12:44:02.692
false,true,9912,9316,596,0,00:00:00.000,2025-04-15 12:44:16.701
false,true,9927,9331,596,0,00:00:00.000,2025-04-15 12:44:34.718
false,false,9928,9332,596,32,00:00:32.000,2025-04-15 12:44:38.721
false,true,9937,9341,596,0,00:00:00.000,2025-04-15 12:44:50.732
false,true,9717,9134,583,0,00:00:00.000,2025-04-15 12:40:01.452
false,true,9728,9145,583,0,00:00:00.000,2025-04-15 12:40:14.465
false,true,9728,9145,583,0,00:00:00.000,2025-04-15 12:40:15.466
false,false,9739,9156,583,343,00:00:33.000,2025-04-15 12:40:29.476
false,false,10003,9403,600,969,00:00:32.000,2025-04-15 12:46:35.848
false,false,10023,9420,603,313,00:00:31.000,2025-04-15 12:47:07.877
false,false,10032,9429,603,161,00:00:32.000,2025-04-15 12:47:28.902
false,false,10062,9458,604,192,00:00:31.000,2025-04-15 12:48:10.941
false,false,10244,9626,618,657,00:00:32.000,2025-04-15 12:52:01.186
false,false,10250,9632,618,849,00:00:33.000,2025-04-15 12:52:07.192
false,false,10264,9646,618,1289,00:00:31.000,2025-04-15 12:52:21.207
false,true,10283,9664,619,0,00:00:00.000,2025-04-15 12:52:41.233
false,false,10414,9787,627,64,00:00:33.000,2025-04-15 12:55:33.405
false,true,10419,9792,627,0,00:00:00.000,2025-04-15 12:55:44.414
false,false,10423,9796,627,123,00:00:30.000,2025-04-15 12:55:48.419
false,true,10423,9796,627,0,00:00:00.000,2025-04-15 12:55:51.420
false,false,10436,9807,629,92,00:00:30.000,2025-04-15 12:56:25.457
false,false,10441,9812,629,249,00:00:33.000,2025-04-15 12:56:30.458
false,false,10457,9827,630,217,00:00:31.000,2025-04-15 12:56:52.485
false,false,10492,9859,633,1327,00:00:31.000,2025-04-15 12:57:27.520
false,false,10504,9871,633,1695,00:00:30.000,2025-04-15 12:57:39.532
false,true,10515,9881,634,0,00:00:00.000,2025-04-15 12:58:02.560
false,false,10516,9882,634,33,00:00:33.000,2025-04-15 12:58:03.561
false,false,10536,9901,635,286,00:00:32.000,2025-04-15 12:58:29.586
false,false,10538,9903,635,352,00:00:33.000,2025-04-15 12:58:31.587
false,true,10539,9904,635,0,00:00:00.000,2025-04-15 12:58:34.590
false,false,10552,9916,636,408,00:00:32.000,2025-04-15 12:58:51.607
false,false,10554,9918,636,473,00:00:32.000,2025-04-15 12:58:53.609
false,true,10559,9922,637,0,00:00:00.000,2025-04-15 12:59:08.625
false,false,10561,9924,637,63,00:00:30.000,2025-04-15 12:59:12.629
false,false,10571,9934,637,380,00:00:31.000,2025-04-15 12:59:22.642
false,false,10579,9942,637,630,00:00:33.000,2025-04-15 12:59:30.650
false,false,10591,9953,638,1008,00:00:31.000,2025-04-15 12:59:42.662
false,false,10594,9954,640,1104,00:00:33.000,2025-04-15 12:59:45.664
false,false,10597,9957,640,1199,00:00:32.000,2025-04-15 12:59:48.668
false,false,10335,9712,623,63,00:00:33.000,2025-04-15 12:53:44.292
false,false,10359,9735,624,62,00:00:32.000,2025-04-15 12:54:14.321
false,false,10364,9740,624,219,00:00:30.000,2025-04-15 12:54:19.327
false,false,10606,9965,641,218,00:00:33.000,2025-04-15 13:00:03.681
false,true,10661,10018,643,0,00:00:00.000,2025-04-15 13:01:22.756
false,false,10804,10154,650,92,00:00:30.000,2025-04-15 13:04:33.945
false,true,10818,10168,650,0,00:00:00.000,2025-04-15 13:04:49.961
false,true,10897,10242,655,0,00:00:00.000,2025-04-15 13:06:45.076
false,true,10897,10242,655,0,00:00:00.000,2025-04-15 13:06:46.077
false,false,10907,10252,655,66,00:00:33.000,2025-04-15 13:07:05.096
false,true,10960,10303,657,0,00:00:00.000,2025-04-15 13:08:07.158
false,false,10970,10313,657,124,00:00:32.000,2025-04-15 13:08:26.180
false,false,10973,10316,657,221,00:00:33.000,2025-04-15 13:08:29.183
false,true,10977,10320,657,0,00:00:00.000,2025-04-15 13:08:51.202
false,false,10988,10331,657,344,00:00:33.000,2025-04-15 13:09:02.214
false,true,10991,10334,657,0,00:00:00.000,2025-04-15 13:09:07.217
false,true,10993,10336,657,0,00:00:00.000,2025-04-15 13:09:19.227
false,false,11014,10357,657,158,00:00:30.000,2025-04-15 13:09:46.255
false,false,10674,10031,643,98,00:00:32.000,2025-04-15 13:01:41.776
false,false,10697,10051,646,833,00:00:31.000,2025-04-15 13:02:04.795
false,false,10715,10069,646,529,00:00:32.000,2025-04-15 13:02:28.818
false,true,10736,10087,649,0,00:00:00.000,2025-04-15 13:02:51.847
false,false,10737,10088,649,33,00:00:33.000,2025-04-15 13:02:56.853
false,false,10740,10091,649,125,00:00:30.000,2025-04-15 13:02:59.855
false,true,10745,10096,649,0,00:00:00.000,2025-04-15 13:03:10.864
false,true,10818,10168,650,0,00:00:00.000,2025-04-15 13:04:52.963
false,false,10828,10178,650,312,00:00:31.000,2025-04-15 13:05:03.973
false,false,10830,10179,651,376,00:00:32.000,2025-04-15 13:05:05.974
false,false,10838,10187,651,161,00:00:33.000,2025-04-15 13:05:19.989
false,false,10840,10189,651,227,00:00:33.000,2025-04-15 13:05:21.992
false,false,10845,10194,651,64,00:00:31.000,2025-04-15 13:05:33.002
false,false,10847,10196,651,126,00:00:32.000,2025-04-15 13:05:35.004
false,false,10849,10198,651,186,00:00:30.000,2025-04-15 13:05:37.004
false,false,10855,10203,652,374,00:00:30.000,2025-04-15 13:05:43.010
false,true,10856,10204,652,0,00:00:00.000,2025-04-15 13:05:45.012
false,true,10856,10204,652,0,00:00:00.000,2025-04-15 13:05:46.013
false,false,10863,10211,652,227,00:00:31.000,2025-04-15 13:05:57.028
false,true,10864,10212,652,0,00:00:00.000,2025-04-15 13:06:03.034
false,false,10879,10225,654,472,00:00:32.000,2025-04-15 13:06:19.051
false,false,10171,9560,611,475,00:00:32.000,2025-04-15 12:50:18.081
false,false,10180,9569,611,757,00:00:30.000,2025-04-15 12:50:27.089
false,true,10196,9580,616,0,00:00:00.000,2025-04-15 12:50:44.108
false,true,10202,9586,616,0,00:00:00.000,2025-04-15 12:51:06.125
false,true,11022,10365,657,0,00:00:00.000,2025-04-15 13:09:59.265
false,false,11029,10370,659,218,00:00:31.000,2025-04-15 13:10:07.271
false,true,11035,10376,659,0,00:00:00.000,2025-04-15 13:10:18.281
false,true,11039,10380,659,0,00:00:00.000,2025-04-15 13:10:27.291
false,false,11050,10391,659,349,00:00:33.000,2025-04-15 13:10:40.302
false,true,11058,10399,659,0,00:00:00.000,2025-04-15 13:10:54.316
false,false,11065,10406,659,223,00:00:31.000,2025-04-15 13:11:01.323
false,false,11067,10408,659,287,00:00:33.000,2025-04-15 13:11:03.323
false,false,11071,10412,659,410,00:00:30.000,2025-04-15 13:11:07.326
false,false,11083,10424,659,345,00:00:32.000,2025-04-15 13:11:25.347
false,true,11176,10512,664,0,00:00:00.000,2025-04-15 13:13:31.474
false,false,11195,10531,664,598,00:00:32.000,2025-04-15 13:13:53.498
false,true,11203,10539,664,0,00:00:00.000,2025-04-15 13:14:11.517
false,false,11219,10553,666,497,00:00:33.000,2025-04-15 13:14:29.536
false,false,11231,10564,667,347,00:00:30.000,2025-04-15 13:14:47.553
false,false,11327,10653,674,974,00:00:32.000,2025-04-15 13:16:41.667
false,true,11338,10664,674,0,00:00:00.000,2025-04-15 13:17:08.699
false,true,11352,10678,674,0,00:00:00.000,2025-04-15 13:17:25.717
false,true,11353,10679,674,0,00:00:00.000,2025-04-15 13:17:35.724
false,true,11353,10679,674,0,00:00:00.000,2025-04-15 13:17:36.726
false,false,11366,10692,674,402,00:00:32.000,2025-04-15 13:17:50.746
false,false,11257,10590,667,1156,00:00:31.000,2025-04-15 13:15:13.580
false,false,11265,10598,667,1413,00:00:33.000,2025-04-15 13:15:21.589
false,true,11279,10611,668,0,00:00:00.000,2025-04-15 13:15:43.612
false,false,11290,10620,670,345,00:00:33.000,2025-04-15 13:15:58.626
false,false,11303,10630,673,221,00:00:30.000,2025-04-15 13:16:17.644
false,false,11102,10439,663,405,00:00:30.000,2025-04-15 13:11:50.369
false,true,11121,10458,663,0,00:00:00.000,2025-04-15 13:12:21.406
false,false,11138,10475,663,217,00:00:33.000,2025-04-15 13:12:44.426
false,false,11152,10488,664,662,00:00:32.000,2025-04-15 13:12:58.440
false,false,11156,10492,664,126,00:00:32.000,2025-04-15 13:13:08.451
false,true,11380,10706,674,0,00:00:00.000,2025-04-15 13:18:15.766
false,false,11384,10710,674,131,00:00:33.000,2025-04-15 13:18:20.772
false,true,11388,10713,675,0,00:00:00.000,2025-04-15 13:18:30.781
false,false,11401,10723,678,414,00:00:33.000,2025-04-15 13:18:43.791
false,false,11405,10725,680,65,00:00:33.000,2025-04-15 13:18:53.801
false,false,11407,10727,680,33,00:00:33.000,2025-04-15 13:19:01.806
false,false,11414,10733,681,125,00:00:32.000,2025-04-15 13:19:14.816
false,false,11416,10735,681,188,00:00:30.000,2025-04-15 13:19:16.818
false,false,11425,10744,681,475,00:00:32.000,2025-04-15 13:19:25.828
false,false,11449,10767,682,1236,00:00:32.000,2025-04-15 13:19:49.854
false,false,11529,10845,684,192,00:00:31.000,2025-04-15 13:21:33.978
false,true,11547,10862,685,0,00:00:00.000,2025-04-15 13:21:56.002
false,false,11581,10892,689,281,00:00:31.000,2025-04-15 13:22:50.053
false,false,11588,10899,689,500,00:00:30.000,2025-04-15 13:22:57.060
false,true,11588,10899,689,0,00:00:00.000,2025-04-15 13:23:02.066
false,false,11597,10908,689,280,00:00:31.000,2025-04-15 13:23:12.074
false,false,11474,10792,682,33,00:00:33.000,2025-04-15 13:20:20.896
false,false,11483,10800,683,315,00:00:30.000,2025-04-15 13:20:29.905
false,false,11510,10827,683,345,00:00:32.000,2025-04-15 13:21:02.943
false,false,11512,10829,683,31,00:00:31.000,2025-04-15 13:21:10.952
false,false,11527,10843,684,130,00:00:33.000,2025-04-15 13:21:31.976
false,true,11598,10909,689,0,00:00:00.000,2025-04-15 13:23:15.076
false,false,11603,10914,689,124,00:00:30.000,2025-04-15 13:23:30.093
false,false,11612,10922,690,32,00:00:32.000,2025-04-15 13:23:45.108
false,false,11616,10926,690,95,00:00:32.000,2025-04-15 13:23:55.119
false,false,11623,10933,690,316,00:00:31.000,2025-04-15 13:24:02.123
false,false,11624,10934,690,348,00:00:32.000,2025-04-15 13:24:03.125
false,false,11637,10945,692,757,00:00:32.000,2025-04-15 13:24:16.138
false,true,11742,11044,698,0,00:00:00.000,2025-04-15 13:26:56.306
false,false,11743,11045,698,33,00:00:33.000,2025-04-15 13:27:02.311
false,false,11759,11059,700,30,00:00:30.000,2025-04-15 13:27:24.332
false,false,11778,11077,701,632,00:00:30.000,2025-04-15 13:27:43.351
false,false,11795,11094,701,1167,00:00:32.000,2025-04-15 13:28:00.364
false,false,11799,11097,702,1293,00:00:30.000,2025-04-15 13:28:04.367
false,false,11845,11140,705,1067,00:00:30.000,2025-04-15 13:28:56.417
false,false,11847,11142,705,63,00:00:30.000,2025-04-15 13:29:04.424
false,true,11866,11161,705,0,00:00:00.000,2025-04-15 13:29:43.471
false,true,11867,11162,705,0,00:00:00.000,2025-04-15 13:29:49.475
false,false,11670,10976,694,944,00:00:30.000,2025-04-15 13:24:55.178
false,false,11674,10980,694,1073,00:00:33.000,2025-04-15 13:24:59.182
false,false,11692,10997,695,188,00:00:33.000,2025-04-15 13:25:29.209
false,false,11722,11025,697,311,00:00:31.000,2025-04-15 13:26:23.273
false,false,11930,11221,709,844,00:00:31.000,2025-04-15 13:31:39.596
false,true,11931,11222,709,0,00:00:00.000,2025-04-15 13:31:43.600
false,false,11932,11223,709,33,00:00:33.000,2025-04-15 13:31:47.605
false,false,11935,11226,709,92,00:00:32.000,2025-04-15 13:31:56.613
false,true,11937,11228,709,0,00:00:00.000,2025-04-15 13:32:08.624
false,false,11943,11233,710,193,00:00:33.000,2025-04-15 13:32:16.631
false,false,11945,11234,711,258,00:00:33.000,2025-04-15 13:32:18.634
false,false,11962,11249,713,799,00:00:31.000,2025-04-15 13:32:35.656
false,true,11973,11259,714,0,00:00:00.000,2025-04-15 13:32:54.682
false,false,11871,11166,705,130,00:00:33.000,2025-04-15 13:29:58.486
false,true,11874,11168,706,0,00:00:00.000,2025-04-15 13:30:02.489
false,true,11887,11180,707,0,00:00:00.000,2025-04-15 13:30:28.522
false,false,11904,11195,709,32,00:00:32.000,2025-04-15 13:31:13.569
false,false,11905,11196,709,63,00:00:31.000,2025-04-15 13:31:14.571
false,false,11918,11209,709,469,00:00:32.000,2025-04-15 13:31:27.584
false,false,2894,2724,170,94,00:00:30.000,2025-04-14 12:37:35.648
false,false,2954,2781,173,1491,00:00:33.000,2025-04-14 12:39:59.766
false,true,2962,2789,173,0,00:00:00.000,2025-04-14 12:40:37.793
false,false,2976,2802,174,129,00:00:33.000,2025-04-14 12:41:31.842
false,false,3021,2843,178,32,00:00:32.000,2025-04-14 12:44:01.965
false,false,3029,2851,178,66,00:00:33.000,2025-04-14 12:44:29.984
false,false,3038,2859,179,350,00:00:31.000,2025-04-14 12:44:47.997
false,false,9785,9199,586,922,00:00:33.000,2025-04-15 12:41:33.533
false,false,9810,9222,588,570,00:00:33.000,2025-04-15 12:42:04.565
false,false,9816,9228,588,761,00:00:30.000,2025-04-15 12:42:10.570
false,false,9828,9239,589,1137,00:00:33.000,2025-04-15 12:42:22.585
false,false,9839,9248,591,1485,00:00:32.000,2025-04-15 12:42:33.597
false,true,9852,9260,592,0,00:00:00.000,2025-04-15 12:43:03.626
false,false,9854,9262,592,60,00:00:30.000,2025-04-15 12:43:06.632
false,true,9960,9363,597,0,00:00:00.000,2025-04-15 12:45:33.782
false,true,9961,9364,597,0,00:00:00.000,2025-04-15 12:45:37.786
false,true,9961,9364,597,0,00:00:00.000,2025-04-15 12:45:38.787
false,false,9976,9377,599,124,00:00:31.000,2025-04-15 12:46:08.824
false,false,9979,9380,599,215,00:00:31.000,2025-04-15 12:46:11.825
false,false,9984,9385,599,371,00:00:33.000,2025-04-15 12:46:16.831
false,false,9994,9394,600,685,00:00:30.000,2025-04-15 12:46:26.840
false,false,9998,9398,600,813,00:00:30.000,2025-04-15 12:46:30.843
false,false,10065,9461,604,286,00:00:31.000,2025-04-15 12:48:13.945
false,false,10076,9472,604,346,00:00:30.000,2025-04-15 12:48:30.960
false,false,10102,9495,607,1165,00:00:30.000,2025-04-15 12:48:56.993
false,false,9861,9269,592,279,00:00:30.000,2025-04-15 12:43:13.635
false,true,9864,9272,592,0,00:00:00.000,2025-04-15 12:43:19.641
false,false,9887,9293,594,726,00:00:33.000,2025-04-15 12:43:45.672
false,false,9896,9301,595,1011,00:00:33.000,2025-04-15 12:43:54.681
false,false,9903,9307,596,1236,00:00:32.000,2025-04-15 12:44:01.692
false,false,9911,9315,596,1486,00:00:30.000,2025-04-15 12:44:09.696
false,false,9926,9330,596,442,00:00:30.000,2025-04-15 12:44:30.716
false,true,9717,9134,583,0,00:00:00.000,2025-04-15 12:39:59.451
false,false,9747,9164,583,588,00:00:32.000,2025-04-15 12:40:37.482
false,true,9756,9172,584,0,00:00:00.000,2025-04-15 12:41:04.507
false,false,9767,9182,585,348,00:00:31.000,2025-04-15 12:41:15.516
false,false,9777,9191,586,668,00:00:32.000,2025-04-15 12:41:25.527
false,false,9780,9194,586,761,00:00:30.000,2025-04-15 12:41:28.529
false,false,10009,9408,601,1158,00:00:30.000,2025-04-15 12:46:41.852
false,true,10012,9410,602,0,00:00:00.000,2025-04-15 12:46:50.860
false,false,10017,9415,602,127,00:00:32.000,2025-04-15 12:47:01.869
false,false,10018,9416,602,158,00:00:31.000,2025-04-15 12:47:02.870
false,false,10028,9425,603,32,00:00:32.000,2025-04-15 12:47:24.895
false,true,10056,9453,603,0,00:00:00.000,2025-04-15 12:48:02.933
false,true,10056,9453,603,0,00:00:00.000,2025-04-15 12:48:04.937
false,false,10240,9622,618,531,00:00:32.000,2025-04-15 12:51:57.180
false,false,10241,9623,618,562,00:00:31.000,2025-04-15 12:51:58.180
false,false,10243,9625,618,625,00:00:30.000,2025-04-15 12:52:00.184
false,false,10263,9645,618,1258,00:00:30.000,2025-04-15 12:52:20.206
false,false,10270,9652,618,1484,00:00:33.000,2025-04-15 12:52:27.214
false,false,10280,9661,619,1799,00:00:33.000,2025-04-15 12:52:37.228
false,true,10283,9664,619,0,00:00:00.000,2025-04-15 12:52:46.237
false,false,10387,9762,625,192,00:00:32.000,2025-04-15 12:55:00.374
false,false,10390,9765,625,287,00:00:31.000,2025-04-15 12:55:03.377
false,false,10394,9767,627,414,00:00:30.000,2025-04-15 12:55:07.380
false,false,10404,9777,627,728,00:00:32.000,2025-04-15 12:55:17.391
false,true,10412,9785,627,0,00:00:00.000,2025-04-15 12:55:26.398
false,true,10412,9785,627,0,00:00:00.000,2025-04-15 12:55:27.400
false,false,10413,9786,627,31,00:00:31.000,2025-04-15 12:55:32.404
false,true,10419,9792,627,0,00:00:00.000,2025-04-15 12:55:39.409
false,true,10419,9792,627,0,00:00:00.000,2025-04-15 12:55:43.414
false,false,10420,9793,627,32,00:00:32.000,2025-04-15 12:55:45.416
false,true,10423,9796,627,0,00:00:00.000,2025-04-15 12:55:50.419
false,false,10428,9801,627,128,00:00:33.000,2025-04-15 12:56:11.440
false,false,10438,9809,629,153,00:00:30.000,2025-04-15 12:56:27.457
false,false,10451,9821,630,30,00:00:30.000,2025-04-15 12:56:46.477
false,false,10465,9834,631,472,00:00:32.000,2025-04-15 12:57:00.491
false,false,10468,9837,631,569,00:00:33.000,2025-04-15 12:57:03.494
false,false,10478,9846,632,890,00:00:32.000,2025-04-15 12:57:13.504
false,false,10496,9863,633,1447,00:00:30.000,2025-04-15 12:57:31.524
false,true,10515,9881,634,0,00:00:00.000,2025-04-15 12:57:59.556
false,false,10532,9897,635,161,00:00:33.000,2025-04-15 12:58:25.584
false,false,10539,9904,635,383,00:00:31.000,2025-04-15 12:58:32.588
false,false,10547,9911,636,251,00:00:30.000,2025-04-15 12:58:46.600
false,false,10555,9919,636,503,00:00:30.000,2025-04-15 12:58:54.610
false,true,10555,9919,636,0,00:00:00.000,2025-04-15 12:58:56.612
false,true,10559,9922,637,0,00:00:00.000,2025-04-15 12:59:09.627
false,false,10563,9926,637,123,00:00:30.000,2025-04-15 12:59:14.632
false,false,10566,9929,637,219,00:00:32.000,2025-04-15 12:59:17.637
false,false,10569,9932,637,317,00:00:33.000,2025-04-15 12:59:20.640
false,false,10575,9938,637,503,00:00:33.000,2025-04-15 12:59:26.646
false,false,10327,9705,622,1366,00:00:30.000,2025-04-15 12:53:30.280
false,false,10332,9710,622,1523,00:00:30.000,2025-04-15 12:53:35.284
false,false,10333,9710,623,1556,00:00:33.000,2025-04-15 12:53:36.286
false,true,10333,9710,623,0,00:00:00.000,2025-04-15 12:53:41.291
false,false,10345,9722,623,377,00:00:31.000,2025-04-15 12:53:54.304
false,true,10366,9742,624,0,00:00:00.000,2025-04-15 12:54:23.331
false,true,10366,9742,624,0,00:00:00.000,2025-04-15 12:54:24.334
false,true,10366,9742,624,0,00:00:00.000,2025-04-15 12:54:25.334
false,false,10380,9755,625,409,00:00:30.000,2025-04-15 12:54:47.359
false,false,10600,9960,640,32,00:00:32.000,2025-04-15 12:59:57.677
false,false,10602,9962,640,93,00:00:30.000,2025-04-15 12:59:59.679
false,false,10614,9973,641,470,00:00:33.000,2025-04-15 13:00:11.690
false,false,10623,9981,642,752,00:00:31.000,2025-04-15 13:00:20.698
false,false,10629,9987,642,942,00:00:31.000,2025-04-15 13:00:26.703
false,false,10634,9992,642,1101,00:00:31.000,2025-04-15 13:00:31.708
false,true,10637,9995,642,0,00:00:00.000,2025-04-15 13:00:36.715
false,false,10659,10016,643,188,00:00:32.000,2025-04-15 13:01:14.752
false,false,10660,10017,643,221,00:00:33.000,2025-04-15 13:01:15.752
false,false,10752,10103,649,220,00:00:31.000,2025-04-15 13:03:17.868
false,false,10754,10105,649,282,00:00:30.000,2025-04-15 13:03:19.870
false,true,10760,10111,649,0,00:00:00.000,2025-04-15 13:03:29.876
false,false,10777,10128,649,537,00:00:32.000,2025-04-15 13:03:48.896
false,false,10785,10136,649,219,00:00:31.000,2025-04-15 13:04:08.917
false,false,10801,10151,650,725,00:00:32.000,2025-04-15 13:04:24.937
false,true,10801,10151,650,0,00:00:00.000,2025-04-15 13:04:26.939
false,false,10810,10160,650,280,00:00:33.000,2025-04-15 13:04:39.950
false,false,10894,10239,655,410,00:00:32.000,2025-04-15 13:06:40.068
false,false,10903,10248,655,190,00:00:32.000,2025-04-15 13:06:55.088
false,false,10919,10263,656,440,00:00:30.000,2025-04-15 13:07:17.109
false,false,10958,10301,657,1061,00:00:31.000,2025-04-15 13:08:02.153
false,false,10962,10305,657,62,00:00:31.000,2025-04-15 13:08:12.165
false,false,10969,10312,657,92,00:00:30.000,2025-04-15 13:08:25.178
false,false,10971,10314,657,157,00:00:33.000,2025-04-15 13:08:27.181
false,false,10974,10317,657,251,00:00:30.000,2025-04-15 13:08:30.184
false,false,10975,10318,657,30,00:00:30.000,2025-04-15 13:08:37.192
false,false,10984,10327,657,218,00:00:32.000,2025-04-15 13:08:58.208
false,false,10997,10340,657,128,00:00:30.000,2025-04-15 13:09:23.232
false,true,10671,10028,643,0,00:00:00.000,2025-04-15 13:01:35.771
false,true,10671,10028,643,0,00:00:00.000,2025-04-15 13:01:36.772
false,true,10745,10096,649,0,00:00:00.000,2025-04-15 13:03:08.862
false,false,10824,10174,650,187,00:00:30.000,2025-04-15 13:04:59.969
false,false,10825,10175,650,218,00:00:31.000,2025-04-15 13:05:00.970
false,false,10839,10188,651,194,00:00:33.000,2025-04-15 13:05:20.990
false,false,10844,10193,651,33,00:00:33.000,2025-04-15 13:05:32.001
false,false,10882,10227,655,32,00:00:32.000,2025-04-15 13:06:28.059
false,false,10153,9545,608,790,00:00:30.000,2025-04-15 12:49:54.056
false,false,10163,9552,611,218,00:00:30.000,2025-04-15 12:50:10.073
false,false,11026,10368,658,124,00:00:31.000,2025-04-15 13:10:04.268
false,true,11039,10380,659,0,00:00:00.000,2025-04-15 13:10:29.291
false,false,11082,10423,659,313,00:00:31.000,2025-04-15 13:11:24.347
false,false,11185,10521,664,282,00:00:30.000,2025-04-15 13:13:43.488
false,true,11196,10532,664,0,00:00:00.000,2025-04-15 13:13:56.502
false,true,11196,10532,664,0,00:00:00.000,2025-04-15 13:13:59.503
false,false,11213,10548,665,309,00:00:33.000,2025-04-15 13:14:23.530
false,false,11218,10552,666,464,00:00:30.000,2025-04-15 13:14:28.536
false,true,11220,10553,667,0,00:00:00.000,2025-04-15 13:14:34.541
false,false,11230,10563,667,317,00:00:31.000,2025-04-15 13:14:46.550
false,false,11322,10648,674,817,00:00:30.000,2025-04-15 13:16:36.661
false,false,11326,10652,674,942,00:00:31.000,2025-04-15 13:16:40.665
false,true,11329,10655,674,0,00:00:00.000,2025-04-15 13:16:44.670
false,true,11336,10662,674,0,00:00:00.000,2025-04-15 13:17:02.693
false,true,11338,10664,674,0,00:00:00.000,2025-04-15 13:17:10.700
false,false,11350,10676,674,369,00:00:32.000,2025-04-15 13:17:22.713
false,false,11352,10678,674,429,00:00:30.000,2025-04-15 13:17:24.716
false,false,11252,10585,667,1005,00:00:32.000,2025-04-15 13:15:08.576
false,true,11277,10610,667,0,00:00:00.000,2025-04-15 13:15:37.604
false,false,11110,10447,663,656,00:00:30.000,2025-04-15 13:11:58.380
false,false,11124,10461,663,98,00:00:33.000,2025-04-15 13:12:24.409
false,false,11126,10463,663,158,00:00:30.000,2025-04-15 13:12:26.412
false,false,11145,10481,664,439,00:00:31.000,2025-04-15 13:12:51.433
false,false,11158,10494,664,188,00:00:32.000,2025-04-15 13:13:10.455
false,false,11382,10708,674,65,00:00:33.000,2025-04-15 13:18:18.770
false,false,11385,10711,674,162,00:00:31.000,2025-04-15 13:18:21.773
false,false,11387,10712,675,226,00:00:31.000,2025-04-15 13:18:23.776
false,false,11389,10714,675,33,00:00:33.000,2025-04-15 13:18:31.781
false,false,11408,10727,681,63,00:00:30.000,2025-04-15 13:19:02.807
false,false,11412,10731,681,61,00:00:31.000,2025-04-15 13:19:12.815
false,false,11422,10741,681,378,00:00:31.000,2025-04-15 13:19:22.824
false,false,11432,10751,681,699,00:00:33.000,2025-04-15 13:19:32.834
false,false,11433,10752,681,729,00:00:30.000,2025-04-15 13:19:33.835
false,false,11445,10764,681,1105,00:00:33.000,2025-04-15 13:19:45.849
false,false,11532,10848,684,287,00:00:32.000,2025-04-15 13:21:36.981
false,false,11534,10850,684,347,00:00:30.000,2025-04-15 13:21:38.985
false,true,11549,10863,686,0,00:00:00.000,2025-04-15 13:22:03.008
false,false,11550,10863,687,30,00:00:30.000,2025-04-15 13:22:07.012
false,false,11564,10876,688,380,00:00:32.000,2025-04-15 13:22:27.032
false,false,11576,10887,689,125,00:00:31.000,2025-04-15 13:22:45.048
false,false,11583,10894,689,346,00:00:33.000,2025-04-15 13:22:52.054
false,false,11453,10771,682,1361,00:00:32.000,2025-04-15 13:19:53.861
false,false,11455,10773,682,1426,00:00:32.000,2025-04-15 13:19:55.862
false,false,11481,10798,683,252,00:00:30.000,2025-04-15 13:20:27.903
false,true,11511,10828,683,0,00:00:00.000,2025-04-15 13:21:07.949
false,false,11522,10839,683,346,00:00:33.000,2025-04-15 13:21:20.961
false,true,11523,10840,683,0,00:00:00.000,2025-04-15 13:21:26.970
false,false,11528,10844,684,161,00:00:31.000,2025-04-15 13:21:32.978
false,false,11600,10911,689,31,00:00:31.000,2025-04-15 13:23:27.090
false,true,11611,10921,690,0,00:00:00.000,2025-04-15 13:23:41.106
false,true,11611,10921,690,0,00:00:00.000,2025-04-15 13:23:44.107
false,true,11613,10923,690,0,00:00:00.000,2025-04-15 13:23:52.116
false,false,11627,10937,690,442,00:00:32.000,2025-04-15 13:24:06.130
false,false,11635,10944,691,693,00:00:32.000,2025-04-15 13:24:14.137
false,false,11642,10949,693,62,00:00:31.000,2025-04-15 13:24:27.148
false,false,11658,10964,694,573,00:00:33.000,2025-04-15 13:24:43.165
false,false,11740,11042,698,285,00:00:32.000,2025-04-15 13:26:53.302
false,true,11742,11044,698,0,00:00:00.000,2025-04-15 13:27:00.308
false,false,11758,11058,700,506,00:00:32.000,2025-04-15 13:27:17.323
false,true,11758,11058,700,0,00:00:00.000,2025-04-15 13:27:19.325
false,true,11758,11058,700,0,00:00:00.000,2025-04-15 13:27:21.328
false,false,11763,11062,701,157,00:00:31.000,2025-04-15 13:27:28.337
false,false,11779,11078,701,663,00:00:31.000,2025-04-15 13:27:44.351
false,false,11809,11106,703,1612,00:00:33.000,2025-04-15 13:28:14.373
false,false,11822,11119,703,342,00:00:30.000,2025-04-15 13:28:33.398
false,true,11854,11149,705,0,00:00:00.000,2025-04-15 13:29:17.438
false,true,11858,11153,705,0,00:00:00.000,2025-04-15 13:29:28.451
false,true,11686,10991,695,0,00:00:00.000,2025-04-15 13:25:21.204
false,false,11697,11000,697,32,00:00:32.000,2025-04-15 13:25:40.222
false,true,11702,11005,697,0,00:00:00.000,2025-04-15 13:25:49.234
false,false,11713,11016,697,31,00:00:31.000,2025-04-15 13:26:14.263
false,true,11726,11029,697,0,00:00:00.000,2025-04-15 13:26:32.279
false,true,11937,11228,709,0,00:00:00.000,2025-04-15 13:32:02.620
false,false,11951,11239,712,448,00:00:33.000,2025-04-15 13:32:24.641
false,false,11968,11255,713,986,00:00:30.000,2025-04-15 13:32:41.663
false,false,11979,11265,714,188,00:00:31.000,2025-04-15 13:33:04.692
false,false,11980,11266,714,219,00:00:31.000,2025-04-15 13:33:05.692
false,true,11887,11180,707,0,00:00:00.000,2025-04-15 13:30:31.526
false,false,11891,11184,707,126,00:00:32.000,2025-04-15 13:30:42.538
false,true,11893,11184,709,0,00:00:00.000,2025-04-15 13:30:47.542
false,false,11901,11192,709,218,00:00:33.000,2025-04-15 13:31:04.561
false,false,11908,11199,709,153,00:00:30.000,2025-04-15 13:31:17.575
false,false,2884,2714,170,247,00:00:32.000,2025-04-14 12:37:03.624
false,false,2888,2718,170,371,00:00:31.000,2025-04-14 12:37:11.629
false,true,2891,2721,170,0,00:00:00.000,2025-04-14 12:37:29.643
false,false,2898,2728,170,219,00:00:32.000,2025-04-14 12:37:43.656
false,false,2899,2729,170,252,00:00:33.000,2025-04-14 12:37:45.658
false,false,2910,2740,170,94,00:00:30.000,2025-04-14 12:38:31.705
false,false,2946,2775,171,1235,00:00:33.000,2025-04-14 12:39:43.757
false,false,2947,2776,171,1268,00:00:33.000,2025-04-14 12:39:45.758
false,false,2956,2783,173,1553,00:00:32.000,2025-04-14 12:40:03.768
false,true,2957,2784,173,0,00:00:00.000,2025-04-14 12:40:17.780
false,false,2958,2785,173,30,00:00:30.000,2025-04-14 12:40:19.781
false,false,2962,2789,173,158,00:00:32.000,2025-04-14 12:40:27.787
false,true,2962,2789,173,0,00:00:00.000,2025-04-14 12:40:41.799
false,false,2965,2791,174,93,00:00:32.000,2025-04-14 12:40:57.811
false,true,2972,2798,174,0,00:00:00.000,2025-04-14 12:41:21.834
false,false,2977,2803,174,160,00:00:31.000,2025-04-14 12:41:33.844
false,true,2987,2812,175,0,00:00:00.000,2025-04-14 12:41:59.866
false,true,2987,2812,175,0,00:00:00.000,2025-04-14 12:42:05.873
false,true,2990,2814,176,0,00:00:00.000,2025-04-14 12:42:21.886
false,false,2991,2815,176,32,00:00:32.000,2025-04-14 12:42:25.891
false,false,3001,2825,176,249,00:00:30.000,2025-04-14 12:42:57.918
false,false,3004,2828,176,343,00:00:32.000,2025-04-14 12:43:03.921
false,false,3007,2831,176,438,00:00:33.000,2025-04-14 12:43:09.925
false,false,3017,2840,177,754,00:00:32.000,2025-04-14 12:43:29.942
false,false,3036,2857,179,288,00:00:33.000,2025-04-14 12:44:43.995
false,false,9783,9197,586,857,00:00:33.000,2025-04-15 12:41:31.531
false,false,9797,9210,587,158,00:00:33.000,2025-04-15 12:41:51.553
false,false,9805,9218,587,412,00:00:33.000,2025-04-15 12:41:59.562
false,false,9817,9229,588,793,00:00:32.000,2025-04-15 12:42:11.573
false,false,9837,9246,591,1420,00:00:30.000,2025-04-15 12:42:31.594
false,false,9840,9249,591,1518,00:00:33.000,2025-04-15 12:42:34.598
false,true,9849,9257,592,0,00:00:00.000,2025-04-15 12:42:48.612
false,false,9856,9264,592,124,00:00:32.000,2025-04-15 12:43:08.632
false,false,9940,9344,596,94,00:00:31.000,2025-04-15 12:44:56.737
false,false,9952,9356,596,380,00:00:31.000,2025-04-15 12:45:14.759
false,false,9955,9359,596,32,00:00:32.000,2025-04-15 12:45:23.771
false,false,9960,9363,597,190,00:00:33.000,2025-04-15 12:45:28.777
false,true,9960,9363,597,0,00:00:00.000,2025-04-15 12:45:32.781
false,true,9961,9364,597,0,00:00:00.000,2025-04-15 12:45:36.784
false,true,9971,9373,598,0,00:00:00.000,2025-04-15 12:45:53.806
false,true,9971,9373,598,0,00:00:00.000,2025-04-15 12:45:56.810
false,true,9972,9374,598,0,00:00:00.000,2025-04-15 12:46:03.818
false,false,9987,9387,600,465,00:00:31.000,2025-04-15 12:46:19.834
false,false,10104,9497,607,1229,00:00:33.000,2025-04-15 12:48:58.995
false,false,10121,9513,608,1765,00:00:32.000,2025-04-15 12:49:16.013
false,true,10128,9520,608,0,00:00:00.000,2025-04-15 12:49:25.024
false,true,10128,9520,608,0,00:00:00.000,2025-04-15 12:49:27.027
false,false,10129,9521,608,30,00:00:30.000,2025-04-15 12:49:30.028
false,false,10143,9535,608,475,00:00:30.000,2025-04-15 12:49:44.045
false,false,9870,9277,593,189,00:00:30.000,2025-04-15 12:43:28.653
false,true,9912,9316,596,0,00:00:00.000,2025-04-15 12:44:14.700
false,false,9716,9133,583,467,00:00:33.000,2025-04-15 12:39:54.446
false,false,9729,9146,583,30,00:00:30.000,2025-04-15 12:40:19.470
false,false,9741,9158,583,403,00:00:30.000,2025-04-15 12:40:31.478
false,false,9749,9166,583,30,00:00:30.000,2025-04-15 12:40:45.490
false,false,10004,9403,601,1002,00:00:33.000,2025-04-15 12:46:36.848
false,false,10006,9405,601,1064,00:00:30.000,2025-04-15 12:46:38.851
false,false,10011,9409,602,1220,00:00:30.000,2025-04-15 12:46:43.853
false,true,10047,9444,603,0,00:00:00.000,2025-04-15 12:47:46.918
false,false,10049,9446,603,61,00:00:30.000,2025-04-15 12:47:51.923
false,false,10057,9454,603,31,00:00:31.000,2025-04-15 12:48:05.937
false,false,10410,9783,627,919,00:00:33.000,2025-04-15 12:55:23.397
false,true,10423,9796,627,0,00:00:00.000,2025-04-15 12:55:49.419
false,true,10423,9796,627,0,00:00:00.000,2025-04-15 12:55:53.421
false,true,10424,9797,627,0,00:00:00.000,2025-04-15 12:56:06.435
false,true,10424,9797,627,0,00:00:00.000,2025-04-15 12:56:07.436
false,false,10426,9799,627,64,00:00:33.000,2025-04-15 12:56:09.437
false,true,10433,9805,628,0,00:00:00.000,2025-04-15 12:56:18.448
false,true,10450,9820,630,0,00:00:00.000,2025-04-15 12:56:41.472
false,false,10463,9832,631,407,00:00:31.000,2025-04-15 12:56:58.489
false,false,10501,9868,633,1604,00:00:30.000,2025-04-15 12:57:36.527
false,false,10507,9874,633,1789,00:00:32.000,2025-04-15 12:57:42.535
false,false,10510,9877,633,93,00:00:30.000,2025-04-15 12:57:51.546
false,false,10540,9904,636,32,00:00:32.000,2025-04-15 12:58:39.594
false,false,10544,9908,636,158,00:00:32.000,2025-04-15 12:58:43.599
false,true,10555,9919,636,0,00:00:00.000,2025-04-15 12:58:58.613
false,false,10560,9923,637,33,00:00:33.000,2025-04-15 12:59:11.629
false,false,10590,9952,638,977,00:00:32.000,2025-04-15 12:59:41.661
false,true,10333,9710,623,0,00:00:00.000,2025-04-15 12:53:38.288
false,true,10366,9742,624,0,00:00:00.000,2025-04-15 12:54:22.330
false,true,10366,9742,624,0,00:00:00.000,2025-04-15 12:54:26.335
false,false,10371,9746,625,125,00:00:33.000,2025-04-15 12:54:38.348
false,false,10619,9977,642,626,00:00:31.000,2025-04-15 13:00:16.694
false,false,10632,9990,642,1038,00:00:33.000,2025-04-15 13:00:29.706
false,false,10633,9991,642,1070,00:00:32.000,2025-04-15 13:00:30.707
false,false,10650,10007,643,412,00:00:32.000,2025-04-15 13:00:53.732
false,true,10653,10010,643,0,00:00:00.000,2025-04-15 13:00:59.735
false,true,10653,10010,643,0,00:00:00.000,2025-04-15 13:01:08.748
false,true,10661,10018,643,0,00:00:00.000,2025-04-15 13:01:19.755
false,false,10662,10019,643,32,00:00:32.000,2025-04-15 13:01:23.756
false,false,10666,10023,643,156,00:00:31.000,2025-04-15 13:01:27.762
false,false,10758,10109,649,412,00:00:33.000,2025-04-15 13:03:23.872
false,false,10762,10113,649,63,00:00:31.000,2025-04-15 13:03:33.881
false,false,10769,10120,649,286,00:00:33.000,2025-04-15 13:03:40.891
false,true,10778,10129,649,0,00:00:00.000,2025-04-15 13:03:56.902
false,false,10779,10130,649,32,00:00:32.000,2025-04-15 13:04:02.909
false,false,10794,10144,650,503,00:00:32.000,2025-04-15 13:04:17.927
false,false,10811,10161,650,313,00:00:33.000,2025-04-15 13:04:40.951
false,false,10817,10167,650,503,00:00:31.000,2025-04-15 13:04:46.957
false,false,10904,10249,655,223,00:00:33.000,2025-04-15 13:06:56.089
false,true,10905,10250,655,0,00:00:00.000,2025-04-15 13:07:03.095
false,false,10912,10257,655,224,00:00:30.000,2025-04-15 13:07:10.102
false,false,10922,10266,656,536,00:00:30.000,2025-04-15 13:07:20.114
false,true,10924,10268,656,0,00:00:00.000,2025-04-15 13:07:26.118
false,false,10932,10276,656,249,00:00:30.000,2025-04-15 13:07:36.128
false,false,10939,10282,657,467,00:00:30.000,2025-04-15 13:07:43.136
false,false,10987,10330,657,311,00:00:31.000,2025-04-15 13:09:01.213
false,false,11000,10343,657,220,00:00:31.000,2025-04-15 13:09:26.234
false,false,11020,10363,657,348,00:00:32.000,2025-04-15 13:09:52.260
false,true,10698,10052,646,0,00:00:00.000,2025-04-15 13:02:08.799
false,false,10705,10059,646,217,00:00:33.000,2025-04-15 13:02:18.810
false,false,10712,10066,646,434,00:00:32.000,2025-04-15 13:02:25.817
false,false,10729,10080,649,969,00:00:33.000,2025-04-15 13:02:42.836
false,true,10736,10087,649,0,00:00:00.000,2025-04-15 13:02:55.851
false,false,10744,10095,649,252,00:00:30.000,2025-04-15 13:03:03.861
false,true,10745,10096,649,0,00:00:00.000,2025-04-15 13:03:05.861
false,false,10842,10191,651,291,00:00:33.000,2025-04-15 13:05:23.995
false,true,10843,10192,651,0,00:00:00.000,2025-04-15 13:05:29.999
false,false,10848,10197,651,156,00:00:30.000,2025-04-15 13:05:36.004
false,true,10856,10204,652,0,00:00:00.000,2025-04-15 13:05:48.017
false,false,10156,9547,609,886,00:00:32.000,2025-04-15 12:49:57.059
false,false,10181,9570,611,787,00:00:30.000,2025-04-15 12:50:28.091
false,true,10196,9580,616,0,00:00:00.000,2025-04-15 12:50:47.112
false,true,10200,9584,616,0,00:00:00.000,2025-04-15 12:50:54.116
false,true,10200,9584,616,0,00:00:00.000,2025-04-15 12:50:55.118
false,true,10212,9596,616,0,00:00:00.000,2025-04-15 12:51:23.145
false,false,11022,10365,657,411,00:00:32.000,2025-04-15 13:09:54.262
false,false,11024,10366,658,63,00:00:33.000,2025-04-15 13:10:02.267
false,false,11051,10392,659,380,00:00:31.000,2025-04-15 13:10:41.303
false,true,11072,10413,659,0,00:00:00.000,2025-04-15 13:11:11.331
false,false,11073,10414,659,31,00:00:31.000,2025-04-15 13:11:15.335
false,false,11173,10509,664,663,00:00:33.000,2025-04-15 13:13:25.467
false,false,11178,10514,664,62,00:00:32.000,2025-04-15 13:13:36.481
false,false,11210,10546,664,214,00:00:30.000,2025-04-15 13:14:20.526
false,false,11226,10559,667,193,00:00:33.000,2025-04-15 13:14:42.549
false,false,11229,10562,667,286,00:00:30.000,2025-04-15 13:14:45.550
false,false,11328,10654,674,1007,00:00:33.000,2025-04-15 13:16:42.668
false,true,11329,10655,674,0,00:00:00.000,2025-04-15 13:16:47.673
false,false,11332,10658,674,95,00:00:33.000,2025-04-15 13:16:52.682
false,false,11336,10662,674,222,00:00:30.000,2025-04-15 13:16:56.687
false,false,11340,10666,674,61,00:00:31.000,2025-04-15 13:17:12.701
false,false,11349,10675,674,337,00:00:30.000,2025-04-15 13:17:21.711
false,true,11353,10679,674,0,00:00:00.000,2025-04-15 13:17:32.721
false,false,11360,10686,674,214,00:00:30.000,2025-04-15 13:17:44.737
false,false,11361,10687,674,246,00:00:32.000,2025-04-15 13:17:45.738
false,true,11369,10695,674,0,00:00:00.000,2025-04-15 13:17:59.754
false,false,11255,10588,667,1095,00:00:30.000,2025-04-15 13:15:11.578
false,true,11089,10429,660,0,00:00:00.000,2025-04-15 13:11:36.354
false,false,11090,10429,661,30,00:00:30.000,2025-04-15 13:11:38.356
false,false,11095,10432,663,192,00:00:33.000,2025-04-15 13:11:43.361
false,false,11113,10450,663,751,00:00:31.000,2025-04-15 13:12:01.381
false,false,11121,10458,663,33,00:00:33.000,2025-04-15 13:12:15.398
false,true,11131,10468,663,0,00:00:00.000,2025-04-15 13:12:34.417
false,false,11132,10469,663,31,00:00:31.000,2025-04-15 13:12:38.420
false,false,11142,10478,664,342,00:00:32.000,2025-04-15 13:12:48.430
false,true,11152,10488,664,0,00:00:00.000,2025-04-15 13:13:00.441
false,true,11388,10713,675,0,00:00:00.000,2025-04-15 13:18:27.778
false,false,11403,10723,680,479,00:00:33.000,2025-04-15 13:18:45.794
false,false,11411,10730,681,30,00:00:30.000,2025-04-15 13:19:11.813
false,false,11423,10742,681,410,00:00:32.000,2025-04-15 13:19:23.825
false,false,11431,10750,681,666,00:00:33.000,2025-04-15 13:19:31.833
false,false,11436,10755,681,821,00:00:30.000,2025-04-15 13:19:36.839
false,false,11441,10760,681,976,00:00:32.000,2025-04-15 13:19:41.845
false,false,11447,10766,681,1171,00:00:33.000,2025-04-15 13:19:47.852
false,false,11530,10846,684,222,00:00:30.000,2025-04-15 13:21:34.979
false,false,11560,10872,688,252,00:00:33.000,2025-04-15 13:22:23.028
false,false,11575,10886,689,94,00:00:32.000,2025-04-15 13:22:44.047
false,false,11578,10889,689,187,00:00:31.000,2025-04-15 13:22:47.050
false,true,11588,10899,689,0,00:00:00.000,2025-04-15 13:22:59.063
false,false,11592,10903,689,125,00:00:32.000,2025-04-15 13:23:07.069
false,false,11468,10786,682,1836,00:00:33.000,2025-04-15 13:20:08.879
false,false,11469,10787,682,1868,00:00:32.000,2025-04-15 13:20:09.880
false,false,11492,10809,683,594,00:00:31.000,2025-04-15 13:20:38.912
false,true,11499,10816,683,0,00:00:00.000,2025-04-15 13:20:51.928
false,false,11507,10824,683,250,00:00:33.000,2025-04-15 13:20:59.940
false,true,11599,10910,689,0,00:00:00.000,2025-04-15 13:23:21.084
false,true,11599,10910,689,0,00:00:00.000,2025-04-15 13:23:22.084
false,false,11608,10919,689,282,00:00:33.000,2025-04-15 13:23:35.099
false,false,11620,10930,690,225,00:00:33.000,2025-04-15 13:23:59.123
false,true,11640,10947,693,0,00:00:00.000,2025-04-15 13:24:22.141
false,false,11657,10963,694,540,00:00:31.000,2025-04-15 13:24:42.162
false,false,11662,10968,694,698,00:00:30.000,2025-04-15 13:24:47.169
false,false,11751,11052,699,285,00:00:31.000,2025-04-15 13:27:10.317
false,false,11760,11060,700,63,00:00:33.000,2025-04-15 13:27:25.333
false,false,11771,11070,701,411,00:00:33.000,2025-04-15 13:27:36.343
false,false,11811,11108,703,1676,00:00:33.000,2025-04-15 13:28:16.374
false,true,11811,11108,703,0,00:00:00.000,2025-04-15 13:28:17.375
false,false,11816,11113,703,157,00:00:33.000,2025-04-15 13:28:27.391
false,false,11817,11114,703,187,00:00:30.000,2025-04-15 13:28:28.392
false,false,11832,11128,704,657,00:00:33.000,2025-04-15 13:28:43.407
false,true,11845,11140,705,0,00:00:00.000,2025-04-15 13:29:00.419
false,false,11851,11146,705,193,00:00:33.000,2025-04-15 13:29:08.429
false,true,11854,11149,705,0,00:00:00.000,2025-04-15 13:29:12.434
false,false,11857,11152,705,95,00:00:31.000,2025-04-15 13:29:20.441
false,false,11690,10995,695,125,00:00:31.000,2025-04-15 13:25:27.208
false,false,11696,10999,697,316,00:00:33.000,2025-04-15 13:25:33.213
false,true,11702,11005,697,0,00:00:00.000,2025-04-15 13:25:50.235
false,true,11712,11015,697,0,00:00:00.000,2025-04-15 13:26:03.249
false,true,11712,11015,697,0,00:00:00.000,2025-04-15 13:26:10.257
false,true,11712,11015,697,0,00:00:00.000,2025-04-15 13:26:13.262
false,false,11717,11020,697,157,00:00:33.000,2025-04-15 13:26:18.268
false,false,11724,11027,697,373,00:00:30.000,2025-04-15 13:26:25.275
false,true,11726,11029,697,0,00:00:00.000,2025-04-15 13:26:30.278
false,true,11931,11222,709,0,00:00:00.000,2025-04-15 13:31:41.598
false,false,11936,11227,709,125,00:00:33.000,2025-04-15 13:31:57.614
false,false,11937,11228,709,157,00:00:32.000,2025-04-15 13:31:58.614
false,false,11941,11231,710,128,00:00:32.000,2025-04-15 13:32:14.628
false,false,11947,11236,711,322,00:00:31.000,2025-04-15 13:32:20.636
false,true,11970,11256,714,0,00:00:00.000,2025-04-15 13:32:44.667
false,false,11974,11260,714,32,00:00:32.000,2025-04-15 13:32:59.687
false,false,11975,11261,714,63,00:00:31.000,2025-04-15 13:33:00.687
false,false,11983,11269,714,310,00:00:30.000,2025-04-15 13:33:08.696
false,true,11893,11184,709,0,00:00:00.000,2025-04-15 13:30:48.542
false,false,11921,11212,709,562,00:00:31.000,2025-04-15 13:31:30.587
false,false,2929,2758,171,689,00:00:30.000,2025-04-14 12:39:09.738
false,false,2935,2764,171,880,00:00:33.000,2025-04-14 12:39:21.746
false,false,2936,2765,171,911,00:00:31.000,2025-04-14 12:39:23.747
false,false,2937,2766,171,944,00:00:33.000,2025-04-14 12:39:25.747
false,false,2968,2794,174,189,00:00:33.000,2025-04-14 12:41:03.817
false,true,2972,2798,174,0,00:00:00.000,2025-04-14 12:41:19.831
false,true,2990,2814,176,0,00:00:00.000,2025-04-14 12:42:19.884
false,true,2993,2817,176,0,00:00:00.000,2025-04-14 12:42:35.900
false,true,3020,2842,178,0,00:00:00.000,2025-04-14 12:43:49.957
false,false,3022,2844,178,65,00:00:33.000,2025-04-14 12:44:03.968
false,true,3027,2849,178,0,00:00:00.000,2025-04-14 12:44:19.979
false,false,3033,2854,179,193,00:00:32.000,2025-04-14 12:44:37.992
false,false,3035,2856,179,255,00:00:31.000,2025-04-14 12:44:41.994
false,false,9788,9201,587,1014,00:00:32.000,2025-04-15 12:41:36.537
false,false,9791,9204,587,1105,00:00:31.000,2025-04-15 12:41:39.540
false,false,9814,9226,588,698,00:00:31.000,2025-04-15 12:42:08.568
false,false,9824,9235,589,1009,00:00:32.000,2025-04-15 12:42:18.578
false,false,9845,9253,592,1677,00:00:31.000,2025-04-15 12:42:39.603
false,true,9849,9257,592,0,00:00:00.000,2025-04-15 12:42:44.607
false,false,9951,9355,596,349,00:00:33.000,2025-04-15 12:45:13.758
false,false,9957,9361,596,95,00:00:33.000,2025-04-15 12:45:25.774
false,true,9961,9364,597,0,00:00:00.000,2025-04-15 12:45:40.791
false,false,9970,9372,598,288,00:00:33.000,2025-04-15 12:45:50.803
false,true,10065,9461,604,0,00:00:00.000,2025-04-15 12:48:15.946
false,false,10092,9486,606,848,00:00:33.000,2025-04-15 12:48:46.979
false,false,10112,9505,607,1481,00:00:32.000,2025-04-15 12:49:07.003
false,true,10128,9520,608,0,00:00:00.000,2025-04-15 12:49:26.026
false,false,9860,9268,592,249,00:00:33.000,2025-04-15 12:43:12.633
false,false,9879,9286,593,473,00:00:33.000,2025-04-15 12:43:37.662
false,false,9880,9287,593,506,00:00:33.000,2025-04-15 12:43:38.664
false,false,9881,9287,594,538,00:00:32.000,2025-04-15 12:43:39.665
false,false,9883,9289,594,599,00:00:31.000,2025-04-15 12:43:41.667
false,false,9893,9298,595,915,00:00:32.000,2025-04-15 12:43:51.679
false,false,9927,9331,596,474,00:00:32.000,2025-04-15 12:44:31.717
false,true,9927,9331,596,0,00:00:00.000,2025-04-15 12:44:32.718
false,false,9721,9138,583,127,00:00:31.000,2025-04-15 12:40:05.457
false,false,9732,9149,583,126,00:00:33.000,2025-04-15 12:40:22.472
false,false,9734,9151,583,186,00:00:30.000,2025-04-15 12:40:24.474
false,true,9748,9165,583,0,00:00:00.000,2025-04-15 12:40:44.489
false,false,9752,9168,584,33,00:00:33.000,2025-04-15 12:40:54.498
false,false,9999,9399,600,843,00:00:30.000,2025-04-15 12:46:31.843
false,false,10005,9404,601,1034,00:00:32.000,2025-04-15 12:46:37.850
false,true,10013,9411,602,0,00:00:00.000,2025-04-15 12:46:53.862
false,false,10021,9419,602,251,00:00:30.000,2025-04-15 12:47:05.875
false,true,10027,9424,603,0,00:00:00.000,2025-04-15 12:47:22.892
false,true,10047,9444,603,0,00:00:00.000,2025-04-15 12:47:48.919
false,true,10056,9453,603,0,00:00:00.000,2025-04-15 12:48:01.931
false,false,10242,9624,618,595,00:00:33.000,2025-04-15 12:51:59.182
false,true,10283,9664,619,0,00:00:00.000,2025-04-15 12:52:42.234
false,false,10296,9675,621,410,00:00:30.000,2025-04-15 12:52:59.247
false,false,10302,9681,621,595,00:00:32.000,2025-04-15 12:53:05.253
false,false,10304,9683,621,658,00:00:32.000,2025-04-15 12:53:07.257
false,true,10381,9756,625,0,00:00:00.000,2025-04-15 12:54:54.368
false,false,10389,9764,625,256,00:00:33.000,2025-04-15 12:55:02.376
false,false,10392,9765,627,352,00:00:32.000,2025-04-15 12:55:05.380
false,false,10409,9782,627,886,00:00:32.000,2025-04-15 12:55:22.395
false,true,10412,9785,627,0,00:00:00.000,2025-04-15 12:55:31.403
false,false,10443,9814,629,312,00:00:31.000,2025-04-15 12:56:32.459
false,false,10447,9818,629,436,00:00:30.000,2025-04-15 12:56:36.465
false,false,10473,9841,632,730,00:00:33.000,2025-04-15 12:57:08.498
false,false,10479,9847,632,922,00:00:32.000,2025-04-15 12:57:14.504
false,false,10498,9865,633,1509,00:00:31.000,2025-04-15 12:57:33.525
false,false,10529,9894,635,64,00:00:33.000,2025-04-15 12:58:22.581
false,false,10559,9922,637,127,00:00:32.000,2025-04-15 12:59:04.622
false,true,10559,9922,637,0,00:00:00.000,2025-04-15 12:59:05.622
false,false,10589,9951,638,945,00:00:31.000,2025-04-15 12:59:40.659
false,false,10309,9688,621,812,00:00:33.000,2025-04-15 12:53:12.260
false,false,10344,9721,623,346,00:00:33.000,2025-04-15 12:53:53.303
false,false,10349,9725,624,499,00:00:31.000,2025-04-15 12:53:58.308
false,false,10354,9730,624,657,00:00:30.000,2025-04-15 12:54:03.310
false,false,10378,9753,625,347,00:00:32.000,2025-04-15 12:54:45.355
false,false,10603,9963,640,125,00:00:32.000,2025-04-15 13:00:00.679
false,false,10621,9979,642,690,00:00:31.000,2025-04-15 13:00:18.695
false,false,10627,9985,642,879,00:00:32.000,2025-04-15 13:00:24.702
false,false,10638,9996,642,30,00:00:30.000,2025-04-15 13:00:41.720
false,false,10652,10009,643,474,00:00:31.000,2025-04-15 13:00:55.733
false,false,10655,10012,643,63,00:00:33.000,2025-04-15 13:01:10.749
false,true,10661,10018,643,0,00:00:00.000,2025-04-15 13:01:17.753
false,true,10661,10018,643,0,00:00:00.000,2025-04-15 13:01:20.755
false,true,10778,10129,649,0,00:00:00.000,2025-04-15 13:03:54.901
false,false,10790,10141,649,377,00:00:31.000,2025-04-15 13:04:13.923
false,false,10808,10158,650,217,00:00:30.000,2025-04-15 13:04:37.948
false,false,10890,10235,655,283,00:00:30.000,2025-04-15 13:06:36.067
false,false,10901,10246,655,127,00:00:31.000,2025-04-15 13:06:53.085
false,true,10905,10250,655,0,00:00:00.000,2025-04-15 13:06:58.090
false,false,10906,10251,655,33,00:00:33.000,2025-04-15 13:07:04.095
false,false,10920,10264,656,473,00:00:33.000,2025-04-15 13:07:18.111
false,false,10924,10268,656,599,00:00:30.000,2025-04-15 13:07:22.116
false,false,10935,10278,657,343,00:00:32.000,2025-04-15 13:07:39.130
false,true,10974,10317,657,0,00:00:00.000,2025-04-15 13:08:35.190
false,true,10975,10318,657,0,00:00:00.000,2025-04-15 13:08:38.191
false,false,10976,10319,657,30,00:00:30.000,2025-04-15 13:08:44.194
false,true,10977,10320,657,0,00:00:00.000,2025-04-15 13:08:46.195
false,false,10986,10329,657,280,00:00:30.000,2025-04-15 13:09:00.212
false,true,10991,10334,657,0,00:00:00.000,2025-04-15 13:09:11.219
false,false,11008,10351,657,474,00:00:33.000,2025-04-15 13:09:34.241
false,true,11009,10352,657,0,00:00:00.000,2025-04-15 13:09:37.244
false,false,11010,10353,657,32,00:00:32.000,2025-04-15 13:09:42.250
false,true,10671,10028,643,0,00:00:00.000,2025-04-15 13:01:33.768
false,false,10680,10036,644,288,00:00:30.000,2025-04-15 13:01:47.783
false,false,10694,10048,646,740,00:00:32.000,2025-04-15 13:02:01.793
false,false,10713,10067,646,465,00:00:31.000,2025-04-15 13:02:26.818
false,false,10714,10068,646,497,00:00:32.000,2025-04-15 13:02:27.818
false,true,10736,10087,649,0,00:00:00.000,2025-04-15 13:02:52.849
false,false,10822,10172,650,125,00:00:31.000,2025-04-15 13:04:57.967
false,true,10843,10192,651,0,00:00:00.000,2025-04-15 13:05:28.997
false,false,10858,10206,652,65,00:00:32.000,2025-04-15 13:05:52.024
false,false,10874,10221,653,316,00:00:33.000,2025-04-15 13:06:14.046
false,true,10881,10226,655,0,00:00:00.000,2025-04-15 13:06:23.056
false,true,10196,9580,616,0,00:00:00.000,2025-04-15 12:50:46.111
false,true,10200,9584,616,0,00:00:00.000,2025-04-15 12:50:59.120
false,false,10202,9586,616,63,00:00:33.000,2025-04-15 12:51:01.121
false,false,10208,9592,616,189,00:00:31.000,2025-04-15 12:51:13.134
false,false,11027,10369,658,156,00:00:32.000,2025-04-15 13:10:05.269
false,false,11034,10375,659,380,00:00:32.000,2025-04-15 13:10:12.275
false,false,11038,10379,659,96,00:00:31.000,2025-04-15 13:10:22.288
false,false,11040,10381,659,33,00:00:33.000,2025-04-15 13:10:30.292
false,false,11055,10396,659,508,00:00:32.000,2025-04-15 13:10:45.306
false,true,11058,10399,659,0,00:00:00.000,2025-04-15 13:10:52.314
false,true,11072,10413,659,0,00:00:00.000,2025-04-15 13:11:13.334
false,false,11169,10505,664,535,00:00:32.000,2025-04-15 13:13:21.463
false,false,11179,10515,664,93,00:00:31.000,2025-04-15 13:13:37.482
false,false,11200,10536,664,126,00:00:33.000,2025-04-15 13:14:04.509
false,true,11203,10539,664,0,00:00:00.000,2025-04-15 13:14:08.513
false,false,11220,10553,667,529,00:00:32.000,2025-04-15 13:14:30.537
false,true,11220,10553,667,0,00:00:00.000,2025-04-15 13:14:32.539
false,true,11329,10655,674,0,00:00:00.000,2025-04-15 13:16:49.677
false,false,11330,10656,674,31,00:00:31.000,2025-04-15 13:16:50.678
false,false,11334,10660,674,159,00:00:33.000,2025-04-15 13:16:54.684
false,false,11341,10667,674,91,00:00:30.000,2025-04-15 13:17:13.703
false,false,11353,10679,674,31,00:00:31.000,2025-04-15 13:17:31.720
false,false,11356,10682,674,92,00:00:32.000,2025-04-15 13:17:40.731
false,false,11254,10587,667,1065,00:00:30.000,2025-04-15 13:15:10.578
false,false,11272,10605,667,1632,00:00:32.000,2025-04-15 13:15:28.597
false,false,11302,10629,673,191,00:00:32.000,2025-04-15 13:16:16.644
false,false,11317,10643,674,665,00:00:31.000,2025-04-15 13:16:31.655
false,false,11092,10430,662,96,00:00:33.000,2025-04-15 13:11:40.357
false,false,11093,10431,662,128,00:00:32.000,2025-04-15 13:11:41.358
false,false,11094,10431,663,159,00:00:31.000,2025-04-15 13:11:42.359
false,false,11097,10434,663,253,00:00:31.000,2025-04-15 13:11:45.362
false,false,11119,10456,663,937,00:00:31.000,2025-04-15 13:12:07.388
false,false,11127,10464,663,189,00:00:31.000,2025-04-15 13:12:27.413
false,false,11141,10477,664,310,00:00:31.000,2025-04-15 13:12:47.430
false,false,11143,10479,664,375,00:00:33.000,2025-04-15 13:12:49.431
false,true,11388,10713,675,0,00:00:00.000,2025-04-15 13:18:25.778
false,true,11388,10713,675,0,00:00:00.000,2025-04-15 13:18:28.778
false,false,11394,10719,675,194,00:00:31.000,2025-04-15 13:18:36.784
false,false,11406,10726,680,97,00:00:32.000,2025-04-15 13:18:54.802
false,false,11531,10847,684,255,00:00:33.000,2025-04-15 13:21:35.980
false,false,11533,10849,684,317,00:00:30.000,2025-04-15 13:21:37.983
false,false,11549,10863,686,60,00:00:30.000,2025-04-15 13:22:00.005
false,true,11588,10899,689,0,00:00:00.000,2025-04-15 13:23:00.063
false,false,11454,10772,682,1394,00:00:33.000,2025-04-15 13:19:54.861
false,false,11463,10781,682,1679,00:00:33.000,2025-04-15 13:20:03.871
false,false,11465,10783,682,1741,00:00:30.000,2025-04-15 13:20:05.875
false,true,11499,10816,683,0,00:00:00.000,2025-04-15 13:20:49.926
false,false,11521,10838,683,313,00:00:30.000,2025-04-15 13:21:19.960
false,false,11526,10842,684,97,00:00:31.000,2025-04-15 13:21:30.975
false,false,11607,10918,689,249,00:00:32.000,2025-04-15 13:23:34.098
false,false,11617,10927,690,126,00:00:31.000,2025-04-15 13:23:56.119
false,false,11626,10936,690,410,00:00:31.000,2025-04-15 13:24:05.129
false,false,11631,10941,690,565,00:00:30.000,2025-04-15 13:24:10.134
false,false,11667,10973,694,851,00:00:31.000,2025-04-15 13:24:52.176
false,false,11736,11038,698,156,00:00:31.000,2025-04-15 13:26:49.300
false,false,11770,11069,701,378,00:00:30.000,2025-04-15 13:27:35.342
false,false,11772,11071,701,444,00:00:33.000,2025-04-15 13:27:37.344
false,false,11810,11107,703,1643,00:00:31.000,2025-04-15 13:28:15.373
false,true,11811,11108,703,0,00:00:00.000,2025-04-15 13:28:20.381
false,false,11841,11136,705,940,00:00:31.000,2025-04-15 13:28:52.414
false,true,11858,11153,705,0,00:00:00.000,2025-04-15 13:29:26.448
false,true,11858,11153,705,0,00:00:00.000,2025-04-15 13:29:33.457
false,false,11677,10983,694,1168,00:00:33.000,2025-04-15 13:25:02.185
false,true,11696,10999,697,0,00:00:00.000,2025-04-15 13:25:39.222
false,false,11707,11010,697,157,00:00:32.000,2025-04-15 13:25:56.242
false,false,11711,11014,697,286,00:00:33.000,2025-04-15 13:26:00.246
false,true,11712,11015,697,0,00:00:00.000,2025-04-15 13:26:07.253
false,true,11726,11029,697,0,00:00:00.000,2025-04-15 13:26:28.276
false,true,11931,11222,709,0,00:00:00.000,2025-04-15 13:31:42.599
false,true,11932,11223,709,0,00:00:00.000,2025-04-15 13:31:49.605
false,false,11940,11230,710,96,00:00:33.000,2025-04-15 13:32:13.628
false,false,11970,11256,714,1047,00:00:30.000,2025-04-15 13:32:43.666
false,false,11976,11262,714,95,00:00:32.000,2025-04-15 13:33:01.688
false,false,11982,11268,714,280,00:00:30.000,2025-04-15 13:33:07.695
false,false,11870,11165,705,97,00:00:33.000,2025-04-15 13:29:57.486
false,true,11874,11168,706,0,00:00:00.000,2025-04-15 13:30:04.493
false,true,11874,11168,706,0,00:00:00.000,2025-04-15 13:30:05.494
false,true,11874,11168,706,0,00:00:00.000,2025-04-15 13:30:06.495
false,false,11880,11174,706,63,00:00:33.000,2025-04-15 13:30:19.511
false,false,11886,11179,707,249,00:00:32.000,2025-04-15 13:30:25.519
false,true,11887,11180,707,0,00:00:00.000,2025-04-15 13:30:27.522
false,true,11887,11180,707,0,00:00:00.000,2025-04-15 13:30:30.525
false,true,11887,11180,707,0,00:00:00.000,2025-04-15 13:30:38.534
false,true,11894,11185,709,0,00:00:00.000,2025-04-15 13:30:53.549
false,true,11894,11185,709,0,00:00:00.000,2025-04-15 13:30:55.550
false,true,11894,11185,709,0,00:00:00.000,2025-04-15 13:30:57.553
false,true,11903,11194,709,0,00:00:00.000,2025-04-15 13:31:11.568
false,false,11915,11206,709,373,00:00:32.000,2025-04-15 13:31:24.580
false,false,2920,2750,170,411,00:00:33.000,2025-04-14 12:38:51.723
false,true,2962,2789,173,0,00:00:00.000,2025-04-14 12:40:43.801
false,true,2962,2789,173,0,00:00:00.000,2025-04-14 12:40:47.805
false,false,2963,2789,174,31,00:00:31.000,2025-04-14 12:40:53.809
false,false,2980,2806,174,255,00:00:32.000,2025-04-14 12:41:39.850
false,false,3019,2841,178,32,00:00:32.000,2025-04-14 12:43:45.956
false,true,3020,2842,178,0,00:00:00.000,2025-04-14 12:43:55.962
false,false,3025,2847,178,159,00:00:32.000,2025-04-14 12:44:09.972
false,true,3027,2849,178,0,00:00:00.000,2025-04-14 12:44:15.976
false,false,3030,2852,178,97,00:00:31.000,2025-04-14 12:44:31.986
false,true,3045,2866,179,0,00:00:00.000,2025-04-14 12:45:04.011
false,false,9825,9236,589,1042,00:00:33.000,2025-04-15 12:42:19.579
false,false,9835,9244,591,1357,00:00:30.000,2025-04-15 12:42:29.592
false,false,9938,9342,596,32,00:00:32.000,2025-04-15 12:44:54.736
false,true,9954,9358,596,0,00:00:00.000,2025-04-15 12:45:17.763
false,false,9966,9368,598,162,00:00:33.000,2025-04-15 12:45:46.798
false,true,9971,9373,598,0,00:00:00.000,2025-04-15 12:45:57.812
false,false,9985,9386,599,403,00:00:32.000,2025-04-15 12:46:17.832
false,false,9996,9396,600,751,00:00:33.000,2025-04-15 12:46:28.842
false,true,10065,9461,604,0,00:00:00.000,2025-04-15 12:48:17.949
false,false,10069,9465,604,125,00:00:31.000,2025-04-15 12:48:23.954
false,false,10072,9468,604,221,00:00:32.000,2025-04-15 12:48:26.957
false,false,10085,9481,604,629,00:00:30.000,2025-04-15 12:48:39.971
false,false,10098,9492,606,1042,00:00:32.000,2025-04-15 12:48:52.988
false,false,10101,9494,607,1135,00:00:31.000,2025-04-15 12:48:55.991
false,false,10113,9506,607,1513,00:00:32.000,2025-04-15 12:49:08.005
false,false,10115,9508,607,1574,00:00:31.000,2025-04-15 12:49:10.007
false,false,10133,9525,608,160,00:00:33.000,2025-04-15 12:49:34.033
false,false,9859,9267,592,216,00:00:30.000,2025-04-15 12:43:11.633
false,false,9863,9271,592,340,00:00:30.000,2025-04-15 12:43:15.636
false,true,9864,9272,592,0,00:00:00.000,2025-04-15 12:43:20.642
false,false,9897,9302,595,1042,00:00:31.000,2025-04-15 12:43:55.683
false,false,9724,9141,583,223,00:00:33.000,2025-04-15 12:40:08.459
false,false,9728,9145,583,347,00:00:31.000,2025-04-15 12:40:12.463
false,false,9754,9170,584,96,00:00:33.000,2025-04-15 12:40:56.500
false,false,9760,9175,585,127,00:00:30.000,2025-04-15 12:41:08.511
false,false,9772,9187,585,508,00:00:32.000,2025-04-15 12:41:20.521
false,false,10014,9412,602,31,00:00:31.000,2025-04-15 12:46:58.866
false,false,10041,9438,603,444,00:00:32.000,2025-04-15 12:47:37.910
false,false,10221,9605,616,285,00:00:30.000,2025-04-15 12:51:32.152
false,false,10222,9606,616,315,00:00:30.000,2025-04-15 12:51:33.154
false,false,10268,9650,618,1418,00:00:31.000,2025-04-15 12:52:25.213
false,false,10281,9662,619,1829,00:00:30.000,2025-04-15 12:52:38.229
false,false,10282,9663,619,1860,00:00:31.000,2025-04-15 12:52:39.230
false,true,10283,9664,619,0,00:00:00.000,2025-04-15 12:52:44.235
false,false,10284,9665,619,30,00:00:30.000,2025-04-15 12:52:47.237
false,false,10385,9760,625,127,00:00:30.000,2025-04-15 12:54:58.373
false,false,10397,9770,627,508,00:00:31.000,2025-04-15 12:55:10.383
false,false,10400,9773,627,603,00:00:32.000,2025-04-15 12:55:13.387
false,false,10408,9781,627,854,00:00:31.000,2025-04-15 12:55:21.394
false,false,10417,9790,627,158,00:00:33.000,2025-04-15 12:55:36.408
false,true,10419,9792,627,0,00:00:00.000,2025-04-15 12:55:42.412
false,true,10423,9796,627,0,00:00:00.000,2025-04-15 12:55:56.425
false,false,10424,9797,627,32,00:00:32.000,2025-04-15 12:56:01.429
false,true,10433,9805,628,0,00:00:00.000,2025-04-15 12:56:21.452
false,true,10450,9820,630,0,00:00:00.000,2025-04-15 12:56:45.476
false,false,10477,9845,632,858,00:00:33.000,2025-04-15 12:57:12.503
false,false,10485,9852,633,1110,00:00:32.000,2025-04-15 12:57:20.512
false,false,10493,9860,633,1357,00:00:30.000,2025-04-15 12:57:28.520
false,false,10525,9890,635,316,00:00:31.000,2025-04-15 12:58:12.572
false,false,10558,9922,636,95,00:00:32.000,2025-04-15 12:59:03.620
false,false,10311,9689,622,875,00:00:31.000,2025-04-15 12:53:14.261
false,false,10319,9697,622,1122,00:00:31.000,2025-04-15 12:53:22.270
false,false,10323,9701,622,1246,00:00:33.000,2025-04-15 12:53:26.275
false,false,10330,9708,622,1463,00:00:33.000,2025-04-15 12:53:33.283
false,false,10331,9709,622,1493,00:00:30.000,2025-04-15 12:53:34.283
false,false,10347,9723,624,438,00:00:31.000,2025-04-15 12:53:56.306
false,true,10367,9743,624,0,00:00:00.000,2025-04-15 12:54:30.340
false,false,10610,9969,641,342,00:00:30.000,2025-04-15 13:00:07.686
false,true,10637,9995,642,0,00:00:00.000,2025-04-15 13:00:40.719
false,false,10644,10001,643,221,00:00:32.000,2025-04-15 13:00:47.728
false,false,10668,10025,643,219,00:00:31.000,2025-04-15 13:01:29.764
false,true,10760,10111,649,0,00:00:00.000,2025-04-15 13:03:28.876
false,true,10778,10129,649,0,00:00:00.000,2025-04-15 13:03:50.897
false,true,10778,10129,649,0,00:00:00.000,2025-04-15 13:04:00.906
false,false,10786,10137,649,252,00:00:33.000,2025-04-15 13:04:09.918
false,false,10813,10163,650,377,00:00:32.000,2025-04-15 13:04:42.953
false,false,10814,10164,650,409,00:00:32.000,2025-04-15 13:04:43.953
false,true,10905,10250,655,0,00:00:00.000,2025-04-15 13:06:59.090
false,true,10905,10250,655,0,00:00:00.000,2025-04-15 13:07:02.093
false,false,10908,10253,655,97,00:00:31.000,2025-04-15 13:07:06.097
false,false,10927,10271,656,94,00:00:33.000,2025-04-15 13:07:31.123
false,false,10953,10296,657,907,00:00:32.000,2025-04-15 13:07:57.150
false,true,10966,10309,657,0,00:00:00.000,2025-04-15 13:08:21.173
false,false,11001,10344,657,253,00:00:33.000,2025-04-15 13:09:27.234
false,false,11019,10362,657,316,00:00:30.000,2025-04-15 13:09:51.260
false,true,10671,10028,643,0,00:00:00.000,2025-04-15 13:01:38.773
false,false,10688,10044,644,544,00:00:33.000,2025-04-15 13:01:55.788
false,false,10696,10050,646,802,00:00:31.000,2025-04-15 13:02:03.794
false,true,10698,10052,646,0,00:00:00.000,2025-04-15 13:02:07.797
false,false,10710,10064,646,372,00:00:30.000,2025-04-15 13:02:23.815
false,false,10711,10065,646,402,00:00:30.000,2025-04-15 13:02:24.816
false,false,10730,10081,649,999,00:00:30.000,2025-04-15 13:02:43.837
false,false,10741,10092,649,158,00:00:33.000,2025-04-15 13:03:00.856
false,false,10745,10096,649,283,00:00:31.000,2025-04-15 13:03:04.861
false,true,10745,10096,649,0,00:00:00.000,2025-04-15 13:03:06.861
false,true,10833,10182,651,0,00:00:00.000,2025-04-15 13:05:12.984
false,false,10853,10202,651,313,00:00:30.000,2025-04-15 13:05:41.008
false,true,10856,10204,652,0,00:00:00.000,2025-04-15 13:05:47.015
false,false,10875,10222,653,346,00:00:30.000,2025-04-15 13:06:15.048
false,false,10878,10224,654,440,00:00:31.000,2025-04-15 13:06:18.051
false,false,10173,9562,611,537,00:00:30.000,2025-04-15 12:50:20.084
false,true,10212,9596,616,0,00:00:00.000,2025-04-15 12:51:20.141
false,false,10218,9602,616,189,00:00:33.000,2025-04-15 12:51:29.150
false,false,10219,9603,616,222,00:00:33.000,2025-04-15 12:51:30.151
false,true,11022,10365,657,0,00:00:00.000,2025-04-15 13:09:56.263
false,false,11032,10373,659,315,00:00:33.000,2025-04-15 13:10:10.274
false,false,11041,10382,659,63,00:00:30.000,2025-04-15 13:10:31.292
false,false,11057,10398,659,572,00:00:33.000,2025-04-15 13:10:47.308
false,false,11058,10399,659,602,00:00:30.000,2025-04-15 13:10:48.310
false,false,11068,10409,659,317,00:00:30.000,2025-04-15 13:11:04.324
false,false,11163,10499,664,344,00:00:31.000,2025-04-15 13:13:15.459
false,false,11174,10510,664,696,00:00:33.000,2025-04-15 13:13:26.469
false,false,11175,10511,664,726,00:00:30.000,2025-04-15 13:13:27.470
false,false,11180,10516,664,124,00:00:31.000,2025-04-15 13:13:38.482
false,false,11222,10555,667,65,00:00:33.000,2025-04-15 13:14:38.543
false,false,11333,10659,674,126,00:00:31.000,2025-04-15 13:16:53.683
false,false,11342,10668,674,121,00:00:30.000,2025-04-15 13:17:14.703
false,false,11347,10673,674,277,00:00:32.000,2025-04-15 13:17:19.709
false,false,11348,10674,674,307,00:00:30.000,2025-04-15 13:17:20.710
false,true,11352,10678,674,0,00:00:00.000,2025-04-15 13:17:26.717
false,true,11352,10678,674,0,00:00:00.000,2025-04-15 13:17:29.719
false,false,11354,10680,674,30,00:00:30.000,2025-04-15 13:17:38.729
false,false,11359,10685,674,184,00:00:32.000,2025-04-15 13:17:43.736
false,true,11369,10695,674,0,00:00:00.000,2025-04-15 13:17:54.747
false,true,11369,10695,674,0,00:00:00.000,2025-04-15 13:17:55.748
false,false,11372,10698,674,98,00:00:33.000,2025-04-15 13:18:02.755
false,false,11373,10699,674,130,00:00:32.000,2025-04-15 13:18:03.756
false,false,11375,10701,674,194,00:00:31.000,2025-04-15 13:18:05.757
false,false,11253,10586,667,1035,00:00:30.000,2025-04-15 13:15:09.578
false,false,11268,10601,667,1505,00:00:32.000,2025-04-15 13:15:24.593
false,false,11275,10608,667,1728,00:00:32.000,2025-04-15 13:15:31.599
false,true,11277,10610,667,0,00:00:00.000,2025-04-15 13:15:39.607
false,true,11279,10611,668,0,00:00:00.000,2025-04-15 13:15:46.615
false,false,11284,10615,669,158,00:00:30.000,2025-04-15 13:15:52.621
false,false,11287,10618,669,251,00:00:31.000,2025-04-15 13:15:55.623
false,false,11292,10621,671,410,00:00:32.000,2025-04-15 13:16:00.628
false,false,11300,10627,673,126,00:00:33.000,2025-04-15 13:16:14.641
false,true,11089,10429,660,0,00:00:00.000,2025-04-15 13:11:35.354
false,true,11089,10429,660,0,00:00:00.000,2025-04-15 13:11:37.354
false,true,11121,10458,663,0,00:00:00.000,2025-04-15 13:12:20.405
false,true,11131,10468,663,0,00:00:00.000,2025-04-15 13:12:35.419
false,false,11134,10471,663,92,00:00:31.000,2025-04-15 13:12:40.423
false,false,11398,10721,677,319,00:00:32.000,2025-04-15 13:18:40.788
false,true,11406,10726,680,0,00:00:00.000,2025-04-15 13:18:59.803
false,false,11418,10737,681,251,00:00:33.000,2025-04-15 13:19:18.820
false,false,11428,10747,681,570,00:00:32.000,2025-04-15 13:19:28.831
false,false,11429,10748,681,601,00:00:31.000,2025-04-15 13:19:29.831
false,false,11439,10758,681,913,00:00:30.000,2025-04-15 13:19:39.842
false,false,11442,10761,681,1009,00:00:33.000,2025-04-15 13:19:42.847
false,false,11452,10770,682,1329,00:00:32.000,2025-04-15 13:19:52.859
false,false,11537,10853,684,438,00:00:30.000,2025-04-15 13:21:41.986
false,false,11540,10856,684,535,00:00:33.000,2025-04-15 13:21:44.990
false,true,11549,10863,686,0,00:00:00.000,2025-04-15 13:22:02.007
false,true,11552,10864,688,0,00:00:00.000,2025-04-15 13:22:10.014
false,false,11472,10790,682,1960,00:00:31.000,2025-04-15 13:20:12.885
false,false,11482,10799,683,285,00:00:33.000,2025-04-15 13:20:28.904
false,false,11490,10807,683,533,00:00:33.000,2025-04-15 13:20:36.911
false,false,11493,10810,683,626,00:00:32.000,2025-04-15 13:20:39.912
false,false,11494,10811,683,657,00:00:31.000,2025-04-15 13:20:40.912
false,true,11499,10816,683,0,00:00:00.000,2025-04-15 13:20:47.925
false,true,11499,10816,683,0,00:00:00.000,2025-04-15 13:20:50.927
false,false,11502,10819,683,93,00:00:30.000,2025-04-15 13:20:54.933
false,false,11513,10830,683,62,00:00:31.000,2025-04-15 13:21:11.952
false,false,11518,10835,683,221,00:00:32.000,2025-04-15 13:21:16.956
false,false,11605,10916,689,185,00:00:30.000,2025-04-15 13:23:32.096
false,false,11610,10920,690,344,00:00:31.000,2025-04-15 13:23:37.101
false,true,11611,10921,690,0,00:00:00.000,2025-04-15 13:23:42.106
false,false,11655,10962,693,476,00:00:30.000,2025-04-15 13:24:40.161
false,false,11660,10966,694,636,00:00:31.000,2025-04-15 13:24:45.167
false,true,11731,11034,697,0,00:00:00.000,2025-04-15 13:26:42.290
false,true,11731,11034,697,0,00:00:00.000,2025-04-15 13:26:43.291
false,true,11731,11034,697,0,00:00:00.000,2025-04-15 13:26:44.292
false,false,11732,11035,697,30,00:00:30.000,2025-04-15 13:26:45.293
false,false,11783,11082,701,788,00:00:30.000,2025-04-15 13:27:48.353
false,false,11787,11086,701,911,00:00:30.000,2025-04-15 13:27:52.358
false,false,11797,11095,702,1232,00:00:33.000,2025-04-15 13:28:02.366
false,false,11831,11127,704,624,00:00:31.000,2025-04-15 13:28:42.407
false,false,11843,11138,705,1005,00:00:33.000,2025-04-15 13:28:54.416
false,true,11845,11140,705,0,00:00:00.000,2025-04-15 13:28:58.418
false,false,11853,11148,705,258,00:00:33.000,2025-04-15 13:29:10.431
false,true,11858,11153,705,0,00:00:00.000,2025-04-15 13:29:25.447
false,false,11860,11155,705,62,00:00:32.000,2025-04-15 13:29:35.460
false,true,11867,11162,705,0,00:00:00.000,2025-04-15 13:29:51.478
false,false,11675,10981,694,1104,00:00:31.000,2025-04-15 13:25:00.183
false,false,11684,10989,695,1387,00:00:31.000,2025-04-15 13:25:09.192
false,true,11686,10991,695,0,00:00:00.000,2025-04-15 13:25:18.200
false,true,11702,11005,697,0,00:00:00.000,2025-04-15 13:25:46.230
false,true,11702,11005,697,0,00:00:00.000,2025-04-15 13:25:51.236
false,false,11704,11007,697,65,00:00:32.000,2025-04-15 13:25:53.239
false,false,11705,11008,697,95,00:00:30.000,2025-04-15 13:25:54.241
false,true,11712,11015,697,0,00:00:00.000,2025-04-15 13:26:04.250
false,false,11715,11018,697,94,00:00:30.000,2025-04-15 13:26:16.265
false,false,11927,11218,709,752,00:00:30.000,2025-04-15 13:31:36.592
false,false,11929,11220,709,813,00:00:30.000,2025-04-15 13:31:38.595
false,true,11937,11228,709,0,00:00:00.000,2025-04-15 13:32:03.620
false,true,11937,11228,709,0,00:00:00.000,2025-04-15 13:32:04.621
false,false,11950,11239,711,415,00:00:31.000,2025-04-15 13:32:23.639
false,false,11958,11245,713,676,00:00:31.000,2025-04-15 13:32:31.651
false,false,11959,11246,713,706,00:00:30.000,2025-04-15 13:32:32.653
false,false,11963,11250,713,832,00:00:33.000,2025-04-15 13:32:36.657
false,false,11877,11171,706,98,00:00:32.000,2025-04-15 13:30:10.500
false,false,11881,11175,706,96,00:00:33.000,2025-04-15 13:30:20.512
false,true,11887,11180,707,0,00:00:00.000,2025-04-15 13:30:37.533
false,true,11903,11194,709,0,00:00:00.000,2025-04-15 13:31:12.569
false,false,2902,2732,170,348,00:00:33.000,2025-04-14 12:37:51.663
false,false,2906,2736,170,32,00:00:32.000,2025-04-14 12:38:11.685
false,false,2941,2770,171,1074,00:00:33.000,2025-04-14 12:39:33.753
false,false,2957,2784,173,1584,00:00:31.000,2025-04-14 12:40:05.769
false,true,2957,2784,173,0,00:00:00.000,2025-04-14 12:40:09.772
false,true,2990,2814,176,0,00:00:00.000,2025-04-14 12:42:13.878
false,true,2993,2817,176,0,00:00:00.000,2025-04-14 12:42:37.902
false,false,2999,2823,176,187,00:00:33.000,2025-04-14 12:42:53.913
false,true,3020,2842,178,0,00:00:00.000,2025-04-14 12:43:59.963
false,false,3031,2853,178,130,00:00:33.000,2025-04-14 12:44:33.988
false,false,3039,2860,179,383,00:00:33.000,2025-04-14 12:44:49.997
false,true,3045,2866,179,0,00:00:00.000,2025-04-14 12:45:08.016
false,false,9799,9212,587,221,00:00:30.000,2025-04-15 12:41:53.558
false,false,9826,9237,589,1074,00:00:32.000,2025-04-15 12:42:20.580
false,false,9846,9254,592,1707,00:00:30.000,2025-04-15 12:42:40.604
false,true,9849,9257,592,0,00:00:00.000,2025-04-15 12:42:46.610
false,false,9949,9353,596,283,00:00:33.000,2025-04-15 12:45:11.755
false,true,9954,9358,596,0,00:00:00.000,2025-04-15 12:45:21.767
false,true,9961,9364,597,0,00:00:00.000,2025-04-15 12:45:41.793
false,true,9971,9373,598,0,00:00:00.000,2025-04-15 12:45:55.809
false,false,9973,9375,598,30,00:00:30.000,2025-04-15 12:46:05.821
false,false,9974,9376,598,61,00:00:31.000,2025-04-15 12:46:06.823
false,false,9989,9389,600,529,00:00:31.000,2025-04-15 12:46:21.835
false,true,10065,9461,604,0,00:00:00.000,2025-04-15 12:48:16.947
false,false,10094,9488,606,913,00:00:32.000,2025-04-15 12:48:48.981
false,false,10118,9510,608,1668,00:00:32.000,2025-04-15 12:49:13.010
false,false,10144,9536,608,508,00:00:33.000,2025-04-15 12:49:45.046
false,false,10147,9539,608,602,00:00:31.000,2025-04-15 12:49:48.050
false,false,9864,9272,592,372,00:00:32.000,2025-04-15 12:43:16.638
false,true,9864,9272,592,0,00:00:00.000,2025-04-15 12:43:21.643
false,false,9892,9297,595,883,00:00:31.000,2025-04-15 12:43:50.677
false,false,9902,9307,595,1204,00:00:32.000,2025-04-15 12:44:00.690
false,false,9930,9334,596,97,00:00:32.000,2025-04-15 12:44:40.723
false,true,9937,9341,596,0,00:00:00.000,2025-04-15 12:44:48.731
false,false,9725,9142,583,254,00:00:31.000,2025-04-15 12:40:09.460
false,false,9735,9152,583,217,00:00:31.000,2025-04-15 12:40:25.474
false,false,9744,9161,583,495,00:00:30.000,2025-04-15 12:40:34.480
false,true,9756,9172,584,0,00:00:00.000,2025-04-15 12:41:02.504
false,true,9756,9172,584,0,00:00:00.000,2025-04-15 12:41:03.506
false,true,10013,9411,602,0,00:00:00.000,2025-04-15 12:46:57.865
false,true,10024,9421,603,0,00:00:00.000,2025-04-15 12:47:12.882
false,true,10024,9421,603,0,00:00:00.000,2025-04-15 12:47:13.883
false,false,10026,9423,603,60,00:00:30.000,2025-04-15 12:47:16.887
false,true,10027,9424,603,0,00:00:00.000,2025-04-15 12:47:20.890
false,false,10030,9427,603,98,00:00:33.000,2025-04-15 12:47:26.898
false,false,10038,9435,603,348,00:00:31.000,2025-04-15 12:47:34.908
false,false,10047,9444,603,635,00:00:31.000,2025-04-15 12:47:43.916
false,false,10055,9452,603,246,00:00:30.000,2025-04-15 12:47:57.928
false,true,10223,9606,617,0,00:00:00.000,2025-04-15 12:51:38.159
false,false,10225,9608,617,65,00:00:33.000,2025-04-15 12:51:42.164
false,false,10239,9621,618,499,00:00:32.000,2025-04-15 12:51:56.180
false,false,10248,9630,618,784,00:00:31.000,2025-04-15 12:52:05.190
false,false,10249,9631,618,816,00:00:32.000,2025-04-15 12:52:06.191
false,false,10254,9636,618,977,00:00:33.000,2025-04-15 12:52:11.196
false,false,10265,9647,618,1322,00:00:33.000,2025-04-15 12:52:22.208
false,false,10290,9670,620,219,00:00:33.000,2025-04-15 12:52:53.243
false,false,10301,9680,621,563,00:00:30.000,2025-04-15 12:53:04.252
false,false,10386,9761,625,160,00:00:33.000,2025-04-15 12:54:59.373
false,false,10407,9780,627,823,00:00:33.000,2025-04-15 12:55:20.394
false,true,10423,9796,627,0,00:00:00.000,2025-04-15 12:55:55.423
false,true,10433,9805,628,0,00:00:00.000,2025-04-15 12:56:19.449
false,false,10449,9820,629,496,00:00:30.000,2025-04-15 12:56:38.468
false,false,10453,9823,630,91,00:00:31.000,2025-04-15 12:56:48.479
false,false,10497,9864,633,1478,00:00:31.000,2025-04-15 12:57:32.525
false,false,10502,9869,633,1634,00:00:30.000,2025-04-15 12:57:37.529
false,true,10515,9881,634,0,00:00:00.000,2025-04-15 12:58:01.558
false,false,10524,9889,635,285,00:00:33.000,2025-04-15 12:58:11.571
false,true,10539,9904,635,0,00:00:00.000,2025-04-15 12:58:37.593
false,true,10539,9904,635,0,00:00:00.000,2025-04-15 12:58:38.594
false,false,10562,9925,637,93,00:00:30.000,2025-04-15 12:59:13.631
false,false,10567,9930,637,252,00:00:33.000,2025-04-15 12:59:18.638
false,false,10568,9931,637,284,00:00:32.000,2025-04-15 12:59:19.639
false,false,10578,9941,637,597,00:00:31.000,2025-04-15 12:59:29.647
false,false,10592,9953,639,1039,00:00:31.000,2025-04-15 12:59:43.663
false,false,10320,9698,622,1152,00:00:30.000,2025-04-15 12:53:23.272
false,false,10334,9711,623,30,00:00:30.000,2025-04-15 12:53:43.292
false,false,10357,9733,624,750,00:00:31.000,2025-04-15 12:54:06.315
false,false,10367,9743,624,32,00:00:32.000,2025-04-15 12:54:28.337
false,true,10381,9756,625,0,00:00:00.000,2025-04-15 12:54:50.363
false,true,10381,9756,625,0,00:00:00.000,2025-04-15 12:54:51.364
false,false,10605,9964,641,185,00:00:30.000,2025-04-15 13:00:02.681
false,false,10639,9997,642,61,00:00:31.000,2025-04-15 13:00:42.721
false,false,10641,9998,643,125,00:00:33.000,2025-04-15 13:00:44.725
false,false,10647,10004,643,316,00:00:32.000,2025-04-15 13:00:50.730
false,true,10653,10010,643,0,00:00:00.000,2025-04-15 13:01:06.747
false,false,10778,10129,649,570,00:00:33.000,2025-04-15 13:03:49.897
false,false,10791,10142,649,408,00:00:31.000,2025-04-15 13:04:14.924
false,false,10792,10143,649,439,00:00:31.000,2025-04-15 13:04:15.925
false,false,10798,10148,650,629,00:00:33.000,2025-04-15 13:04:21.932
false,false,10805,10155,650,123,00:00:31.000,2025-04-15 13:04:34.946
false,false,10895,10240,655,440,00:00:30.000,2025-04-15 13:06:41.069
false,false,10913,10258,655,254,00:00:30.000,2025-04-15 13:07:11.102
false,false,10914,10259,655,285,00:00:31.000,2025-04-15 13:07:12.104
false,false,10923,10267,656,569,00:00:33.000,2025-04-15 13:07:21.116
false,true,10924,10268,656,0,00:00:00.000,2025-04-15 13:07:27.118
false,false,10933,10276,657,281,00:00:32.000,2025-04-15 13:07:37.129
false,false,10952,10295,657,875,00:00:30.000,2025-04-15 13:07:56.149
false,false,10955,10298,657,970,00:00:31.000,2025-04-15 13:07:59.151
false,true,10960,10303,657,0,00:00:00.000,2025-04-15 13:08:08.159
false,false,10965,10308,657,160,00:00:33.000,2025-04-15 13:08:15.167
false,true,10966,10309,657,0,00:00:00.000,2025-04-15 13:08:22.174
false,true,10977,10320,657,0,00:00:00.000,2025-04-15 13:08:50.201
false,false,10978,10321,657,30,00:00:30.000,2025-04-15 13:08:52.202
false,true,10993,10336,657,0,00:00:00.000,2025-04-15 13:09:14.222
false,true,10993,10336,657,0,00:00:00.000,2025-04-15 13:09:18.225
false,false,10994,10337,657,32,00:00:32.000,2025-04-15 13:09:20.228
false,false,11015,10358,657,191,00:00:33.000,2025-04-15 13:09:47.257
false,false,10700,10054,646,61,00:00:30.000,2025-04-15 13:02:13.806
false,false,10733,10084,649,1095,00:00:30.000,2025-04-15 13:02:46.841
false,false,10739,10090,649,95,00:00:32.000,2025-04-15 13:02:58.855
false,false,10819,10169,650,32,00:00:32.000,2025-04-15 13:04:54.965
false,false,10862,10210,652,196,00:00:33.000,2025-04-15 13:05:56.027
false,false,10885,10230,655,126,00:00:31.000,2025-04-15 13:06:31.062
false,false,10157,9547,610,31,00:00:31.000,2025-04-15 12:50:04.068
false,false,10160,9550,610,125,00:00:31.000,2025-04-15 12:50:07.070
false,false,10192,9578,614,1134,00:00:33.000,2025-04-15 12:50:39.102
false,true,10200,9584,616,0,00:00:00.000,2025-04-15 12:50:58.119
false,false,10210,9594,616,252,00:00:31.000,2025-04-15 12:51:15.136
false,false,10213,9597,616,32,00:00:32.000,2025-04-15 12:51:24.146
false,false,11023,10365,658,30,00:00:30.000,2025-04-15 13:10:01.266
false,false,11028,10369,659,187,00:00:31.000,2025-04-15 13:10:06.270
false,true,11035,10376,659,0,00:00:00.000,2025-04-15 13:10:17.281
false,false,11042,10383,659,94,00:00:31.000,2025-04-15 13:10:32.293
false,false,11043,10384,659,127,00:00:33.000,2025-04-15 13:10:33.293
false,false,11070,10411,659,380,00:00:31.000,2025-04-15 13:11:06.325
false,false,11084,10424,660,375,00:00:30.000,2025-04-15 13:11:26.347
false,true,11176,10512,664,0,00:00:00.000,2025-04-15 13:13:29.472
false,true,11176,10512,664,0,00:00:00.000,2025-04-15 13:13:32.475
false,false,11181,10517,664,155,00:00:31.000,2025-04-15 13:13:39.482
false,false,11212,10548,664,276,00:00:31.000,2025-04-15 13:14:22.529
false,false,11221,10554,667,32,00:00:32.000,2025-04-15 13:14:37.542
false,false,11234,10567,667,440,00:00:31.000,2025-04-15 13:14:50.556
false,true,11336,10662,674,0,00:00:00.000,2025-04-15 13:16:59.689
false,false,11338,10664,674,64,00:00:33.000,2025-04-15 13:17:04.696
false,true,11338,10664,674,0,00:00:00.000,2025-04-15 13:17:07.698
false,false,11339,10665,674,30,00:00:30.000,2025-04-15 13:17:11.701
false,false,11251,10584,667,973,00:00:32.000,2025-04-15 13:15:07.574
false,true,11296,10624,672,0,00:00:00.000,2025-04-15 13:16:09.637
false,false,11298,10625,673,63,00:00:33.000,2025-04-15 13:16:12.639
false,false,11315,10641,674,601,00:00:32.000,2025-04-15 13:16:29.653
false,false,11117,10454,663,876,00:00:31.000,2025-04-15 13:12:05.386
false,true,11120,10457,663,0,00:00:00.000,2025-04-15 13:12:09.392
false,true,11120,10457,663,0,00:00:00.000,2025-04-15 13:12:13.397
false,false,11133,10470,663,61,00:00:30.000,2025-04-15 13:12:39.421
false,false,11144,10480,664,408,00:00:33.000,2025-04-15 13:12:50.432
false,false,11437,10756,681,852,00:00:31.000,2025-04-15 13:19:37.840
false,false,11538,10854,684,470,00:00:32.000,2025-04-15 13:21:42.987
false,false,11547,10862,685,753,00:00:32.000,2025-04-15 13:21:51.997
false,false,11555,10867,688,96,00:00:31.000,2025-04-15 13:22:18.025
false,false,11563,10875,688,348,00:00:33.000,2025-04-15 13:22:26.031
false,false,11569,10880,689,540,00:00:30.000,2025-04-15 13:22:32.035
false,true,11473,10791,682,0,00:00:00.000,2025-04-15 13:20:19.893
false,false,11475,10793,682,64,00:00:31.000,2025-04-15 13:20:21.897
false,false,11499,10816,683,816,00:00:30.000,2025-04-15 13:20:45.922
false,true,11499,10816,683,0,00:00:00.000,2025-04-15 13:20:46.923
false,false,11606,10917,689,217,00:00:32.000,2025-04-15 13:23:33.097
false,true,11613,10923,690,0,00:00:00.000,2025-04-15 13:23:50.114
false,false,11630,10940,690,535,00:00:32.000,2025-04-15 13:24:09.133
false,true,11640,10947,693,0,00:00:00.000,2025-04-15 13:24:21.140
false,false,11728,11031,697,64,00:00:33.000,2025-04-15 13:26:35.283
false,false,11757,11058,699,474,00:00:30.000,2025-04-15 13:27:16.321
false,false,11762,11062,700,126,00:00:30.000,2025-04-15 13:27:27.335
false,false,11773,11072,701,476,00:00:32.000,2025-04-15 13:27:38.345
false,false,11788,11087,701,941,00:00:30.000,2025-04-15 13:27:53.358
false,false,11807,11104,703,1547,00:00:32.000,2025-04-15 13:28:12.372
false,false,11808,11105,703,1579,00:00:32.000,2025-04-15 13:28:13.372
false,false,11818,11115,703,217,00:00:30.000,2025-04-15 13:28:29.393
false,true,11858,11153,705,0,00:00:00.000,2025-04-15 13:29:22.443
false,false,11862,11157,705,128,00:00:33.000,2025-04-15 13:29:37.462
false,true,11866,11161,705,0,00:00:00.000,2025-04-15 13:29:46.472
false,false,11680,10986,694,1261,00:00:30.000,2025-04-15 13:25:05.187
false,false,11708,11011,697,187,00:00:30.000,2025-04-15 13:25:57.243
false,true,11712,11015,697,0,00:00:00.000,2025-04-15 13:26:12.261
false,false,11925,11216,709,689,00:00:31.000,2025-04-15 13:31:34.590
false,false,11953,11241,712,514,00:00:33.000,2025-04-15 13:32:26.643
false,false,11960,11247,713,737,00:00:31.000,2025-04-15 13:32:33.654
false,true,11970,11256,714,0,00:00:00.000,2025-04-15 13:32:48.671
false,true,11983,11269,714,0,00:00:00.000,2025-04-15 13:33:13.699
false,false,11878,11172,706,131,00:00:33.000,2025-04-15 13:30:11.501
false,false,11882,11176,706,126,00:00:30.000,2025-04-15 13:30:21.513
false,false,11887,11180,707,281,00:00:32.000,2025-04-15 13:30:26.522
false,true,11887,11180,707,0,00:00:00.000,2025-04-15 13:30:36.532
false,false,11888,11181,707,31,00:00:31.000,2025-04-15 13:30:39.534
false,true,11893,11184,709,0,00:00:00.000,2025-04-15 13:30:49.543
false,true,11903,11194,709,0,00:00:00.000,2025-04-15 13:31:09.567
false,true,11903,11194,709,0,00:00:00.000,2025-04-15 13:31:10.568
false,false,11909,11200,709,183,00:00:30.000,2025-04-15 13:31:18.575
false,false,11910,11201,709,213,00:00:30.000,2025-04-15 13:31:19.575
false,false,11919,11210,709,500,00:00:31.000,2025-04-15 13:31:28.585
false,false,2890,2720,170,432,00:00:31.000,2025-04-14 12:37:15.632
false,false,2891,2721,170,464,00:00:32.000,2025-04-14 12:37:17.633
false,true,2891,2721,170,0,00:00:00.000,2025-04-14 12:37:21.637
false,true,2905,2735,170,0,00:00:00.000,2025-04-14 12:37:59.671
false,true,2907,2737,170,0,00:00:00.000,2025-04-14 12:38:15.689
false,true,2907,2737,170,0,00:00:00.000,2025-04-14 12:38:25.699
false,false,2917,2747,170,316,00:00:31.000,2025-04-14 12:38:45.718
false,false,2922,2752,170,474,00:00:32.000,2025-04-14 12:38:55.728
false,false,2925,2755,170,566,00:00:32.000,2025-04-14 12:39:01.733
false,false,2933,2762,171,815,00:00:33.000,2025-04-14 12:39:17.744
false,false,2940,2769,171,1041,00:00:32.000,2025-04-14 12:39:31.752
false,true,2957,2784,173,0,00:00:00.000,2025-04-14 12:40:15.778
false,true,2962,2789,173,0,00:00:00.000,2025-04-14 12:40:49.806
false,false,2971,2797,174,280,00:00:30.000,2025-04-14 12:41:09.823
false,false,2974,2800,174,65,00:00:32.000,2025-04-14 12:41:27.839
false,true,2993,2817,176,0,00:00:00.000,2025-04-14 12:42:41.904
false,false,3003,2827,176,311,00:00:30.000,2025-04-14 12:43:01.919
false,false,3024,2846,178,127,00:00:31.000,2025-04-14 12:44:07.970
false,true,3027,2849,178,0,00:00:00.000,2025-04-14 12:44:25.983
false,true,3045,2866,179,0,00:00:00.000,2025-04-14 12:45:14.020
false,false,9793,9206,587,30,00:00:30.000,2025-04-15 12:41:47.549
false,false,9807,9220,587,475,00:00:31.000,2025-04-15 12:42:01.563
false,false,9836,9245,591,1390,00:00:33.000,2025-04-15 12:42:30.593
false,true,9849,9257,592,0,00:00:00.000,2025-04-15 12:42:49.613
false,false,9851,9259,592,64,00:00:32.000,2025-04-15 12:42:57.622
false,false,9852,9260,592,94,00:00:30.000,2025-04-15 12:42:58.622
false,false,9947,9351,596,219,00:00:31.000,2025-04-15 12:45:09.753
false,true,9960,9363,597,0,00:00:00.000,2025-04-15 12:45:31.781
false,false,9962,9365,597,32,00:00:32.000,2025-04-15 12:45:42.794
false,true,9972,9374,598,0,00:00:00.000,2025-04-15 12:46:02.817
false,false,9978,9379,599,184,00:00:30.000,2025-04-15 12:46:10.825
false,false,9986,9386,600,434,00:00:31.000,2025-04-15 12:46:18.832
false,false,9993,9393,600,655,00:00:30.000,2025-04-15 12:46:25.839
false,false,10070,9466,604,156,00:00:31.000,2025-04-15 12:48:24.955
false,false,10080,9476,604,470,00:00:30.000,2025-04-15 12:48:34.965
false,false,10093,9487,606,881,00:00:33.000,2025-04-15 12:48:47.981
false,false,10099,9493,606,1072,00:00:30.000,2025-04-15 12:48:53.990
false,false,10106,9499,607,1292,00:00:30.000,2025-04-15 12:49:00.996
false,false,10123,9515,608,1829,00:00:33.000,2025-04-15 12:49:18.015
false,false,10126,9518,608,1924,00:00:30.000,2025-04-15 12:49:21.018
false,false,10127,9519,608,1955,00:00:31.000,2025-04-15 12:49:22.019
false,false,10131,9523,608,95,00:00:32.000,2025-04-15 12:49:32.030
false,false,10142,9534,608,445,00:00:31.000,2025-04-15 12:49:43.044
false,false,9869,9276,593,159,00:00:33.000,2025-04-15 12:43:27.652
false,false,9875,9282,593,347,00:00:31.000,2025-04-15 12:43:33.658
false,false,9905,9309,596,1299,00:00:31.000,2025-04-15 12:44:03.692
false,false,9906,9310,596,1330,00:00:31.000,2025-04-15 12:44:04.693
false,true,9912,9316,596,0,00:00:00.000,2025-04-15 12:44:13.700
false,false,9726,9143,583,284,00:00:30.000,2025-04-15 12:40:10.461
false,true,9728,9145,583,0,00:00:00.000,2025-04-15 12:40:17.468
false,false,9733,9150,583,156,00:00:30.000,2025-04-15 12:40:23.473
false,false,9736,9153,583,247,00:00:30.000,2025-04-15 12:40:26.475
false,false,9745,9162,583,525,00:00:30.000,2025-04-15 12:40:35.481
false,true,9748,9165,583,0,00:00:00.000,2025-04-15 12:40:42.488
false,false,9778,9192,586,699,00:00:31.000,2025-04-15 12:41:26.528
false,false,10000,9400,600,874,00:00:31.000,2025-04-15 12:46:32.845
false,false,10008,9407,601,1128,00:00:32.000,2025-04-15 12:46:40.851
false,true,10012,9410,602,0,00:00:00.000,2025-04-15 12:46:47.857
false,false,10019,9417,602,191,00:00:33.000,2025-04-15 12:47:03.871
false,false,10029,9426,603,65,00:00:33.000,2025-04-15 12:47:25.896
false,false,10042,9439,603,476,00:00:32.000,2025-04-15 12:47:38.910
false,false,10045,9442,603,572,00:00:33.000,2025-04-15 12:47:41.914
false,true,10047,9444,603,0,00:00:00.000,2025-04-15 12:47:45.917
false,false,10246,9628,618,721,00:00:32.000,2025-04-15 12:52:03.188
false,false,10252,9634,618,911,00:00:30.000,2025-04-15 12:52:09.194
false,false,10257,9639,618,1072,00:00:32.000,2025-04-15 12:52:14.200
false,false,10266,9648,618,1354,00:00:32.000,2025-04-15 12:52:23.210
false,true,10423,9796,627,0,00:00:00.000,2025-04-15 12:55:54.422
false,true,10424,9797,627,0,00:00:00.000,2025-04-15 12:56:04.434
false,false,10427,9800,627,95,00:00:31.000,2025-04-15 12:56:10.439
false,false,10430,9802,628,190,00:00:30.000,2025-04-15 12:56:13.442
false,false,10445,9816,629,375,00:00:31.000,2025-04-15 12:56:34.463
false,false,10454,9824,630,122,00:00:31.000,2025-04-15 12:56:49.481
false,false,10462,9831,631,376,00:00:32.000,2025-04-15 12:56:57.488
false,false,10487,9854,633,1171,00:00:31.000,2025-04-15 12:57:22.515
false,false,10495,9862,633,1417,00:00:30.000,2025-04-15 12:57:30.522
false,false,10505,9872,633,1725,00:00:30.000,2025-04-15 12:57:40.534
false,false,10509,9876,633,63,00:00:33.000,2025-04-15 12:57:50.545
false,false,10511,9878,633,126,00:00:33.000,2025-04-15 12:57:52.549
false,true,10559,9922,637,0,00:00:00.000,2025-04-15 12:59:06.623
false,false,10316,9694,622,1028,00:00:30.000,2025-04-15 12:53:19.267
false,false,10336,9713,623,93,00:00:30.000,2025-04-15 12:53:45.293
false,false,10352,9728,624,595,00:00:33.000,2025-04-15 12:54:01.309
false,true,10366,9742,624,0,00:00:00.000,2025-04-15 12:54:27.337
false,false,10376,9751,625,284,00:00:32.000,2025-04-15 12:54:43.353
false,false,10379,9754,625,379,00:00:32.000,2025-04-15 12:54:46.357
false,true,10599,9959,640,0,00:00:00.000,2025-04-15 12:59:54.674
false,false,10618,9976,642,595,00:00:32.000,2025-04-15 13:00:15.693
false,true,10637,9995,642,0,00:00:00.000,2025-04-15 13:00:35.713
false,true,10637,9995,642,0,00:00:00.000,2025-04-15 13:00:37.716
false,false,10654,10011,643,30,00:00:30.000,2025-04-15 13:01:09.749
false,false,10748,10099,649,95,00:00:33.000,2025-04-15 13:03:13.866
false,false,10753,10104,649,252,00:00:32.000,2025-04-15 13:03:18.869
false,true,10760,10111,649,0,00:00:00.000,2025-04-15 13:03:31.880
false,false,10773,10124,649,412,00:00:30.000,2025-04-15 13:03:44.894
false,true,10801,10151,650,0,00:00:00.000,2025-04-15 13:04:27.940
false,false,10809,10159,650,247,00:00:30.000,2025-04-15 13:04:38.950
false,false,10818,10168,650,533,00:00:30.000,2025-04-15 13:04:47.957
false,false,10900,10245,655,96,00:00:33.000,2025-04-15 13:06:52.082
false,true,10905,10250,655,0,00:00:00.000,2025-04-15 13:07:00.091
false,false,10911,10256,655,194,00:00:33.000,2025-04-15 13:07:09.101
false,true,10924,10268,656,0,00:00:00.000,2025-04-15 13:07:24.117
false,false,10925,10269,656,30,00:00:30.000,2025-04-15 13:07:29.121
false,false,10937,10280,657,405,00:00:32.000,2025-04-15 13:07:41.133
false,true,10991,10334,657,0,00:00:00.000,2025-04-15 13:09:08.218
false,false,11007,10350,657,441,00:00:30.000,2025-04-15 13:09:33.241
false,false,10671,10028,643,312,00:00:31.000,2025-04-15 13:01:32.767
false,false,10683,10039,644,385,00:00:33.000,2025-04-15 13:01:50.786
false,false,10685,10041,644,448,00:00:33.000,2025-04-15 13:01:52.787
false,false,10702,10056,646,124,00:00:33.000,2025-04-15 13:02:15.808
false,false,10716,10069,647,562,00:00:33.000,2025-04-15 13:02:29.819
false,false,10732,10083,649,1065,00:00:33.000,2025-04-15 13:02:45.840
false,true,10745,10096,649,0,00:00:00.000,2025-04-15 13:03:07.862
false,false,10826,10176,650,251,00:00:33.000,2025-04-15 13:05:01.971
false,false,10836,10185,651,95,00:00:32.000,2025-04-15 13:05:17.989
false,false,10841,10190,651,258,00:00:31.000,2025-04-15 13:05:22.993
false,false,10846,10195,651,94,00:00:30.000,2025-04-15 13:05:34.002
false,true,10856,10204,652,0,00:00:00.000,2025-04-15 13:05:49.018
false,false,10865,10213,652,31,00:00:31.000,2025-04-15 13:06:05.036
false,true,10156,9547,609,0,00:00:00.000,2025-04-15 12:50:00.063
false,false,10161,9551,610,156,00:00:31.000,2025-04-15 12:50:08.071
false,false,10178,9567,611,695,00:00:33.000,2025-04-15 12:50:25.087
false,false,10186,9575,611,943,00:00:31.000,2025-04-15 12:50:33.096
false,false,10188,9576,612,1006,00:00:32.000,2025-04-15 12:50:35.098
false,false,10196,9580,616,1256,00:00:31.000,2025-04-15 12:50:43.107
false,true,10196,9580,616,0,00:00:00.000,2025-04-15 12:50:49.112
false,false,10198,9582,616,63,00:00:32.000,2025-04-15 12:50:51.114
false,false,10201,9585,616,30,00:00:30.000,2025-04-15 12:51:00.120
false,false,10215,9599,616,93,00:00:30.000,2025-04-15 12:51:26.147
false,true,11022,10365,657,0,00:00:00.000,2025-04-15 13:09:58.264
false,false,11063,10404,659,162,00:00:32.000,2025-04-15 13:10:59.321
false,false,11080,10421,659,250,00:00:33.000,2025-04-15 13:11:22.345
false,false,11089,10429,660,532,00:00:32.000,2025-04-15 13:11:31.350
false,true,11176,10512,664,0,00:00:00.000,2025-04-15 13:13:33.477
false,false,11194,10530,664,566,00:00:33.000,2025-04-15 13:13:52.497
false,true,11203,10539,664,0,00:00:00.000,2025-04-15 13:14:10.517
false,true,11203,10539,664,0,00:00:00.000,2025-04-15 13:14:13.520
false,false,11227,10560,667,225,00:00:32.000,2025-04-15 13:14:43.550
false,false,11321,10647,674,787,00:00:30.000,2025-04-15 13:16:35.660
false,false,11325,10651,674,911,00:00:33.000,2025-04-15 13:16:39.664
false,true,11329,10655,674,0,00:00:00.000,2025-04-15 13:16:46.673
false,true,11338,10664,674,0,00:00:00.000,2025-04-15 13:17:06.697
false,true,11353,10679,674,0,00:00:00.000,2025-04-15 13:17:33.722
false,false,11374,10700,674,163,00:00:33.000,2025-04-15 13:18:04.756
false,true,11380,10706,674,0,00:00:00.000,2025-04-15 13:18:12.763
false,false,11237,10570,667,533,00:00:33.000,2025-04-15 13:14:53.558
false,false,11246,10579,667,813,00:00:33.000,2025-04-15 13:15:02.569
false,false,11248,10581,667,877,00:00:32.000,2025-04-15 13:15:04.570
false,false,11264,10597,667,1380,00:00:31.000,2025-04-15 13:15:20.589
false,false,11273,10606,667,1663,00:00:31.000,2025-04-15 13:15:29.597
false,true,11277,10610,667,0,00:00:00.000,2025-04-15 13:15:34.602
false,true,11279,10611,668,0,00:00:00.000,2025-04-15 13:15:44.613
false,false,11293,10622,671,441,00:00:31.000,2025-04-15 13:16:01.629
false,false,11304,10631,673,253,00:00:32.000,2025-04-15 13:16:18.645
false,false,11307,10634,673,346,00:00:31.000,2025-04-15 13:16:21.648
false,false,11309,10635,674,410,00:00:32.000,2025-04-15 13:16:23.649
false,false,11312,10638,674,504,00:00:31.000,2025-04-15 13:16:26.651
false,false,11091,10429,662,63,00:00:33.000,2025-04-15 13:11:39.357
false,false,11100,10437,663,344,00:00:30.000,2025-04-15 13:11:48.365
false,true,11120,10457,663,0,00:00:00.000,2025-04-15 13:12:10.393
false,false,11139,10476,663,248,00:00:31.000,2025-04-15 13:12:45.428
false,false,11149,10485,664,567,00:00:33.000,2025-04-15 13:12:55.439
false,false,11392,10717,675,131,00:00:33.000,2025-04-15 13:18:34.783
false,false,11393,10718,675,163,00:00:32.000,2025-04-15 13:18:35.784
false,false,11396,10720,676,255,00:00:30.000,2025-04-15 13:18:38.787
false,true,11410,10729,681,0,00:00:00.000,2025-04-15 13:19:07.810
false,false,11541,10857,684,565,00:00:30.000,2025-04-15 13:21:45.991
false,false,11544,10860,684,660,00:00:30.000,2025-04-15 13:21:48.994
false,false,11546,10862,684,721,00:00:31.000,2025-04-15 13:21:50.996
false,true,11549,10863,686,0,00:00:00.000,2025-04-15 13:22:01.006
false,false,11552,10864,688,93,00:00:33.000,2025-04-15 13:22:09.014
false,false,11553,10865,688,33,00:00:33.000,2025-04-15 13:22:16.022
false,true,11572,10883,689,0,00:00:00.000,2025-04-15 13:22:37.041
false,false,11574,10885,689,62,00:00:31.000,2025-04-15 13:22:43.046
false,true,11588,10899,689,0,00:00:00.000,2025-04-15 13:22:58.061
false,false,11590,10901,689,61,00:00:31.000,2025-04-15 13:23:05.068
false,false,11594,10905,689,188,00:00:33.000,2025-04-15 13:23:09.070
false,false,11595,10906,689,218,00:00:30.000,2025-04-15 13:23:10.071
false,false,11464,10782,682,1711,00:00:32.000,2025-04-15 13:20:04.873
false,true,11473,10791,682,0,00:00:00.000,2025-04-15 13:20:16.889
false,false,11491,10808,683,563,00:00:30.000,2025-04-15 13:20:37.912
false,true,11523,10840,683,0,00:00:00.000,2025-04-15 13:21:24.967
false,true,11523,10840,683,0,00:00:00.000,2025-04-15 13:21:27.972
false,true,11598,10909,689,0,00:00:00.000,2025-04-15 13:23:16.076
false,false,11648,10955,693,253,00:00:31.000,2025-04-15 13:24:33.153
false,false,11649,10956,693,286,00:00:33.000,2025-04-15 13:24:34.154
false,false,11735,11037,698,125,00:00:30.000,2025-04-15 13:26:48.298
false,false,11737,11039,698,189,00:00:33.000,2025-04-15 13:26:50.300
false,false,11741,11043,698,317,00:00:32.000,2025-04-15 13:26:54.303
false,true,11758,11058,700,0,00:00:00.000,2025-04-15 13:27:20.327
false,false,11789,11088,701,972,00:00:31.000,2025-04-15 13:27:54.359
false,false,11793,11092,701,1102,00:00:33.000,2025-04-15 13:27:58.364
false,false,11823,11119,704,373,00:00:31.000,2025-04-15 13:28:34.400
false,false,11825,11121,704,438,00:00:32.000,2025-04-15 13:28:36.402
false,false,11828,11124,704,532,00:00:30.000,2025-04-15 13:28:39.403
false,false,11835,11131,704,749,00:00:32.000,2025-04-15 13:28:46.409
false,false,11837,11133,704,813,00:00:32.000,2025-04-15 13:28:48.411
false,false,11858,11153,705,125,00:00:30.000,2025-04-15 13:29:21.441
false,false,11681,10987,694,1293,00:00:32.000,2025-04-15 13:25:06.188
false,false,11687,10992,695,30,00:00:30.000,2025-04-15 13:25:24.206
false,false,11695,10999,696,283,00:00:33.000,2025-04-15 13:25:32.212
false,true,11696,10999,697,0,00:00:00.000,2025-04-15 13:25:36.218
false,false,11710,11013,697,253,00:00:33.000,2025-04-15 13:25:59.245
false,false,11721,11024,697,280,00:00:30.000,2025-04-15 13:26:22.272
false,true,11932,11223,709,0,00:00:00.000,2025-04-15 13:31:48.605
false,true,11970,11256,714,0,00:00:00.000,2025-04-15 13:32:45.668
false,false,11911,11202,709,243,00:00:30.000,2025-04-15 13:31:20.576
false,false,11913,11204,709,308,00:00:32.000,2025-04-15 13:31:22.577
false,false,2892,2722,170,33,00:00:33.000,2025-04-14 12:37:31.645
false,false,2919,2749,170,378,00:00:32.000,2025-04-14 12:38:49.721
false,false,2923,2753,170,504,00:00:30.000,2025-04-14 12:38:57.730
false,false,2924,2754,170,534,00:00:30.000,2025-04-14 12:38:59.732
false,false,2948,2777,171,1301,00:00:33.000,2025-04-14 12:39:47.760
false,false,2949,2778,171,1333,00:00:32.000,2025-04-14 12:39:49.762
false,false,2961,2788,173,126,00:00:32.000,2025-04-14 12:40:25.784
false,true,2962,2789,173,0,00:00:00.000,2025-04-14 12:40:31.790
false,true,2962,2789,173,0,00:00:00.000,2025-04-14 12:40:45.801
false,false,2988,2812,176,31,00:00:31.000,2025-04-14 12:42:07.873
false,true,2990,2814,176,0,00:00:00.000,2025-04-14 12:42:23.889
false,true,3018,2841,177,0,00:00:00.000,2025-04-14 12:43:43.954
false,false,3026,2848,178,189,00:00:30.000,2025-04-14 12:44:11.975
false,true,9792,9205,587,0,00:00:00.000,2025-04-15 12:41:41.542
false,false,9798,9211,587,191,00:00:33.000,2025-04-15 12:41:52.555
false,false,9811,9223,588,602,00:00:32.000,2025-04-15 12:42:05.565
false,false,9815,9227,588,731,00:00:33.000,2025-04-15 12:42:09.569
false,false,9939,9343,596,63,00:00:31.000,2025-04-15 12:44:55.736
false,true,9960,9363,597,0,00:00:00.000,2025-04-15 12:45:30.778
false,false,9961,9364,597,30,00:00:30.000,2025-04-15 12:45:35.784
false,false,9963,9365,598,64,00:00:32.000,2025-04-15 12:45:43.795
false,true,9972,9374,598,0,00:00:00.000,2025-04-15 12:46:00.814
false,false,9981,9382,599,278,00:00:32.000,2025-04-15 12:46:13.828
false,false,9991,9391,600,592,00:00:33.000,2025-04-15 12:46:23.837
false,false,10097,9491,606,1010,00:00:31.000,2025-04-15 12:48:51.987
false,false,10103,9496,607,1196,00:00:31.000,2025-04-15 12:48:57.993
false,false,10119,9511,608,1701,00:00:33.000,2025-04-15 12:49:14.010
false,true,10128,9520,608,0,00:00:00.000,2025-04-15 12:49:24.023
false,false,9867,9274,593,95,00:00:30.000,2025-04-15 12:43:25.649
false,false,9872,9279,593,253,00:00:32.000,2025-04-15 12:43:30.653
false,false,9874,9281,593,316,00:00:31.000,2025-04-15 12:43:32.657
false,false,9885,9291,594,662,00:00:33.000,2025-04-15 12:43:43.669
false,false,9921,9325,596,286,00:00:33.000,2025-04-15 12:44:25.709
false,false,9933,9337,596,194,00:00:32.000,2025-04-15 12:44:43.726
false,true,9717,9134,583,0,00:00:00.000,2025-04-15 12:39:57.450
false,false,9738,9155,583,310,00:00:31.000,2025-04-15 12:40:28.476
false,true,9748,9165,583,0,00:00:00.000,2025-04-15 12:40:40.485
false,false,9757,9173,584,33,00:00:33.000,2025-04-15 12:41:05.508
false,false,9763,9178,585,224,00:00:32.000,2025-04-15 12:41:11.514
false,false,9775,9189,586,604,00:00:32.000,2025-04-15 12:41:23.525
false,false,10007,9406,601,1096,00:00:32.000,2025-04-15 12:46:39.851
false,true,10024,9421,603,0,00:00:00.000,2025-04-15 12:47:11.881
false,false,10051,9448,603,122,00:00:31.000,2025-04-15 12:47:53.925
false,false,10052,9449,603,153,00:00:31.000,2025-04-15 12:47:54.926
false,false,10227,9610,617,126,00:00:31.000,2025-04-15 12:51:44.166
false,false,10228,9611,617,156,00:00:30.000,2025-04-15 12:51:45.166
false,false,10260,9642,618,1166,00:00:32.000,2025-04-15 12:52:17.205
false,false,10277,9658,619,1702,00:00:30.000,2025-04-15 12:52:34.224
false,false,10295,9675,620,380,00:00:31.000,2025-04-15 12:52:58.247
false,false,10299,9678,621,502,00:00:31.000,2025-04-15 12:53:02.250
false,false,10308,9687,621,779,00:00:31.000,2025-04-15 12:53:11.259
false,true,10381,9756,625,0,00:00:00.000,2025-04-15 12:54:52.366
false,false,10391,9765,626,320,00:00:33.000,2025-04-15 12:55:04.379
false,false,10399,9772,627,571,00:00:33.000,2025-04-15 12:55:12.386
false,false,10401,9774,627,634,00:00:31.000,2025-04-15 12:55:14.389
false,false,10422,9795,627,93,00:00:31.000,2025-04-15 12:55:47.418
false,false,10429,9802,627,160,00:00:32.000,2025-04-15 12:56:12.440
false,false,10434,9805,629,32,00:00:32.000,2025-04-15 12:56:23.454
false,false,10437,9808,629,123,00:00:31.000,2025-04-15 12:56:26.455
false,false,10442,9813,629,281,00:00:32.000,2025-04-15 12:56:31.458
false,false,10470,9839,631,632,00:00:30.000,2025-04-15 12:57:05.496
false,false,10494,9861,633,1387,00:00:30.000,2025-04-15 12:57:29.520
false,false,10520,9886,634,157,00:00:33.000,2025-04-15 12:58:07.567
false,false,10521,9887,634,187,00:00:30.000,2025-04-15 12:58:08.568
false,false,10526,9891,635,349,00:00:33.000,2025-04-15 12:58:13.573
false,true,10527,9892,635,0,00:00:00.000,2025-04-15 12:58:19.579
false,false,10535,9900,635,254,00:00:32.000,2025-04-15 12:58:28.586
false,false,10543,9907,636,126,00:00:30.000,2025-04-15 12:58:42.598
false,false,10572,9935,637,410,00:00:30.000,2025-04-15 12:59:23.643
false,false,10583,9946,637,756,00:00:31.000,2025-04-15 12:59:34.651
false,false,10595,9955,640,1135,00:00:31.000,2025-04-15 12:59:46.666
false,false,10599,9959,640,1261,00:00:32.000,2025-04-15 12:59:50.669
false,false,10317,9695,622,1060,00:00:32.000,2025-04-15 12:53:20.270
false,false,10322,9700,622,1213,00:00:31.000,2025-04-15 12:53:25.274
false,false,10343,9720,623,313,00:00:32.000,2025-04-15 12:53:52.301
false,false,10351,9727,624,562,00:00:30.000,2025-04-15 12:54:00.309
false,false,10356,9732,624,719,00:00:30.000,2025-04-15 12:54:05.313
false,true,10357,9733,624,0,00:00:00.000,2025-04-15 12:54:11.319
false,false,10366,9742,624,281,00:00:31.000,2025-04-15 12:54:21.329
false,false,10601,9961,640,63,00:00:31.000,2025-04-15 12:59:58.678
false,false,10628,9986,642,911,00:00:32.000,2025-04-15 13:00:25.703
false,false,10635,9993,642,1134,00:00:33.000,2025-04-15 13:00:32.710
false,true,10653,10010,643,0,00:00:00.000,2025-04-15 13:00:57.734
false,false,10765,10116,649,156,00:00:31.000,2025-04-15 13:03:36.885
false,false,10771,10122,649,352,00:00:33.000,2025-04-15 13:03:42.892
false,false,10797,10147,650,596,00:00:31.000,2025-04-15 13:04:20.931
false,false,10806,10156,650,156,00:00:33.000,2025-04-15 13:04:35.946
false,false,10926,10270,656,61,00:00:31.000,2025-04-15 13:07:30.121
false,false,10928,10272,656,126,00:00:32.000,2025-04-15 13:07:32.123
false,false,10931,10275,656,219,00:00:32.000,2025-04-15 13:07:35.127
false,false,10942,10285,657,560,00:00:33.000,2025-04-15 13:07:46.140
false,false,10944,10287,657,624,00:00:32.000,2025-04-15 13:07:48.142
false,true,10960,10303,657,0,00:00:00.000,2025-04-15 13:08:09.161
false,false,10961,10304,657,31,00:00:31.000,2025-04-15 13:08:11.163
false,false,10964,10307,657,127,00:00:33.000,2025-04-15 13:08:14.166
false,true,10974,10317,657,0,00:00:00.000,2025-04-15 13:08:31.186
false,true,10975,10318,657,0,00:00:00.000,2025-04-15 13:08:43.194
false,false,11002,10345,657,285,00:00:32.000,2025-04-15 13:09:28.235
false,false,11003,10346,657,317,00:00:32.000,2025-04-15 13:09:29.236
false,false,11004,10347,657,350,00:00:33.000,2025-04-15 13:09:30.237
false,true,11009,10352,657,0,00:00:00.000,2025-04-15 13:09:38.245
false,true,11009,10352,657,0,00:00:00.000,2025-04-15 13:09:40.247
false,false,11011,10354,657,65,00:00:33.000,2025-04-15 13:09:43.251
false,false,11016,10359,657,222,00:00:31.000,2025-04-15 13:09:48.258
false,true,10671,10028,643,0,00:00:00.000,2025-04-15 13:01:34.770
false,false,10678,10034,644,225,00:00:31.000,2025-04-15 13:01:45.780
false,true,10698,10052,646,0,00:00:00.000,2025-04-15 13:02:06.797
false,false,10708,10062,646,310,00:00:30.000,2025-04-15 13:02:21.813
false,false,10727,10078,649,905,00:00:31.000,2025-04-15 13:02:40.833
false,false,10829,10179,650,344,00:00:32.000,2025-04-15 13:05:04.974
false,true,10864,10212,652,0,00:00:00.000,2025-04-15 13:06:04.035
false,false,10199,9583,616,94,00:00:31.000,2025-04-15 12:50:52.114
false,false,10204,9588,616,61,00:00:30.000,2025-04-15 12:51:09.126
false,false,10205,9589,616,94,00:00:33.000,2025-04-15 12:51:10.128
false,false,10207,9591,616,158,00:00:33.000,2025-04-15 12:51:12.133
false,false,10212,9596,616,315,00:00:33.000,2025-04-15 12:51:17.138
false,false,10214,9598,616,63,00:00:31.000,2025-04-15 12:51:25.146
false,true,11022,10365,657,0,00:00:00.000,2025-04-15 13:09:57.264
false,true,11035,10376,659,0,00:00:00.000,2025-04-15 13:10:19.283
false,false,11048,10389,659,284,00:00:30.000,2025-04-15 13:10:38.300
false,false,11049,10390,659,316,00:00:32.000,2025-04-15 13:10:39.301
false,false,11079,10420,659,217,00:00:30.000,2025-04-15 13:11:21.343
false,false,11087,10427,660,467,00:00:30.000,2025-04-15 13:11:29.348
false,false,11162,10498,664,313,00:00:31.000,2025-04-15 13:13:14.459
false,false,11166,10502,664,439,00:00:30.000,2025-04-15 13:13:18.460
false,true,11176,10512,664,0,00:00:00.000,2025-04-15 13:13:34.480
false,true,11196,10532,664,0,00:00:00.000,2025-04-15 13:13:57.502
false,false,11211,10547,664,245,00:00:31.000,2025-04-15 13:14:21.528
false,true,11220,10553,667,0,00:00:00.000,2025-04-15 13:14:36.542
false,false,11224,10557,667,129,00:00:33.000,2025-04-15 13:14:40.546
false,false,11228,10561,667,256,00:00:31.000,2025-04-15 13:14:44.550
false,false,11236,10569,667,500,00:00:30.000,2025-04-15 13:14:52.558
false,false,11335,10661,674,192,00:00:33.000,2025-04-15 13:16:55.685
false,false,11362,10688,674,276,00:00:30.000,2025-04-15 13:17:46.740
false,false,11377,10703,674,254,00:00:30.000,2025-04-15 13:18:07.759
false,false,11240,10573,667,626,00:00:32.000,2025-04-15 13:14:56.562
false,false,11243,10576,667,717,00:00:31.000,2025-04-15 13:14:59.565
false,false,11258,10591,667,1189,00:00:33.000,2025-04-15 13:15:14.581
false,false,11259,10592,667,1222,00:00:33.000,2025-04-15 13:15:15.583
false,false,11294,10623,671,472,00:00:31.000,2025-04-15 13:16:02.630
false,false,11295,10624,671,505,00:00:33.000,2025-04-15 13:16:03.630
false,false,11308,10635,673,378,00:00:32.000,2025-04-15 13:16:22.648
false,false,11101,10438,663,375,00:00:31.000,2025-04-15 13:11:49.367
false,false,11118,10455,663,906,00:00:30.000,2025-04-15 13:12:06.386
false,true,11120,10457,663,0,00:00:00.000,2025-04-15 13:12:11.394
false,true,11121,10458,663,0,00:00:00.000,2025-04-15 13:12:19.403
false,false,11122,10459,663,32,00:00:32.000,2025-04-15 13:12:22.406
false,false,11128,10465,663,222,00:00:33.000,2025-04-15 13:12:28.414
false,false,11146,10482,664,469,00:00:30.000,2025-04-15 13:12:52.435
false,false,11160,10496,664,251,00:00:31.000,2025-04-15 13:13:12.456
false,false,11390,10715,675,66,00:00:33.000,2025-04-15 13:18:32.783
false,false,11395,10720,675,225,00:00:31.000,2025-04-15 13:18:37.785
false,false,11413,10732,681,93,00:00:32.000,2025-04-15 13:19:13.816
false,false,11421,10740,681,347,00:00:30.000,2025-04-15 13:19:21.822
false,false,11446,10765,681,1138,00:00:33.000,2025-04-15 13:19:46.851
false,false,11535,10851,684,377,00:00:30.000,2025-04-15 13:21:39.985
false,true,11572,10883,689,0,00:00:00.000,2025-04-15 13:22:39.042
false,true,11572,10883,689,0,00:00:00.000,2025-04-15 13:22:40.043
false,false,11573,10884,689,31,00:00:31.000,2025-04-15 13:22:42.045
false,false,11589,10900,689,30,00:00:30.000,2025-04-15 13:23:04.068
false,false,11593,10904,689,155,00:00:30.000,2025-04-15 13:23:08.070
false,false,11511,10828,683,378,00:00:33.000,2025-04-15 13:21:03.945
false,false,11514,10831,683,95,00:00:33.000,2025-04-15 13:21:12.952
false,true,11598,10909,689,0,00:00:00.000,2025-04-15 13:23:18.079
false,true,11599,10910,689,0,00:00:00.000,2025-04-15 13:23:26.089
false,false,11618,10928,690,159,00:00:33.000,2025-04-15 13:23:57.121
false,false,11619,10929,690,192,00:00:33.000,2025-04-15 13:23:58.122
false,false,11731,11034,697,163,00:00:33.000,2025-04-15 13:26:38.286
false,false,11744,11046,698,64,00:00:31.000,2025-04-15 13:27:03.312
false,false,11791,11090,701,1036,00:00:32.000,2025-04-15 13:27:56.362
false,true,11811,11108,703,0,00:00:00.000,2025-04-15 13:28:22.384
false,false,11815,11112,703,124,00:00:30.000,2025-04-15 13:28:26.390
false,false,11826,11122,704,470,00:00:32.000,2025-04-15 13:28:37.402
false,true,11858,11153,705,0,00:00:00.000,2025-04-15 13:29:31.454
false,false,11863,11158,705,159,00:00:31.000,2025-04-15 13:29:38.463
false,false,11864,11159,705,191,00:00:32.000,2025-04-15 13:29:39.465
false,false,11867,11162,705,31,00:00:31.000,2025-04-15 13:29:48.474
false,true,11867,11162,705,0,00:00:00.000,2025-04-15 13:29:50.477
false,false,11701,11004,697,159,00:00:32.000,2025-04-15 13:25:44.227
false,true,11702,11005,697,0,00:00:00.000,2025-04-15 13:25:48.232
false,true,11726,11029,697,0,00:00:00.000,2025-04-15 13:26:29.277
false,false,11931,11222,709,876,00:00:32.000,2025-04-15 13:31:40.597
false,false,11965,11252,713,896,00:00:33.000,2025-04-15 13:32:38.659
false,false,11884,11178,706,187,00:00:31.000,2025-04-15 13:30:23.516
false,true,11893,11184,709,0,00:00:00.000,2025-04-15 13:30:45.541
false,true,2891,2721,170,0,00:00:00.000,2025-04-14 12:37:23.638
false,false,2900,2730,170,283,00:00:31.000,2025-04-14 12:37:47.661
false,true,2905,2735,170,0,00:00:00.000,2025-04-14 12:38:05.678
false,true,2905,2735,170,0,00:00:00.000,2025-04-14 12:38:07.681
false,false,2913,2743,170,191,00:00:32.000,2025-04-14 12:38:37.711
false,false,2934,2763,171,847,00:00:32.000,2025-04-14 12:39:19.744
false,false,2953,2781,172,1458,00:00:32.000,2025-04-14 12:39:57.766
false,false,2955,2782,173,1521,00:00:30.000,2025-04-14 12:40:01.767
false,false,2960,2787,173,94,00:00:33.000,2025-04-14 12:40:23.783
false,true,2990,2814,176,0,00:00:00.000,2025-04-14 12:42:17.883
false,false,3013,2837,176,629,00:00:32.000,2025-04-14 12:43:21.935
false,false,3015,2838,177,692,00:00:33.000,2025-04-14 12:43:25.939
false,true,3018,2841,177,0,00:00:00.000,2025-04-14 12:43:37.950
false,true,3018,2841,177,0,00:00:00.000,2025-04-14 12:43:41.953
false,false,3041,2862,179,446,00:00:32.000,2025-04-14 12:44:54.000
false,false,3045,2866,179,574,00:00:32.000,2025-04-14 12:45:02.009
false,false,9784,9198,586,889,00:00:32.000,2025-04-15 12:41:32.532
false,true,9849,9257,592,0,00:00:00.000,2025-04-15 12:42:51.614
false,true,9852,9260,592,0,00:00:00.000,2025-04-15 12:43:01.624
false,true,9937,9341,596,0,00:00:00.000,2025-04-15 12:44:53.735
false,true,9940,9344,596,0,00:00:00.000,2025-04-15 12:45:00.742
false,false,9942,9346,596,61,00:00:30.000,2025-04-15 12:45:04.747
false,false,9943,9347,596,92,00:00:31.000,2025-04-15 12:45:05.749
false,false,9959,9363,596,157,00:00:32.000,2025-04-15 12:45:27.777
false,true,9960,9363,597,0,00:00:00.000,2025-04-15 12:45:29.777
false,false,9965,9367,598,129,00:00:32.000,2025-04-15 12:45:45.796
false,false,9972,9374,598,33,00:00:33.000,2025-04-15 12:45:58.813
false,false,9995,9395,600,718,00:00:33.000,2025-04-15 12:46:27.841
false,false,10077,9473,604,378,00:00:32.000,2025-04-15 12:48:31.961
false,false,10096,9490,606,979,00:00:33.000,2025-04-15 12:48:50.985
false,false,9876,9283,593,378,00:00:31.000,2025-04-15 12:43:34.659
false,false,9909,9313,596,1425,00:00:31.000,2025-04-15 12:44:07.696
false,false,9936,9340,596,288,00:00:32.000,2025-04-15 12:44:46.729
false,false,9718,9135,583,32,00:00:32.000,2025-04-15 12:40:02.454
false,true,9728,9145,583,0,00:00:00.000,2025-04-15 12:40:13.465
false,false,9748,9165,583,619,00:00:31.000,2025-04-15 12:40:38.484
false,true,9748,9165,583,0,00:00:00.000,2025-04-15 12:40:39.485
false,false,9751,9167,584,96,00:00:33.000,2025-04-15 12:40:47.492
false,false,9761,9176,585,160,00:00:33.000,2025-04-15 12:41:09.512
false,false,9762,9177,585,192,00:00:32.000,2025-04-15 12:41:10.513
false,false,9764,9179,585,256,00:00:32.000,2025-04-15 12:41:12.515
false,false,9769,9184,585,413,00:00:32.000,2025-04-15 12:41:17.518
false,false,9779,9193,586,731,00:00:32.000,2025-04-15 12:41:27.529
false,false,10001,9401,600,904,00:00:30.000,2025-04-15 12:46:33.846
false,false,10040,9437,603,412,00:00:31.000,2025-04-15 12:47:36.910
false,false,10059,9455,604,97,00:00:33.000,2025-04-15 12:48:07.938
false,false,10259,9641,618,1134,00:00:31.000,2025-04-15 12:52:16.203
false,false,10262,9644,618,1228,00:00:30.000,2025-04-15 12:52:19.205
false,false,10271,9653,618,1515,00:00:31.000,2025-04-15 12:52:28.216
false,true,10283,9664,619,0,00:00:00.000,2025-04-15 12:52:45.236
false,false,10287,9667,620,123,00:00:30.000,2025-04-15 12:52:50.241
false,false,10411,9784,627,951,00:00:32.000,2025-04-15 12:55:24.398
false,true,10412,9785,627,0,00:00:00.000,2025-04-15 12:55:29.401
false,true,10419,9792,627,0,00:00:00.000,2025-04-15 12:55:40.410
false,true,10419,9792,627,0,00:00:00.000,2025-04-15 12:55:41.411
false,false,10448,9819,629,466,00:00:30.000,2025-04-15 12:56:37.467
false,false,10450,9820,630,528,00:00:32.000,2025-04-15 12:56:39.469
false,true,10450,9820,630,0,00:00:00.000,2025-04-15 12:56:44.475
false,false,10459,9829,630,280,00:00:32.000,2025-04-15 12:56:54.486
false,false,10460,9829,631,312,00:00:32.000,2025-04-15 12:56:55.486
false,false,10461,9830,631,344,00:00:32.000,2025-04-15 12:56:56.487
false,false,10467,9836,631,536,00:00:32.000,2025-04-15 12:57:02.493
false,false,10500,9867,633,1574,00:00:33.000,2025-04-15 12:57:35.526
false,true,10333,9710,623,0,00:00:00.000,2025-04-15 12:53:40.289
false,true,10599,9959,640,0,00:00:00.000,2025-04-15 12:59:52.672
false,false,10615,9974,641,500,00:00:30.000,2025-04-15 13:00:12.691
false,false,10622,9980,642,721,00:00:31.000,2025-04-15 13:00:19.697
false,true,10637,9995,642,0,00:00:00.000,2025-04-15 13:00:38.717
false,false,10646,10003,643,284,00:00:32.000,2025-04-15 13:00:49.729
false,false,10653,10010,643,504,00:00:30.000,2025-04-15 13:00:56.734
false,true,10653,10010,643,0,00:00:00.000,2025-04-15 13:01:02.740
false,false,10657,10014,643,124,00:00:31.000,2025-04-15 13:01:12.751
false,false,10749,10100,649,126,00:00:31.000,2025-04-15 13:03:14.867
false,false,10755,10106,649,314,00:00:32.000,2025-04-15 13:03:20.871
false,false,10756,10107,649,347,00:00:33.000,2025-04-15 13:03:21.871
false,true,10760,10111,649,0,00:00:00.000,2025-04-15 13:03:30.878
false,false,10795,10145,650,534,00:00:31.000,2025-04-15 13:04:18.929
false,false,10796,10146,650,565,00:00:31.000,2025-04-15 13:04:19.929
false,false,10800,10150,650,693,00:00:32.000,2025-04-15 13:04:23.936
false,true,10897,10242,655,0,00:00:00.000,2025-04-15 13:06:49.079
false,false,10963,10306,657,94,00:00:32.000,2025-04-15 13:08:13.166
false,true,10975,10318,657,0,00:00:00.000,2025-04-15 13:08:39.191
false,true,10975,10318,657,0,00:00:00.000,2025-04-15 13:08:41.192
false,false,10980,10323,657,92,00:00:30.000,2025-04-15 13:08:54.204
false,false,11005,10348,657,381,00:00:31.000,2025-04-15 13:09:31.239
false,true,11009,10352,657,0,00:00:00.000,2025-04-15 13:09:41.249
false,false,10673,10030,643,66,00:00:33.000,2025-04-15 13:01:40.775
false,false,10681,10037,644,319,00:00:31.000,2025-04-15 13:01:48.784
false,false,10682,10038,644,352,00:00:33.000,2025-04-15 13:01:49.785
false,false,10691,10047,644,643,00:00:33.000,2025-04-15 13:01:58.791
false,false,10704,10058,646,184,00:00:30.000,2025-04-15 13:02:17.809
false,false,10720,10072,648,685,00:00:33.000,2025-04-15 13:02:33.825
false,false,10823,10173,650,157,00:00:32.000,2025-04-15 13:04:58.968
false,true,10833,10182,651,0,00:00:00.000,2025-04-15 13:05:13.985
false,true,10843,10192,651,0,00:00:00.000,2025-04-15 13:05:31.000
false,false,10880,10225,655,503,00:00:31.000,2025-04-15 13:06:20.052
false,false,10159,9549,610,94,00:00:31.000,2025-04-15 12:50:06.069
false,false,10182,9571,611,818,00:00:31.000,2025-04-15 12:50:29.092
false,false,10193,9578,615,1164,00:00:30.000,2025-04-15 12:50:40.102
false,false,10200,9584,616,126,00:00:32.000,2025-04-15 12:50:53.116
false,false,10206,9590,616,125,00:00:31.000,2025-04-15 12:51:11.130
false,true,11022,10365,657,0,00:00:00.000,2025-04-15 13:10:00.265
false,true,11035,10376,659,0,00:00:00.000,2025-04-15 13:10:14.277
false,true,11039,10380,659,0,00:00:00.000,2025-04-15 13:10:25.291
false,false,11047,10388,659,254,00:00:33.000,2025-04-15 13:10:37.298
false,false,11052,10393,659,412,00:00:32.000,2025-04-15 13:10:42.303
false,false,11056,10397,659,539,00:00:31.000,2025-04-15 13:10:46.307
false,false,11074,10415,659,63,00:00:32.000,2025-04-15 13:11:16.337
false,false,11081,10422,659,282,00:00:32.000,2025-04-15 13:11:23.346
false,false,11189,10525,664,406,00:00:30.000,2025-04-15 13:13:47.492
false,false,11197,10533,664,30,00:00:30.000,2025-04-15 13:14:01.505
false,false,11207,10543,664,124,00:00:30.000,2025-04-15 13:14:17.523
false,true,11352,10678,674,0,00:00:00.000,2025-04-15 13:17:30.720
false,true,11353,10679,674,0,00:00:00.000,2025-04-15 13:17:37.727
false,false,11357,10683,674,122,00:00:30.000,2025-04-15 13:17:41.733
false,false,11370,10696,674,32,00:00:32.000,2025-04-15 13:18:00.754
false,false,11371,10697,674,65,00:00:33.000,2025-04-15 13:18:01.754
false,false,11239,10572,667,594,00:00:31.000,2025-04-15 13:14:55.561
false,false,11242,10575,667,686,00:00:30.000,2025-04-15 13:14:58.565
false,false,11256,10589,667,1125,00:00:30.000,2025-04-15 13:15:12.579
false,false,11261,10594,667,1285,00:00:30.000,2025-04-15 13:15:17.585
false,false,11267,10600,667,1473,00:00:30.000,2025-04-15 13:15:23.592
false,true,11277,10610,667,0,00:00:00.000,2025-04-15 13:15:38.605
false,true,11296,10624,672,0,00:00:00.000,2025-04-15 13:16:06.634
false,false,11297,10625,672,30,00:00:30.000,2025-04-15 13:16:11.639
false,false,11104,10441,663,467,00:00:31.000,2025-04-15 13:11:52.373
false,false,11109,10446,663,626,00:00:30.000,2025-04-15 13:11:57.379
false,true,11120,10457,663,0,00:00:00.000,2025-04-15 13:12:12.396
false,false,11130,10467,663,282,00:00:30.000,2025-04-15 13:12:30.414
false,true,11131,10468,663,0,00:00:00.000,2025-04-15 13:12:36.420
false,true,11152,10488,664,0,00:00:00.000,2025-04-15 13:13:01.443
false,true,11152,10488,664,0,00:00:00.000,2025-04-15 13:13:02.445
false,false,11383,10709,674,98,00:00:33.000,2025-04-15 13:18:19.770
false,false,11397,10721,676,287,00:00:32.000,2025-04-15 13:18:39.787
false,false,11399,10722,677,349,00:00:30.000,2025-04-15 13:18:41.789
false,false,11400,10723,677,381,00:00:32.000,2025-04-15 13:18:42.789
false,false,11404,10724,680,32,00:00:32.000,2025-04-15 13:18:52.800
false,false,11435,10754,681,791,00:00:30.000,2025-04-15 13:19:35.838
false,true,11547,10862,685,0,00:00:00.000,2025-04-15 13:21:57.002
false,false,11568,10880,688,510,00:00:33.000,2025-04-15 13:22:31.035
false,false,11571,10882,689,603,00:00:30.000,2025-04-15 13:22:34.037
false,false,11585,10896,689,406,00:00:30.000,2025-04-15 13:22:54.055
false,false,11591,10902,689,93,00:00:32.000,2025-04-15 13:23:06.068
false,false,11456,10774,682,1459,00:00:33.000,2025-04-15 13:19:56.863
false,false,11477,10794,683,126,00:00:30.000,2025-04-15 13:20:23.899
false,false,11501,10818,683,63,00:00:31.000,2025-04-15 13:20:53.932
false,false,11509,10826,683,313,00:00:32.000,2025-04-15 13:21:01.941
false,false,11524,10841,683,33,00:00:33.000,2025-04-15 13:21:28.973
false,true,11599,10910,689,0,00:00:00.000,2025-04-15 13:23:23.085
false,true,11599,10910,689,0,00:00:00.000,2025-04-15 13:23:25.087
false,false,11613,10923,690,62,00:00:30.000,2025-04-15 13:23:46.109
false,false,11644,10951,693,128,00:00:33.000,2025-04-15 13:24:29.149
false,false,11652,10959,693,382,00:00:32.000,2025-04-15 13:24:37.157
false,false,11665,10971,694,789,00:00:31.000,2025-04-15 13:24:50.172
false,false,11729,11032,697,97,00:00:33.000,2025-04-15 13:26:36.284
false,true,11731,11034,697,0,00:00:00.000,2025-04-15 13:26:40.289
false,false,11765,11064,701,218,00:00:31.000,2025-04-15 13:27:30.338
false,false,11781,11080,701,726,00:00:30.000,2025-04-15 13:27:46.353
false,false,11812,11109,703,30,00:00:30.000,2025-04-15 13:28:23.386
false,true,11845,11140,705,0,00:00:00.000,2025-04-15 13:29:02.423
false,false,11850,11145,705,160,00:00:32.000,2025-04-15 13:29:07.427
false,false,11856,11151,705,64,00:00:31.000,2025-04-15 13:29:19.439
false,true,11858,11153,705,0,00:00:00.000,2025-04-15 13:29:23.445
false,true,11685,10990,695,0,00:00:00.000,2025-04-15 13:25:14.197
false,true,11686,10991,695,0,00:00:00.000,2025-04-15 13:25:23.205
false,false,11706,11009,697,125,00:00:30.000,2025-04-15 13:25:55.242
false,true,11712,11015,697,0,00:00:00.000,2025-04-15 13:26:08.255
false,false,11716,11019,697,124,00:00:30.000,2025-04-15 13:26:17.267
false,false,11725,11028,697,403,00:00:30.000,2025-04-15 13:26:26.276
false,true,11726,11029,697,0,00:00:00.000,2025-04-15 13:26:33.281
false,true,11932,11223,709,0,00:00:00.000,2025-04-15 13:31:50.607
false,true,11937,11228,709,0,00:00:00.000,2025-04-15 13:32:00.617
false,false,11949,11238,711,384,00:00:32.000,2025-04-15 13:32:22.638
false,false,11952,11240,712,481,00:00:33.000,2025-04-15 13:32:25.641
false,false,11954,11242,712,547,00:00:33.000,2025-04-15 13:32:27.643
false,false,11969,11255,714,1017,00:00:31.000,2025-04-15 13:32:42.665
false,true,11973,11259,714,0,00:00:00.000,2025-04-15 13:32:55.683
false,false,11868,11163,705,33,00:00:33.000,2025-04-15 13:29:55.483
false,true,11878,11172,706,0,00:00:00.000,2025-04-15 13:30:14.503
false,true,11887,11180,707,0,00:00:00.000,2025-04-15 13:30:35.531
false,false,11897,11188,709,94,00:00:31.000,2025-04-15 13:31:00.557
false,false,11898,11189,709,125,00:00:31.000,2025-04-15 13:31:01.559
false,false,11902,11193,709,251,00:00:33.000,2025-04-15 13:31:05.562
false,false,2904,2734,170,409,00:00:31.000,2025-04-14 12:37:55.666
false,false,2907,2737,170,63,00:00:31.000,2025-04-14 12:38:13.687
false,false,2912,2742,170,159,00:00:33.000,2025-04-14 12:38:35.708
false,false,2921,2751,170,442,00:00:31.000,2025-04-14 12:38:53.726
false,false,2952,2780,172,1426,00:00:31.000,2025-04-14 12:39:55.765
false,true,2962,2789,173,0,00:00:00.000,2025-04-14 12:40:39.797
false,false,2967,2793,174,156,00:00:31.000,2025-04-14 12:41:01.817
false,true,2972,2798,174,0,00:00:00.000,2025-04-14 12:41:15.829
false,true,2972,2798,174,0,00:00:00.000,2025-04-14 12:41:23.836
false,false,2973,2799,174,33,00:00:33.000,2025-04-14 12:41:25.839
false,false,2978,2804,174,192,00:00:32.000,2025-04-14 12:41:35.845
false,false,2979,2805,174,223,00:00:31.000,2025-04-14 12:41:37.847
false,true,2993,2817,176,0,00:00:00.000,2025-04-14 12:42:39.903
false,false,3000,2824,176,219,00:00:32.000,2025-04-14 12:42:55.914
false,true,3027,2849,178,0,00:00:00.000,2025-04-14 12:44:21.981
false,true,9792,9205,587,0,00:00:00.000,2025-04-15 12:41:44.545
false,false,9796,9209,587,125,00:00:30.000,2025-04-15 12:41:50.551
false,false,9808,9221,587,506,00:00:31.000,2025-04-15 12:42:02.564
false,false,9813,9225,588,667,00:00:32.000,2025-04-15 12:42:07.566
false,false,9822,9233,589,946,00:00:30.000,2025-04-15 12:42:16.576
false,false,9830,9241,589,1201,00:00:31.000,2025-04-15 12:42:24.588
false,false,9842,9250,592,1581,00:00:32.000,2025-04-15 12:42:36.601
false,false,9844,9252,592,1646,00:00:32.000,2025-04-15 12:42:38.601
false,true,9852,9260,592,0,00:00:00.000,2025-04-15 12:43:00.622
false,false,9853,9261,592,30,00:00:30.000,2025-04-15 12:43:05.630
false,true,9940,9344,596,0,00:00:00.000,2025-04-15 12:44:58.740
false,false,9953,9357,596,412,00:00:32.000,2025-04-15 12:45:15.760
false,true,9954,9358,596,0,00:00:00.000,2025-04-15 12:45:18.764
false,true,9954,9358,596,0,00:00:00.000,2025-04-15 12:45:19.765
false,true,10065,9461,604,0,00:00:00.000,2025-04-15 12:48:18.950
false,false,10078,9474,604,410,00:00:32.000,2025-04-15 12:48:32.963
false,false,10084,9480,604,599,00:00:33.000,2025-04-15 12:48:38.970
false,false,10087,9482,605,692,00:00:30.000,2025-04-15 12:48:41.975
false,false,10088,9483,605,722,00:00:30.000,2025-04-15 12:48:42.975
false,false,10116,9508,608,1606,00:00:32.000,2025-04-15 12:49:11.008
false,false,10117,9509,608,1636,00:00:30.000,2025-04-15 12:49:12.009
false,true,10128,9520,608,0,00:00:00.000,2025-04-15 12:49:28.027
false,false,10140,9532,608,382,00:00:31.000,2025-04-15 12:49:41.040
false,false,9890,9295,595,821,00:00:32.000,2025-04-15 12:43:48.675
false,false,9900,9305,595,1139,00:00:33.000,2025-04-15 12:43:58.688
false,false,9907,9311,596,1362,00:00:32.000,2025-04-15 12:44:05.694
false,false,9916,9320,596,126,00:00:32.000,2025-04-15 12:44:20.704
false,false,9923,9327,596,349,00:00:33.000,2025-04-15 12:44:27.712
false,true,9927,9331,596,0,00:00:00.000,2025-04-15 12:44:35.719
false,false,9929,9333,596,65,00:00:33.000,2025-04-15 12:44:39.722
false,false,9722,9139,583,158,00:00:31.000,2025-04-15 12:40:06.458
false,false,9727,9144,583,316,00:00:32.000,2025-04-15 12:40:11.462
false,true,9748,9165,583,0,00:00:00.000,2025-04-15 12:40:43.488
false,false,9750,9167,583,63,00:00:33.000,2025-04-15 12:40:46.491
false,false,9758,9174,584,65,00:00:32.000,2025-04-15 12:41:06.509
false,false,9766,9181,585,317,00:00:31.000,2025-04-15 12:41:14.515
false,false,9768,9183,585,381,00:00:33.000,2025-04-15 12:41:16.516
false,false,9770,9185,585,446,00:00:33.000,2025-04-15 12:41:18.519
false,false,9781,9195,586,791,00:00:30.000,2025-04-15 12:41:29.530
false,false,10002,9402,600,937,00:00:33.000,2025-04-15 12:46:34.848
false,true,10012,9410,602,0,00:00:00.000,2025-04-15 12:46:48.859
false,false,10027,9424,603,92,00:00:32.000,2025-04-15 12:47:17.888
false,true,10027,9424,603,0,00:00:00.000,2025-04-15 12:47:19.890
false,false,10043,9440,603,506,00:00:30.000,2025-04-15 12:47:39.911
false,false,10044,9441,603,539,00:00:33.000,2025-04-15 12:47:40.913
false,true,10223,9606,617,0,00:00:00.000,2025-04-15 12:51:35.157
false,true,10223,9606,617,0,00:00:00.000,2025-04-15 12:51:39.160
false,false,10232,9614,618,281,00:00:33.000,2025-04-15 12:51:49.172
false,false,10253,9635,618,944,00:00:33.000,2025-04-15 12:52:10.195
false,false,10269,9651,618,1451,00:00:33.000,2025-04-15 12:52:26.213
false,false,10285,9666,619,62,00:00:32.000,2025-04-15 12:52:48.239
false,false,10289,9669,620,186,00:00:31.000,2025-04-15 12:52:52.242
false,false,10292,9672,620,284,00:00:32.000,2025-04-15 12:52:55.245
false,false,10393,9766,627,384,00:00:32.000,2025-04-15 12:55:06.380
false,true,10423,9796,627,0,00:00:00.000,2025-04-15 12:55:58.427
false,false,10425,9798,627,31,00:00:31.000,2025-04-15 12:56:08.437
false,false,10433,9805,628,283,00:00:32.000,2025-04-15 12:56:16.445
false,true,10433,9805,628,0,00:00:00.000,2025-04-15 12:56:17.447
false,false,10435,9806,629,62,00:00:30.000,2025-04-15 12:56:24.455
false,false,10472,9840,632,697,00:00:33.000,2025-04-15 12:57:07.497
false,false,10488,9855,633,1201,00:00:30.000,2025-04-15 12:57:23.516
false,false,10491,9858,633,1296,00:00:33.000,2025-04-15 12:57:26.520
false,false,10499,9866,633,1541,00:00:32.000,2025-04-15 12:57:34.526
false,true,10507,9874,633,0,00:00:00.000,2025-04-15 12:57:45.539
false,true,10527,9892,635,0,00:00:00.000,2025-04-15 12:58:17.577
false,true,10539,9904,635,0,00:00:00.000,2025-04-15 12:58:36.591
false,false,10541,9905,636,64,00:00:32.000,2025-04-15 12:58:40.596
false,false,10545,9909,636,190,00:00:32.000,2025-04-15 12:58:44.599
false,false,10550,9914,636,343,00:00:30.000,2025-04-15 12:58:49.604
false,false,10564,9927,637,155,00:00:32.000,2025-04-15 12:59:15.633
false,false,10312,9690,622,905,00:00:30.000,2025-04-15 12:53:15.262
false,false,10318,9696,622,1091,00:00:31.000,2025-04-15 12:53:21.270
false,false,10341,9718,623,248,00:00:31.000,2025-04-15 12:53:50.298
false,true,10357,9733,624,0,00:00:00.000,2025-04-15 12:54:07.316
false,true,10357,9733,624,0,00:00:00.000,2025-04-15 12:54:10.318
false,false,10368,9743,625,30,00:00:30.000,2025-04-15 12:54:35.344
false,false,10372,9747,625,156,00:00:31.000,2025-04-15 12:54:39.349
false,true,10381,9756,625,0,00:00:00.000,2025-04-15 12:54:49.361
false,false,10608,9967,641,281,00:00:33.000,2025-04-15 13:00:05.683
false,false,10625,9983,642,814,00:00:30.000,2025-04-15 13:00:22.700
false,true,10653,10010,643,0,00:00:00.000,2025-04-15 13:00:58.734
false,false,10766,10117,649,189,00:00:33.000,2025-04-15 13:03:37.886
false,false,10772,10123,649,382,00:00:30.000,2025-04-15 13:03:43.893
false,false,10774,10125,649,443,00:00:31.000,2025-04-15 13:03:45.894
false,false,10776,10127,649,505,00:00:30.000,2025-04-15 13:03:47.895
false,true,10778,10129,649,0,00:00:00.000,2025-04-15 13:03:59.906
false,false,10799,10149,650,661,00:00:32.000,2025-04-15 13:04:22.933
false,false,10897,10242,655,505,00:00:32.000,2025-04-15 13:06:43.074
false,false,10898,10243,655,30,00:00:30.000,2025-04-15 13:06:50.081
false,false,10930,10274,656,187,00:00:30.000,2025-04-15 13:07:34.125
false,false,10946,10289,657,689,00:00:32.000,2025-04-15 13:07:50.145
false,false,10956,10299,657,1000,00:00:30.000,2025-04-15 13:08:00.152
false,false,10968,10311,657,62,00:00:30.000,2025-04-15 13:08:24.177
false,false,10972,10315,657,188,00:00:31.000,2025-04-15 13:08:28.181
false,false,10977,10320,657,60,00:00:30.000,2025-04-15 13:08:45.194
false,true,11009,10352,657,0,00:00:00.000,2025-04-15 13:09:39.246
false,true,10671,10028,643,0,00:00:00.000,2025-04-15 13:01:37.773
false,false,10679,10035,644,258,00:00:33.000,2025-04-15 13:01:46.780
false,true,10698,10052,646,0,00:00:00.000,2025-04-15 13:02:10.801
false,false,10699,10053,646,31,00:00:31.000,2025-04-15 13:02:12.805
false,false,10718,10071,647,622,00:00:30.000,2025-04-15 13:02:31.822
false,false,10721,10073,648,715,00:00:30.000,2025-04-15 13:02:34.827
false,false,10746,10097,649,32,00:00:32.000,2025-04-15 13:03:11.867
false,false,10821,10171,650,94,00:00:31.000,2025-04-15 13:04:56.966
false,false,10843,10192,651,324,00:00:33.000,2025-04-15 13:05:24.995
false,false,10851,10200,651,251,00:00:32.000,2025-04-15 13:05:39.006
false,false,10859,10207,652,97,00:00:32.000,2025-04-15 13:05:53.024
false,false,10866,10214,652,61,00:00:30.000,2025-04-15 13:06:06.037
false,false,10868,10216,652,125,00:00:31.000,2025-04-15 13:06:08.040
false,false,10872,10219,653,252,00:00:32.000,2025-04-15 13:06:12.045
false,false,10881,10226,655,534,00:00:31.000,2025-04-15 13:06:21.053
false,true,10156,9547,609,0,00:00:00.000,2025-04-15 12:50:01.064
false,false,10174,9563,611,569,00:00:32.000,2025-04-15 12:50:21.085
false,false,10176,9565,611,630,00:00:31.000,2025-04-15 12:50:23.085
false,false,10185,9574,611,912,00:00:33.000,2025-04-15 12:50:32.095
false,false,10209,9593,616,221,00:00:32.000,2025-04-15 12:51:14.135
false,false,11021,10364,657,379,00:00:31.000,2025-04-15 13:09:53.261
false,false,11039,10380,659,128,00:00:32.000,2025-04-15 13:10:23.289
false,false,11054,10395,659,476,00:00:33.000,2025-04-15 13:10:44.305
false,true,11058,10399,659,0,00:00:00.000,2025-04-15 13:10:49.310
false,true,11058,10399,659,0,00:00:00.000,2025-04-15 13:10:50.311
false,false,11069,10410,659,349,00:00:32.000,2025-04-15 13:11:05.324
false,true,11072,10413,659,0,00:00:00.000,2025-04-15 13:11:09.329
false,true,11072,10413,659,0,00:00:00.000,2025-04-15 13:11:14.334
false,false,11183,10519,664,220,00:00:32.000,2025-04-15 13:13:41.485
false,false,11184,10520,664,252,00:00:32.000,2025-04-15 13:13:42.486
false,false,11188,10524,664,376,00:00:30.000,2025-04-15 13:13:46.491
false,false,11203,10539,664,217,00:00:30.000,2025-04-15 13:14:07.512
false,true,11203,10539,664,0,00:00:00.000,2025-04-15 13:14:09.516
false,false,11216,10550,666,404,00:00:32.000,2025-04-15 13:14:26.533
false,true,11329,10655,674,0,00:00:00.000,2025-04-15 13:16:48.674
false,false,11343,10669,674,151,00:00:30.000,2025-04-15 13:17:15.705
false,false,11345,10671,674,215,00:00:33.000,2025-04-15 13:17:17.706
false,false,11369,10695,674,497,00:00:33.000,2025-04-15 13:17:53.747
false,true,11369,10695,674,0,00:00:00.000,2025-04-15 13:17:58.753
false,false,11380,10706,674,348,00:00:31.000,2025-04-15 13:18:10.762
false,true,11380,10706,674,0,00:00:00.000,2025-04-15 13:18:11.762
false,false,11247,10580,667,845,00:00:32.000,2025-04-15 13:15:03.570
false,false,11286,10617,669,220,00:00:32.000,2025-04-15 13:15:54.622
false,false,11288,10618,670,282,00:00:31.000,2025-04-15 13:15:56.624
false,false,11289,10619,670,312,00:00:30.000,2025-04-15 13:15:57.624
false,true,11296,10624,672,0,00:00:00.000,2025-04-15 13:16:05.633
false,true,11089,10429,660,0,00:00:00.000,2025-04-15 13:11:34.354
false,false,11111,10448,663,689,00:00:33.000,2025-04-15 13:11:59.380
false,true,11152,10488,664,0,00:00:00.000,2025-04-15 13:12:59.440
false,true,11380,10706,674,0,00:00:00.000,2025-04-15 13:18:13.764
false,true,11380,10706,674,0,00:00:00.000,2025-04-15 13:18:16.767
false,false,11409,10728,681,94,00:00:31.000,2025-04-15 13:19:03.808
false,false,11410,10729,681,125,00:00:31.000,2025-04-15 13:19:04.808
false,false,11417,10736,681,218,00:00:30.000,2025-04-15 13:19:17.819
false,false,11443,10762,681,1042,00:00:33.000,2025-04-15 13:19:43.848
false,false,11450,10768,682,1266,00:00:30.000,2025-04-15 13:19:50.855
false,false,11542,10858,684,598,00:00:33.000,2025-04-15 13:21:46.991
false,true,11547,10862,685,0,00:00:00.000,2025-04-15 13:21:54.000
false,true,11552,10864,688,0,00:00:00.000,2025-04-15 13:22:12.016
false,false,11565,10877,688,413,00:00:33.000,2025-04-15 13:22:28.033
false,true,11572,10883,689,0,00:00:00.000,2025-04-15 13:22:38.042
false,false,11580,10891,689,250,00:00:31.000,2025-04-15 13:22:49.051
false,false,11470,10788,682,1898,00:00:30.000,2025-04-15 13:20:10.881
false,false,11476,10794,682,96,00:00:32.000,2025-04-15 13:20:22.898
false,false,11485,10802,683,376,00:00:31.000,2025-04-15 13:20:31.907
false,false,11505,10822,683,187,00:00:33.000,2025-04-15 13:20:57.936
false,false,11508,10825,683,281,00:00:31.000,2025-04-15 13:21:00.941
false,false,11523,10840,683,376,00:00:30.000,2025-04-15 13:21:21.963
false,true,11523,10840,683,0,00:00:00.000,2025-04-15 13:21:23.965
false,true,11598,10909,689,0,00:00:00.000,2025-04-15 13:23:14.075
false,false,11604,10915,689,155,00:00:31.000,2025-04-15 13:23:31.094
false,false,11611,10921,690,375,00:00:31.000,2025-04-15 13:23:38.102
false,true,11613,10923,690,0,00:00:00.000,2025-04-15 13:23:47.110
false,true,11613,10923,690,0,00:00:00.000,2025-04-15 13:23:49.113
false,false,11634,10944,690,661,00:00:30.000,2025-04-15 13:24:13.137
false,false,11643,10950,693,95,00:00:33.000,2025-04-15 13:24:28.148
false,false,11651,10958,693,350,00:00:32.000,2025-04-15 13:24:36.157
false,true,11742,11044,698,0,00:00:00.000,2025-04-15 13:26:58.307
false,false,11748,11049,699,190,00:00:32.000,2025-04-15 13:27:07.313
false,true,11758,11058,700,0,00:00:00.000,2025-04-15 13:27:18.324
false,false,11777,11076,701,602,00:00:32.000,2025-04-15 13:27:42.351
false,false,11794,11093,701,1135,00:00:33.000,2025-04-15 13:27:59.364
false,false,11806,11103,703,1515,00:00:31.000,2025-04-15 13:28:11.370
false,false,11838,11134,704,846,00:00:33.000,2025-04-15 13:28:49.412
false,true,11845,11140,705,0,00:00:00.000,2025-04-15 13:28:59.419
false,false,11859,11154,705,30,00:00:30.000,2025-04-15 13:29:34.458
false,false,11866,11161,705,254,00:00:31.000,2025-04-15 13:29:41.467
false,true,11866,11161,705,0,00:00:00.000,2025-04-15 13:29:42.469
false,false,11669,10975,694,914,00:00:31.000,2025-04-15 13:24:54.177
false,true,11685,10990,695,0,00:00:00.000,2025-04-15 13:25:11.194
false,true,11686,10991,695,0,00:00:00.000,2025-04-15 13:25:20.203
false,true,11696,10999,697,0,00:00:00.000,2025-04-15 13:25:35.217
false,true,11712,11015,697,0,00:00:00.000,2025-04-15 13:26:05.251
false,false,11928,11219,709,783,00:00:31.000,2025-04-15 13:31:37.595
false,true,11937,11228,709,0,00:00:00.000,2025-04-15 13:31:59.616
false,false,11939,11230,709,63,00:00:31.000,2025-04-15 13:32:12.628
false,true,11973,11259,714,0,00:00:00.000,2025-04-15 13:32:56.684
false,true,11973,11259,714,0,00:00:00.000,2025-04-15 13:32:57.685
false,true,11983,11269,714,0,00:00:00.000,2025-04-15 13:33:12.699
false,false,11890,11183,707,94,00:00:32.000,2025-04-15 13:30:41.536
false,true,11893,11184,709,0,00:00:00.000,2025-04-15 13:30:46.542
false,true,11894,11185,709,0,00:00:00.000,2025-04-15 13:30:52.548
false,false,11896,11187,709,63,00:00:31.000,2025-04-15 13:30:59.555
false,true,11903,11194,709,0,00:00:00.000,2025-04-15 13:31:07.565
false,false,11914,11205,709,341,00:00:33.000,2025-04-15 13:31:23.579
false,false,2885,2715,170,278,00:00:31.000,2025-04-14 12:37:05.625
false,false,2897,2727,170,187,00:00:30.000,2025-04-14 12:37:41.653
false,true,2905,2735,170,0,00:00:00.000,2025-04-14 12:38:01.674
false,true,2905,2735,170,0,00:00:00.000,2025-04-14 12:38:03.676
false,false,2916,2746,170,285,00:00:31.000,2025-04-14 12:38:43.716
false,false,2931,2760,171,750,00:00:30.000,2025-04-14 12:39:13.742
false,false,2951,2780,171,1395,00:00:32.000,2025-04-14 12:39:53.765
false,true,2957,2784,173,0,00:00:00.000,2025-04-14 12:40:13.776
false,false,2970,2796,174,250,00:00:30.000,2025-04-14 12:41:07.820
false,true,2972,2798,174,0,00:00:00.000,2025-04-14 12:41:13.826
false,false,2984,2809,175,387,00:00:33.000,2025-04-14 12:41:47.856
false,false,2996,2820,176,91,00:00:30.000,2025-04-14 12:42:47.908
false,false,3002,2826,176,281,00:00:32.000,2025-04-14 12:42:59.918
false,false,3020,2842,178,65,00:00:33.000,2025-04-14 12:43:47.957
false,false,3023,2845,178,96,00:00:31.000,2025-04-14 12:44:05.968
false,false,3040,2861,179,414,00:00:31.000,2025-04-14 12:44:51.999
false,false,3046,2867,179,33,00:00:33.000,2025-04-14 12:45:16.021
false,false,9790,9203,587,1074,00:00:30.000,2025-04-15 12:41:38.538
false,false,9794,9207,587,63,00:00:33.000,2025-04-15 12:41:48.550
false,false,9803,9216,587,346,00:00:31.000,2025-04-15 12:41:57.561
false,false,9821,9232,589,916,00:00:30.000,2025-04-15 12:42:15.576
false,false,9941,9345,596,31,00:00:31.000,2025-04-15 12:45:03.745
false,true,9971,9373,598,0,00:00:00.000,2025-04-15 12:45:52.805
false,true,9971,9373,598,0,00:00:00.000,2025-04-15 12:45:54.807
false,false,9988,9388,600,498,00:00:33.000,2025-04-15 12:46:20.835
false,false,9990,9390,600,559,00:00:30.000,2025-04-15 12:46:22.836
false,false,10083,9479,604,566,00:00:30.000,2025-04-15 12:48:37.969
false,false,10125,9517,608,1894,00:00:33.000,2025-04-15 12:49:20.017
false,false,10141,9533,608,414,00:00:32.000,2025-04-15 12:49:42.042
false,true,9864,9272,592,0,00:00:00.000,2025-04-15 12:43:18.640
false,false,9878,9285,593,440,00:00:32.000,2025-04-15 12:43:36.662
false,false,9886,9292,594,693,00:00:31.000,2025-04-15 12:43:44.670
false,true,9912,9316,596,0,00:00:00.000,2025-04-15 12:44:15.701
false,false,9914,9318,596,62,00:00:32.000,2025-04-15 12:44:18.702
false,false,9915,9319,596,94,00:00:32.000,2025-04-15 12:44:19.703
false,false,9918,9322,596,189,00:00:33.000,2025-04-15 12:44:22.706
false,false,9925,9329,596,412,00:00:31.000,2025-04-15 12:44:29.714
false,true,9927,9331,596,0,00:00:00.000,2025-04-15 12:44:37.721
false,false,9713,9132,581,374,00:00:33.000,2025-04-15 12:39:51.443
false,true,9751,9167,584,0,00:00:00.000,2025-04-15 12:40:52.496
false,true,9756,9172,584,0,00:00:00.000,2025-04-15 12:41:00.503
false,true,9756,9172,584,0,00:00:00.000,2025-04-15 12:41:01.504
false,false,9759,9175,584,97,00:00:32.000,2025-04-15 12:41:07.510
false,false,9773,9188,585,540,00:00:32.000,2025-04-15 12:41:21.522
false,false,9776,9190,586,636,00:00:32.000,2025-04-15 12:41:24.526
false,false,10020,9418,602,221,00:00:30.000,2025-04-15 12:47:04.873
false,true,10027,9424,603,0,00:00:00.000,2025-04-15 12:47:18.889
false,true,10027,9424,603,0,00:00:00.000,2025-04-15 12:47:23.893
false,false,10035,9432,603,254,00:00:31.000,2025-04-15 12:47:31.905
false,false,10039,9436,603,381,00:00:33.000,2025-04-15 12:47:35.909
false,true,10047,9444,603,0,00:00:00.000,2025-04-15 12:47:44.917
false,false,10058,9455,603,64,00:00:33.000,2025-04-15 12:48:06.937
false,false,10061,9457,604,161,00:00:33.000,2025-04-15 12:48:09.940
false,false,10224,9607,617,32,00:00:32.000,2025-04-15 12:51:41.163
false,false,10230,9612,618,218,00:00:30.000,2025-04-15 12:51:47.169
false,false,10255,9637,618,1010,00:00:33.000,2025-04-15 12:52:12.197
false,false,10261,9643,618,1198,00:00:32.000,2025-04-15 12:52:18.205
false,false,10275,9657,618,1641,00:00:31.000,2025-04-15 12:52:32.221
false,false,10286,9667,619,93,00:00:31.000,2025-04-15 12:52:49.241
false,false,10297,9676,621,440,00:00:30.000,2025-04-15 12:53:00.248
false,true,10412,9785,627,0,00:00:00.000,2025-04-15 12:55:30.401
false,false,10418,9791,627,189,00:00:31.000,2025-04-15 12:55:37.409
false,true,10423,9796,627,0,00:00:00.000,2025-04-15 12:55:57.425
false,false,10439,9810,629,185,00:00:32.000,2025-04-15 12:56:28.456
false,false,10440,9811,629,216,00:00:31.000,2025-04-15 12:56:29.457
false,false,10455,9825,630,153,00:00:31.000,2025-04-15 12:56:50.483
false,false,10475,9843,632,792,00:00:32.000,2025-04-15 12:57:10.500
false,false,10528,9893,635,31,00:00:31.000,2025-04-15 12:58:21.580
false,false,10549,9913,636,313,00:00:30.000,2025-04-15 12:58:48.602
false,false,10598,9958,640,1229,00:00:30.000,2025-04-15 12:59:49.669
false,true,10599,9959,640,0,00:00:00.000,2025-04-15 12:59:51.670
false,false,10315,9693,622,998,00:00:30.000,2025-04-15 12:53:18.265
false,false,10326,9704,622,1336,00:00:30.000,2025-04-15 12:53:29.278
false,false,10329,9707,622,1430,00:00:31.000,2025-04-15 12:53:32.283
false,false,10374,9749,625,220,00:00:32.000,2025-04-15 12:54:41.351
false,false,10607,9966,641,248,00:00:30.000,2025-04-15 13:00:04.681
false,false,10609,9968,641,312,00:00:31.000,2025-04-15 13:00:06.685
false,false,10613,9972,641,437,00:00:30.000,2025-04-15 13:00:10.688
false,false,10630,9988,642,973,00:00:31.000,2025-04-15 13:00:27.704
false,false,10637,9995,642,1199,00:00:32.000,2025-04-15 13:00:34.712
false,false,10645,10002,643,252,00:00:31.000,2025-04-15 13:00:48.728
false,true,10653,10010,643,0,00:00:00.000,2025-04-15 13:01:03.742
false,true,10661,10018,643,0,00:00:00.000,2025-04-15 13:01:21.756
false,false,10759,10110,649,444,00:00:32.000,2025-04-15 13:03:24.873
false,false,10767,10118,649,222,00:00:33.000,2025-04-15 13:03:38.887
false,false,10768,10119,649,253,00:00:31.000,2025-04-15 13:03:39.889
false,true,10778,10129,649,0,00:00:00.000,2025-04-15 13:03:51.899
false,true,10778,10129,649,0,00:00:00.000,2025-04-15 13:03:52.899
false,false,10788,10139,649,316,00:00:31.000,2025-04-15 13:04:11.920
false,false,10793,10144,649,471,00:00:32.000,2025-04-15 13:04:16.925
false,true,10801,10151,650,0,00:00:00.000,2025-04-15 13:04:30.942
false,false,10803,10153,650,62,00:00:31.000,2025-04-15 13:04:32.945
false,false,10891,10236,655,316,00:00:33.000,2025-04-15 13:06:37.067
false,true,10897,10242,655,0,00:00:00.000,2025-04-15 13:06:48.079
false,false,10899,10244,655,63,00:00:33.000,2025-04-15 13:06:51.082
false,false,10905,10250,655,256,00:00:33.000,2025-04-15 13:06:57.090
false,true,10974,10317,657,0,00:00:00.000,2025-04-15 13:08:34.189
false,true,10977,10320,657,0,00:00:00.000,2025-04-15 13:08:47.196
false,false,10992,10335,657,32,00:00:32.000,2025-04-15 13:09:12.220
false,false,11013,10356,657,128,00:00:32.000,2025-04-15 13:09:45.253
false,false,10675,10032,643,129,00:00:31.000,2025-04-15 13:01:42.778
false,false,10692,10047,645,676,00:00:33.000,2025-04-15 13:01:59.792
false,false,10717,10070,647,592,00:00:30.000,2025-04-15 13:02:30.820
false,false,10723,10075,648,778,00:00:33.000,2025-04-15 13:02:36.828
false,false,10738,10089,649,63,00:00:30.000,2025-04-15 13:02:57.854
false,false,10835,10184,651,63,00:00:32.000,2025-04-15 13:05:16.989
false,false,10837,10186,651,128,00:00:33.000,2025-04-15 13:05:18.989
false,false,10854,10203,651,344,00:00:31.000,2025-04-15 13:05:42.009
false,false,10864,10212,652,260,00:00:33.000,2025-04-15 13:05:58.029
false,true,10156,9547,609,0,00:00:00.000,2025-04-15 12:49:59.062
false,false,10170,9559,611,443,00:00:31.000,2025-04-15 12:50:17.080
false,true,10202,9586,616,0,00:00:00.000,2025-04-15 12:51:04.123
false,true,10202,9586,616,0,00:00:00.000,2025-04-15 12:51:07.125
false,false,10211,9595,616,282,00:00:30.000,2025-04-15 12:51:16.137
false,true,10212,9596,616,0,00:00:00.000,2025-04-15 12:51:19.141
false,false,11031,10372,659,282,00:00:32.000,2025-04-15 13:10:09.273
false,true,11039,10380,659,0,00:00:00.000,2025-04-15 13:10:26.291
false,false,11044,10385,659,157,00:00:30.000,2025-04-15 13:10:34.294
false,false,11072,10413,659,441,00:00:31.000,2025-04-15 13:11:08.327
false,true,11072,10413,659,0,00:00:00.000,2025-04-15 13:11:12.332
false,false,11167,10503,664,470,00:00:31.000,2025-04-15 13:13:19.461
false,false,11170,10506,664,568,00:00:33.000,2025-04-15 13:13:22.464
false,false,11177,10513,664,30,00:00:30.000,2025-04-15 13:13:35.481
false,true,11196,10532,664,0,00:00:00.000,2025-04-15 13:14:00.504
false,false,11201,10537,664,156,00:00:30.000,2025-04-15 13:14:05.510
false,false,11225,10558,667,160,00:00:31.000,2025-04-15 13:14:41.547
false,true,11336,10662,674,0,00:00:00.000,2025-04-15 13:16:57.687
false,true,11336,10662,674,0,00:00:00.000,2025-04-15 13:16:58.690
false,true,11336,10662,674,0,00:00:00.000,2025-04-15 13:17:00.690
false,true,11338,10664,674,0,00:00:00.000,2025-04-15 13:17:05.697
false,true,11369,10695,674,0,00:00:00.000,2025-04-15 13:17:56.750
false,false,11241,10574,667,656,00:00:30.000,2025-04-15 13:14:57.563
false,false,11250,10583,667,941,00:00:33.000,2025-04-15 13:15:06.573
false,false,11271,10604,667,1600,00:00:31.000,2025-04-15 13:15:27.596
false,false,11278,10610,668,31,00:00:31.000,2025-04-15 13:15:40.607
false,true,11296,10624,672,0,00:00:00.000,2025-04-15 13:16:08.636
false,false,11305,10632,673,285,00:00:32.000,2025-04-15 13:16:19.646
false,false,11310,10636,674,441,00:00:31.000,2025-04-15 13:16:24.649
false,false,11311,10637,674,473,00:00:32.000,2025-04-15 13:16:25.650
false,false,11314,10640,674,569,00:00:33.000,2025-04-15 13:16:28.652
false,false,11099,10436,663,314,00:00:31.000,2025-04-15 13:11:47.364
false,true,11131,10468,663,0,00:00:00.000,2025-04-15 13:12:32.416
false,false,11154,10490,664,61,00:00:31.000,2025-04-15 13:13:06.448
false,false,11388,10713,675,258,00:00:32.000,2025-04-15 13:18:24.777
false,true,11388,10713,675,0,00:00:00.000,2025-04-15 13:18:26.778
false,true,11388,10713,675,0,00:00:00.000,2025-04-15 13:18:29.779
false,false,11402,10723,679,446,00:00:32.000,2025-04-15 13:18:44.793
false,true,11406,10726,680,0,00:00:00.000,2025-04-15 13:18:58.803
false,false,11434,10753,681,761,00:00:32.000,2025-04-15 13:19:34.837
false,false,11448,10766,682,1204,00:00:33.000,2025-04-15 13:19:48.853
false,true,11547,10862,685,0,00:00:00.000,2025-04-15 13:21:55.001
false,false,11551,10864,687,60,00:00:30.000,2025-04-15 13:22:08.013
false,true,11552,10864,688,0,00:00:00.000,2025-04-15 13:22:14.018
false,false,11558,10870,688,188,00:00:32.000,2025-04-15 13:22:21.028
false,false,11562,10874,688,315,00:00:31.000,2025-04-15 13:22:25.029
false,false,11582,10893,689,313,00:00:32.000,2025-04-15 13:22:51.053
false,false,11516,10833,683,157,00:00:31.000,2025-04-15 13:21:14.954
false,false,11517,10834,683,189,00:00:32.000,2025-04-15 13:21:15.954
false,false,11602,10913,689,94,00:00:33.000,2025-04-15 13:23:29.092
false,false,11622,10932,690,285,00:00:30.000,2025-04-15 13:24:01.123
false,true,11640,10947,693,0,00:00:00.000,2025-04-15 13:24:24.145
false,false,11650,10957,693,318,00:00:32.000,2025-04-15 13:24:35.155
false,false,11653,10960,693,413,00:00:31.000,2025-04-15 13:24:38.158
false,false,11668,10974,694,883,00:00:32.000,2025-04-15 13:24:53.176
false,false,11746,11047,699,127,00:00:31.000,2025-04-15 13:27:05.313
false,false,11752,11053,699,317,00:00:32.000,2025-04-15 13:27:11.317
false,false,11754,11055,699,382,00:00:33.000,2025-04-15 13:27:13.319
false,false,11769,11068,701,348,00:00:33.000,2025-04-15 13:27:34.341
false,false,11782,11081,701,758,00:00:32.000,2025-04-15 13:27:47.353
false,false,11802,11100,702,1387,00:00:33.000,2025-04-15 13:28:07.369
false,false,11805,11102,703,1484,00:00:33.000,2025-04-15 13:28:10.370
false,true,11811,11108,703,0,00:00:00.000,2025-04-15 13:28:21.383
false,true,11854,11149,705,0,00:00:00.000,2025-04-15 13:29:14.436
false,false,11683,10988,695,1356,00:00:31.000,2025-04-15 13:25:08.191
false,true,11686,10991,695,0,00:00:00.000,2025-04-15 13:25:22.205
false,false,11688,10993,695,62,00:00:32.000,2025-04-15 13:25:25.206
false,true,11696,10999,697,0,00:00:00.000,2025-04-15 13:25:37.219
false,true,11696,10999,697,0,00:00:00.000,2025-04-15 13:25:38.220
false,false,11703,11006,697,33,00:00:33.000,2025-04-15 13:25:52.237
false,true,11712,11015,697,0,00:00:00.000,2025-04-15 13:26:02.248
false,true,11726,11029,697,0,00:00:00.000,2025-04-15 13:26:31.278
false,false,11956,11243,713,612,00:00:32.000,2025-04-15 13:32:29.643
false,false,11964,11251,713,863,00:00:31.000,2025-04-15 13:32:37.657
false,true,11970,11256,714,0,00:00:00.000,2025-04-15 13:32:49.672
false,true,11973,11259,714,0,00:00:00.000,2025-04-15 13:32:53.681
false,true,11878,11172,706,0,00:00:00.000,2025-04-15 13:30:12.502
false,true,11878,11172,706,0,00:00:00.000,2025-04-15 13:30:16.506
false,true,11887,11180,707,0,00:00:00.000,2025-04-15 13:30:32.528
false,false,11892,11184,708,159,00:00:33.000,2025-04-15 13:30:43.540
false,false,11907,11198,709,123,00:00:30.000,2025-04-15 13:31:16.573
false,false,2893,2723,170,64,00:00:31.000,2025-04-14 12:37:33.646
false,false,2909,2739,170,64,00:00:31.000,2025-04-14 12:38:29.702
false,false,2915,2745,170,254,00:00:30.000,2025-04-14 12:38:41.714
false,false,2928,2758,170,659,00:00:31.000,2025-04-14 12:39:07.737
false,false,2939,2768,171,1009,00:00:33.000,2025-04-14 12:39:29.751
false,false,2969,2795,174,220,00:00:31.000,2025-04-14 12:41:05.819
false,true,2993,2817,176,0,00:00:00.000,2025-04-14 12:42:33.898
false,false,3009,2833,176,502,00:00:33.000,2025-04-14 12:43:13.929
false,false,3016,2839,177,722,00:00:30.000,2025-04-14 12:43:27.941
false,false,3018,2841,177,786,00:00:32.000,2025-04-14 12:43:31.944
false,true,3020,2842,178,0,00:00:00.000,2025-04-14 12:43:57.962
false,true,3027,2849,178,0,00:00:00.000,2025-04-14 12:44:17.978
false,true,3027,2849,178,0,00:00:00.000,2025-04-14 12:44:23.982
false,false,3028,2850,178,33,00:00:33.000,2025-04-14 12:44:27.984
false,false,3044,2865,179,542,00:00:30.000,2025-04-14 12:45:00.006
false,true,3045,2866,179,0,00:00:00.000,2025-04-14 12:45:06.013
false,false,9806,9219,587,444,00:00:32.000,2025-04-15 12:42:00.562
false,false,9819,9230,589,855,00:00:32.000,2025-04-15 12:42:13.575
false,false,9820,9231,589,886,00:00:31.000,2025-04-15 12:42:14.575
false,false,9833,9242,591,1296,00:00:32.000,2025-04-15 12:42:27.591
false,false,9834,9243,591,1327,00:00:31.000,2025-04-15 12:42:28.591
false,true,9849,9257,592,0,00:00:00.000,2025-04-15 12:42:47.612
false,true,9849,9257,592,0,00:00:00.000,2025-04-15 12:42:55.619
false,true,9940,9344,596,0,00:00:00.000,2025-04-15 12:45:02.744
false,false,9945,9349,596,158,00:00:33.000,2025-04-15 12:45:07.751
false,false,9948,9352,596,250,00:00:31.000,2025-04-15 12:45:10.754
false,false,9958,9362,596,125,00:00:30.000,2025-04-15 12:45:26.776
false,true,9960,9363,597,0,00:00:00.000,2025-04-15 12:45:34.782
false,false,9964,9366,598,97,00:00:33.000,2025-04-15 12:45:44.796
false,false,10073,9469,604,254,00:00:33.000,2025-04-15 12:48:27.957
false,false,10091,9486,605,815,00:00:32.000,2025-04-15 12:48:45.979
false,false,10095,9489,606,946,00:00:33.000,2025-04-15 12:48:49.984
false,false,10124,9516,608,1861,00:00:32.000,2025-04-15 12:49:19.016
false,false,9908,9312,596,1394,00:00:32.000,2025-04-15 12:44:06.695
false,true,9912,9316,596,0,00:00:00.000,2025-04-15 12:44:12.698
false,false,9924,9328,596,381,00:00:32.000,2025-04-15 12:44:28.713
false,false,9714,9132,582,404,00:00:30.000,2025-04-15 12:39:52.444
false,false,9746,9163,583,556,00:00:31.000,2025-04-15 12:40:36.481
false,true,9751,9167,584,0,00:00:00.000,2025-04-15 12:40:49.494
false,false,10013,9411,602,32,00:00:32.000,2025-04-15 12:46:51.861
false,false,10016,9414,602,95,00:00:33.000,2025-04-15 12:47:00.868
false,false,10024,9421,603,343,00:00:30.000,2025-04-15 12:47:08.878
false,true,10024,9421,603,0,00:00:00.000,2025-04-15 12:47:10.880
false,false,10025,9422,603,30,00:00:30.000,2025-04-15 12:47:15.887
false,false,10031,9428,603,129,00:00:31.000,2025-04-15 12:47:27.900
false,true,10047,9444,603,0,00:00:00.000,2025-04-15 12:47:47.919
false,false,10226,9609,617,95,00:00:30.000,2025-04-15 12:51:43.165
false,false,10279,9660,619,1766,00:00:31.000,2025-04-15 12:52:36.226
false,false,10283,9664,619,1891,00:00:31.000,2025-04-15 12:52:40.231
false,true,10283,9664,619,0,00:00:00.000,2025-04-15 12:52:43.235
false,false,10388,9763,625,223,00:00:31.000,2025-04-15 12:55:01.376
false,false,10402,9775,627,666,00:00:32.000,2025-04-15 12:55:15.389
false,false,10403,9776,627,696,00:00:30.000,2025-04-15 12:55:16.391
false,true,10412,9785,627,0,00:00:00.000,2025-04-15 12:55:28.400
false,false,10416,9789,627,125,00:00:31.000,2025-04-15 12:55:35.407
false,true,10433,9805,628,0,00:00:00.000,2025-04-15 12:56:20.451
false,true,10450,9820,630,0,00:00:00.000,2025-04-15 12:56:40.471
false,false,10482,9849,633,1016,00:00:31.000,2025-04-15 12:57:17.508
false,true,10507,9874,633,0,00:00:00.000,2025-04-15 12:57:46.539
false,true,10507,9874,633,0,00:00:00.000,2025-04-15 12:57:47.540
false,true,10515,9881,634,0,00:00:00.000,2025-04-15 12:57:57.554
false,false,10518,9884,634,93,00:00:30.000,2025-04-15 12:58:05.564
false,false,10522,9888,634,219,00:00:32.000,2025-04-15 12:58:09.568
false,true,10555,9919,636,0,00:00:00.000,2025-04-15 12:58:57.612
false,false,10574,9937,637,470,00:00:30.000,2025-04-15 12:59:25.646
false,false,10587,9949,638,882,00:00:32.000,2025-04-15 12:59:38.657
false,false,10593,9954,639,1071,00:00:32.000,2025-04-15 12:59:44.663
false,true,10333,9710,623,0,00:00:00.000,2025-04-15 12:53:39.289
false,false,10339,9716,623,186,00:00:30.000,2025-04-15 12:53:48.296
false,false,10353,9729,624,627,00:00:32.000,2025-04-15 12:54:02.309
false,true,10367,9743,624,0,00:00:00.000,2025-04-15 12:54:34.343
false,false,10375,9750,625,252,00:00:32.000,2025-04-15 12:54:42.353
false,false,10381,9756,625,441,00:00:32.000,2025-04-15 12:54:48.360
false,false,10611,9970,641,374,00:00:32.000,2025-04-15 13:00:08.686
false,false,10612,9971,641,407,00:00:33.000,2025-04-15 13:00:09.687
false,false,10620,9978,642,659,00:00:33.000,2025-04-15 13:00:17.694
false,false,10651,10008,643,443,00:00:31.000,2025-04-15 13:00:54.732
false,true,10653,10010,643,0,00:00:00.000,2025-04-15 13:01:01.738
false,false,10656,10013,643,93,00:00:30.000,2025-04-15 13:01:11.750
false,false,10658,10015,643,156,00:00:32.000,2025-04-15 13:01:13.751
false,false,10747,10098,649,62,00:00:30.000,2025-04-15 13:03:12.866
false,false,10750,10101,649,156,00:00:30.000,2025-04-15 13:03:15.867
false,true,10818,10168,650,0,00:00:00.000,2025-04-15 13:04:51.961
false,false,10888,10233,655,222,00:00:33.000,2025-04-15 13:06:34.065
false,true,10897,10242,655,0,00:00:00.000,2025-04-15 13:06:44.075
false,false,10921,10265,656,506,00:00:33.000,2025-04-15 13:07:19.112
false,false,10954,10297,657,939,00:00:32.000,2025-04-15 13:07:58.150
false,true,10966,10309,657,0,00:00:00.000,2025-04-15 13:08:18.169
false,true,10975,10318,657,0,00:00:00.000,2025-04-15 13:08:42.193
false,true,10977,10320,657,0,00:00:00.000,2025-04-15 13:08:48.198
false,true,10977,10320,657,0,00:00:00.000,2025-04-15 13:08:49.200
false,true,10991,10334,657,0,00:00:00.000,2025-04-15 13:09:06.217
false,true,10993,10336,657,0,00:00:00.000,2025-04-15 13:09:16.223
false,false,10996,10339,657,98,00:00:33.000,2025-04-15 13:09:22.231
false,false,10687,10043,644,511,00:00:33.000,2025-04-15 13:01:54.788
false,false,10689,10045,644,577,00:00:33.000,2025-04-15 13:01:56.789
false,false,10709,10063,646,342,00:00:32.000,2025-04-15 13:02:22.814
false,false,10726,10077,649,874,00:00:33.000,2025-04-15 13:02:39.832
false,true,10736,10087,649,0,00:00:00.000,2025-04-15 13:02:54.849
false,false,10833,10182,651,467,00:00:30.000,2025-04-15 13:05:08.979
false,true,10833,10182,651,0,00:00:00.000,2025-04-15 13:05:14.985
false,true,10843,10192,651,0,00:00:00.000,2025-04-15 13:05:26.996
false,false,10850,10199,651,219,00:00:33.000,2025-04-15 13:05:38.006
false,false,10861,10209,652,163,00:00:33.000,2025-04-15 13:05:55.026
false,true,10864,10212,652,0,00:00:00.000,2025-04-15 13:06:01.031
false,true,10881,10226,655,0,00:00:00.000,2025-04-15 13:06:24.056
false,false,10152,9544,608,760,00:00:32.000,2025-04-15 12:49:53.054
false,true,10156,9547,609,0,00:00:00.000,2025-04-15 12:50:03.068
false,false,10158,9548,610,63,00:00:32.000,2025-04-15 12:50:05.068
false,false,10166,9555,611,315,00:00:32.000,2025-04-15 12:50:13.076
false,false,10195,9579,616,1225,00:00:31.000,2025-04-15 12:50:42.106
false,false,10203,9587,616,31,00:00:31.000,2025-04-15 12:51:08.126
false,true,10212,9596,616,0,00:00:00.000,2025-04-15 12:51:18.140
false,true,11022,10365,657,0,00:00:00.000,2025-04-15 13:09:55.263
false,true,11039,10380,659,0,00:00:00.000,2025-04-15 13:10:28.291
false,false,11061,10402,659,97,00:00:31.000,2025-04-15 13:10:57.319
false,false,11085,10425,660,405,00:00:30.000,2025-04-15 13:11:27.348
false,false,11086,10426,660,437,00:00:32.000,2025-04-15 13:11:28.348
false,false,11088,10428,660,500,00:00:33.000,2025-04-15 13:11:30.349
false,true,11176,10512,664,0,00:00:00.000,2025-04-15 13:13:30.473
false,false,11186,10522,664,314,00:00:32.000,2025-04-15 13:13:44.488
false,false,11190,10526,664,439,00:00:33.000,2025-04-15 13:13:48.493
false,false,11192,10528,664,502,00:00:30.000,2025-04-15 13:13:50.495
false,false,11196,10532,664,631,00:00:33.000,2025-04-15 13:13:54.499
false,true,11196,10532,664,0,00:00:00.000,2025-04-15 13:13:58.503
false,false,11202,10538,664,187,00:00:31.000,2025-04-15 13:14:06.511
false,false,11217,10551,666,434,00:00:30.000,2025-04-15 13:14:27.535
false,false,11337,10663,674,31,00:00:31.000,2025-04-15 13:17:03.694
false,true,11338,10664,674,0,00:00:00.000,2025-04-15 13:17:09.700
false,false,11344,10670,674,182,00:00:31.000,2025-04-15 13:17:16.705
false,false,11238,10571,667,563,00:00:30.000,2025-04-15 13:14:54.559
false,false,11260,10593,667,1255,00:00:33.000,2025-04-15 13:15:16.584
false,false,11277,10610,667,1790,00:00:32.000,2025-04-15 13:15:33.602
false,true,11279,10611,668,0,00:00:00.000,2025-04-15 13:15:42.609
false,false,11291,10621,670,378,00:00:33.000,2025-04-15 13:15:59.627
false,true,11296,10624,672,0,00:00:00.000,2025-04-15 13:16:07.635
false,false,11123,10460,663,65,00:00:33.000,2025-04-15 13:12:23.409
false,false,11131,10468,663,312,00:00:30.000,2025-04-15 13:12:31.415
false,true,11152,10488,664,0,00:00:00.000,2025-04-15 13:13:04.447
false,false,11157,10493,664,156,00:00:30.000,2025-04-15 13:13:09.453
false,true,11403,10723,680,0,00:00:00.000,2025-04-15 13:18:47.796
false,true,11403,10723,680,0,00:00:00.000,2025-04-15 13:18:51.800
false,true,11410,10729,681,0,00:00:00.000,2025-04-15 13:19:05.808
false,false,11427,10746,681,538,00:00:32.000,2025-04-15 13:19:27.830
false,false,11539,10855,684,502,00:00:32.000,2025-04-15 13:21:43.989
false,true,11547,10862,685,0,00:00:00.000,2025-04-15 13:21:52.997
false,true,11547,10862,685,0,00:00:00.000,2025-04-15 13:21:58.003
false,false,11566,10878,688,444,00:00:31.000,2025-04-15 13:22:29.033
false,true,11572,10883,689,0,00:00:00.000,2025-04-15 13:22:36.039
false,false,11579,10890,689,219,00:00:32.000,2025-04-15 13:22:48.051
false,true,11588,10899,689,0,00:00:00.000,2025-04-15 13:23:01.065
false,false,11596,10907,689,249,00:00:31.000,2025-04-15 13:23:11.072
false,false,11473,10791,682,1991,00:00:31.000,2025-04-15 13:20:13.886
false,false,11486,10803,683,406,00:00:30.000,2025-04-15 13:20:32.907
false,false,11489,10806,683,500,00:00:32.000,2025-04-15 13:20:35.910
false,false,11500,10817,683,32,00:00:32.000,2025-04-15 13:20:52.930
false,false,11599,10910,689,30,00:00:30.000,2025-04-15 13:23:20.082
false,false,11609,10919,690,313,00:00:31.000,2025-04-15 13:23:36.101
false,false,11625,10935,690,379,00:00:31.000,2025-04-15 13:24:04.127
false,false,11632,10942,690,598,00:00:33.000,2025-04-15 13:24:11.135
false,false,11641,10948,693,31,00:00:31.000,2025-04-15 13:24:26.147
false,false,11664,10970,694,758,00:00:30.000,2025-04-15 13:24:49.171
false,false,11739,11041,698,253,00:00:31.000,2025-04-15 13:26:52.301
false,false,11749,11050,699,221,00:00:31.000,2025-04-15 13:27:08.314
false,false,11755,11056,699,414,00:00:32.000,2025-04-15 13:27:14.319
false,true,11758,11058,700,0,00:00:00.000,2025-04-15 13:27:22.329
false,false,11784,11083,701,820,00:00:32.000,2025-04-15 13:27:49.355
false,false,11786,11085,701,881,00:00:31.000,2025-04-15 13:27:51.357
false,false,11800,11098,702,1324,00:00:31.000,2025-04-15 13:28:05.368
false,false,11804,11101,703,1451,00:00:32.000,2025-04-15 13:28:09.369
false,true,11854,11149,705,0,00:00:00.000,2025-04-15 13:29:13.436
false,true,11854,11149,705,0,00:00:00.000,2025-04-15 13:29:15.437
false,false,11671,10977,694,977,00:00:33.000,2025-04-15 13:24:56.178
false,false,11676,10982,694,1135,00:00:31.000,2025-04-15 13:25:01.183
false,true,11685,10990,695,0,00:00:00.000,2025-04-15 13:25:15.198
false,false,11689,10994,695,94,00:00:32.000,2025-04-15 13:25:26.207
false,false,11694,10998,696,250,00:00:32.000,2025-04-15 13:25:31.210
false,true,11931,11222,709,0,00:00:00.000,2025-04-15 13:31:44.601
false,true,11931,11222,709,0,00:00:00.000,2025-04-15 13:31:46.604
false,true,11937,11228,709,0,00:00:00.000,2025-04-15 13:32:09.625
false,false,11942,11232,710,160,00:00:32.000,2025-04-15 13:32:15.629
false,false,11944,11233,711,225,00:00:32.000,2025-04-15 13:32:17.632
false,false,11957,11244,713,645,00:00:33.000,2025-04-15 13:32:30.648
false,false,11972,11258,714,61,00:00:31.000,2025-04-15 13:32:51.678
false,false,11981,11267,714,250,00:00:31.000,2025-04-15 13:33:06.694
false,false,11889,11182,707,62,00:00:31.000,2025-04-15 13:30:40.535
false,true,11894,11185,709,0,00:00:00.000,2025-04-15 13:30:54.549
false,true,11894,11185,709,0,00:00:00.000,2025-04-15 13:30:56.552
false,false,11895,11186,709,32,00:00:32.000,2025-04-15 13:30:58.555
false,false,11900,11191,709,185,00:00:30.000,2025-04-15 13:31:03.559
false,false,11916,11207,709,406,00:00:33.000,2025-04-15 13:31:25.582
true,false,2975,2801,174,96,00:00:31.000,2025-04-14 12:41:29.839
true,false,10406,9779,627,790,00:00:32.000,2025-04-15 12:55:19.394
true,true,10333,9710,623,0,00:00:00.000,2025-04-15 12:53:42.291
true,true,10856,10204,652,0,00:00:00.000,2025-04-15 13:05:50.020
true,false,11033,10374,659,348,00:00:33.000,2025-04-15 13:10:11.275
true,true,11403,10723,680,0,00:00:00.000,2025-04-15 13:18:49.797
true,false,11438,10757,681,883,00:00:31.000,2025-04-15 13:19:38.841
true,true,9792,9205,587,0,00:00:00.000,2025-04-15 12:41:43.545
true,true,10966,10309,657,0,00:00:00.000,2025-04-15 13:08:20.170
true,false,11233,10566,667,409,00:00:31.000,2025-04-15 13:14:49.555
true,false,11301,10628,673,159,00:00:33.000,2025-04-15 13:16:15.643
true,false,11543,10859,684,630,00:00:32.000,2025-04-15 13:21:47.993
true,false,11628,10938,690,472,00:00:30.000,2025-04-15 13:24:07.131
true,false,11827,11123,704,502,00:00:32.000,2025-04-15 13:28:38.403
true,true,11845,11140,705,0,00:00:00.000,2025-04-15 13:29:01.421
true,true,2972,2798,174,0,00:00:00.000,2025-04-14 12:41:17.831
true,false,10107,9500,607,1322,00:00:30.000,2025-04-15 12:49:01.997
true,true,10128,9520,608,0,00:00:00.000,2025-04-15 12:49:29.027
true,true,10027,9424,603,0,00:00:00.000,2025-04-15 12:47:21.891
true,false,10669,10026,643,251,00:00:32.000,2025-04-15 13:01:30.764
true,false,10896,10241,655,473,00:00:33.000,2025-04-15 13:06:42.071
true,false,10960,10303,657,1125,00:00:32.000,2025-04-15 13:08:04.156
true,true,11549,10863,686,0,00:00:00.000,2025-04-15 13:22:06.012
true,false,11458,10776,682,1521,00:00:32.000,2025-04-15 13:19:58.866
true,false,11467,10785,682,1803,00:00:30.000,2025-04-15 13:20:07.878
true,true,11640,10947,693,0,00:00:00.000,2025-04-15 13:24:20.140
true,true,9792,9205,587,0,00:00:00.000,2025-04-15 12:41:46.548
true,false,9809,9222,587,537,00:00:31.000,2025-04-15 12:42:03.565
true,false,10090,9485,605,783,00:00:30.000,2025-04-15 12:48:44.977
true,true,10013,9411,602,0,00:00:00.000,2025-04-15 12:46:55.863
true,false,10348,9724,624,468,00:00:30.000,2025-04-15 12:53:57.307
true,true,10367,9743,624,0,00:00:00.000,2025-04-15 12:54:33.343
true,false,10940,10283,657,497,00:00:30.000,2025-04-15 13:07:44.137
true,true,10864,10212,652,0,00:00:00.000,2025-04-15 13:06:02.032
true,false,11324,10650,674,878,00:00:31.000,2025-04-15 13:16:38.663
true,false,11266,10599,667,1443,00:00:30.000,2025-04-15 13:15:22.591
true,true,11277,10610,667,0,00:00:00.000,2025-04-15 13:15:36.603
true,false,11848,11143,705,96,00:00:33.000,2025-04-15 13:29:05.425
true,true,9972,9374,598,0,00:00:00.000,2025-04-15 12:45:59.813
true,false,10146,9538,608,571,00:00:33.000,2025-04-15 12:49:47.049
true,false,10588,9950,638,914,00:00:32.000,2025-04-15 12:59:39.657
true,false,10617,9975,642,563,00:00:30.000,2025-04-15 13:00:14.691
true,true,10864,10212,652,0,00:00:00.000,2025-04-15 13:05:59.030
true,true,10200,9584,616,0,00:00:00.000,2025-04-15 12:50:56.118
true,true,10202,9586,616,0,00:00:00.000,2025-04-15 12:51:02.122
true,false,11466,10784,682,1773,00:00:32.000,2025-04-15 13:20:06.876
true,true,11523,10840,683,0,00:00:00.000,2025-04-15 13:21:22.964
true,false,2938,2767,171,976,00:00:32.000,2025-04-14 12:39:27.749
true,false,9786,9200,586,952,00:00:30.000,2025-04-15 12:41:34.535
true,false,9801,9214,587,283,00:00:32.000,2025-04-15 12:41:55.559
true,false,10074,9470,604,286,00:00:32.000,2025-04-15 12:48:28.958
true,false,10086,9482,604,662,00:00:33.000,2025-04-15 12:48:40.973
true,false,10548,9912,636,283,00:00:32.000,2025-04-15 12:58:47.601
true,false,11198,10534,664,61,00:00:31.000,2025-04-15 13:14:02.506
true,true,11352,10678,674,0,00:00:00.000,2025-04-15 13:17:27.718
true,false,11296,10624,672,537,00:00:32.000,2025-04-15 13:16:04.630
true,false,11570,10881,689,573,00:00:33.000,2025-04-15 13:22:33.035
true,false,11846,11141,705,33,00:00:33.000,2025-04-15 13:29:03.423
true,false,11855,11150,705,33,00:00:33.000,2025-04-15 13:29:18.439
true,true,11712,11015,697,0,00:00:00.000,2025-04-15 13:26:09.255
true,false,11926,11217,709,722,00:00:33.000,2025-04-15 13:31:35.590
true,true,9927,9331,596,0,00:00:00.000,2025-04-15 12:44:36.719
true,false,10056,9453,603,277,00:00:31.000,2025-04-15 12:47:58.929
true,false,10421,9794,627,62,00:00:30.000,2025-04-15 12:55:46.417
true,false,10179,9568,611,727,00:00:32.000,2025-04-15 12:50:26.088
true,true,11277,10610,667,0,00:00:00.000,2025-04-15 13:15:35.603
true,false,11519,10836,683,253,00:00:32.000,2025-04-15 13:21:17.957
true,false,9857,9265,592,154,00:00:30.000,2025-04-15 12:43:09.633
true,false,10258,9640,618,1103,00:00:31.000,2025-04-15 12:52:15.201
true,false,10313,9691,622,937,00:00:32.000,2025-04-15 12:53:16.262
true,false,10910,10255,655,161,00:00:33.000,2025-04-15 13:07:08.100
true,false,11223,10556,667,96,00:00:31.000,2025-04-15 13:14:39.545
true,true,11473,10791,682,0,00:00:00.000,2025-04-15 13:20:14.887
true,false,11756,11057,699,444,00:00:30.000,2025-04-15 13:27:15.320
true,false,11709,11012,697,220,00:00:33.000,2025-04-15 13:25:58.244
true,true,11970,11256,714,0,00:00:00.000,2025-04-15 13:32:47.669
true,true,9940,9344,596,0,00:00:00.000,2025-04-15 12:45:01.743
true,true,10760,10111,649,0,00:00:00.000,2025-04-15 13:03:27.875
true,false,10966,10309,657,192,00:00:32.000,2025-04-15 13:08:16.167
true,true,10833,10182,651,0,00:00:00.000,2025-04-15 13:05:11.983
true,true,11613,10923,690,0,00:00:00.000,2025-04-15 13:23:48.111
true,true,2962,2789,173,0,00:00:00.000,2025-04-14 12:40:29.789
true,false,3008,2832,176,469,00:00:31.000,2025-04-14 12:43:11.928
true,false,10150,9542,608,695,00:00:32.000,2025-04-15 12:49:51.053
true,false,9922,9326,596,316,00:00:30.000,2025-04-15 12:44:26.711
true,false,10358,9734,624,30,00:00:30.000,2025-04-15 12:54:13.321
true,false,10151,9543,608,728,00:00:33.000,2025-04-15 12:49:52.054
true,true,11685,10990,695,0,00:00:00.000,2025-04-15 13:25:12.196
true,true,11983,11269,714,0,00:00:00.000,2025-04-15 13:33:11.697
true,false,9849,9257,592,1803,00:00:32.000,2025-04-15 12:42:43.607
true,false,10064,9460,604,255,00:00:30.000,2025-04-15 12:48:12.944
true,false,9931,9335,596,129,00:00:32.000,2025-04-15 12:44:41.723
true,false,10036,9433,603,284,00:00:30.000,2025-04-15 12:47:32.906
true,false,10512,9879,633,158,00:00:32.000,2025-04-15 12:57:53.549
true,false,10537,9902,635,319,00:00:33.000,2025-04-15 12:58:30.586
true,true,10653,10010,643,0,00:00:00.000,2025-04-15 13:01:07.747
true,false,10995,10338,657,65,00:00:33.000,2025-04-15 13:09:21.229
true,false,10672,10029,643,33,00:00:33.000,2025-04-15 13:01:39.773
true,true,10833,10182,651,0,00:00:00.000,2025-04-15 13:05:10.982
true,false,10162,9552,610,188,00:00:32.000,2025-04-15 12:50:09.072
true,false,10172,9561,611,507,00:00:32.000,2025-04-15 12:50:19.083
true,false,11025,10367,658,93,00:00:30.000,2025-04-15 13:10:03.267
true,false,11153,10489,664,30,00:00:30.000,2025-04-15 13:13:05.448
true,true,11858,11153,705,0,00:00:00.000,2025-04-15 13:29:29.451
true,true,2891,2721,170,0,00:00:00.000,2025-04-14 12:37:25.640
true,true,2907,2737,170,0,00:00:00.000,2025-04-14 12:38:17.692
true,true,10012,9410,602,0,00:00:00.000,2025-04-15 12:46:49.859
true,false,10164,9553,611,251,00:00:33.000,2025-04-15 12:50:11.074
true,false,11323,10649,674,847,00:00:30.000,2025-04-15 13:16:37.662
true,true,11473,10791,682,0,00:00:00.000,2025-04-15 13:20:17.891
true,false,11685,10990,695,1418,00:00:31.000,2025-04-15 13:25:10.193
true,false,2927,2757,170,628,00:00:30.000,2025-04-14 12:39:05.736
true,false,2992,2816,176,65,00:00:33.000,2025-04-14 12:42:27.893
true,false,9882,9288,594,568,00:00:30.000,2025-04-15 12:43:40.665
true,true,9937,9341,596,0,00:00:00.000,2025-04-15 12:44:49.731
true,false,10012,9410,602,1253,00:00:33.000,2025-04-15 12:46:44.853
true,false,10321,9699,622,1182,00:00:30.000,2025-04-15 12:53:24.273
true,true,10653,10010,643,0,00:00:00.000,2025-04-15 13:01:00.737
true,false,10947,10290,657,719,00:00:30.000,2025-04-15 13:07:51.145
true,false,10154,9546,608,823,00:00:33.000,2025-04-15 12:49:55.057
true,false,11280,10612,668,33,00:00:33.000,2025-04-15 13:15:48.617
true,false,11419,10738,681,284,00:00:33.000,2025-04-15 13:19:19.821
true,true,11640,10947,693,0,00:00:00.000,2025-04-15 13:24:25.145
true,true,11937,11228,709,0,00:00:00.000,2025-04-15 13:32:10.625
true,true,11878,11172,706,0,00:00:00.000,2025-04-15 13:30:13.503
true,true,2962,2789,173,0,00:00:00.000,2025-04-14 12:40:51.807
true,true,9849,9257,592,0,00:00:00.000,2025-04-15 12:42:45.608
true,false,10474,9842,632,760,00:00:30.000,2025-04-15 12:57:09.499
true,false,10514,9881,633,220,00:00:32.000,2025-04-15 12:57:55.552
true,false,10350,9726,624,532,00:00:33.000,2025-04-15 12:53:59.308
true,false,10892,10237,655,347,00:00:31.000,2025-04-15 13:06:38.067
true,false,10876,10223,653,379,00:00:33.000,2025-04-15 13:06:16.048
true,false,10183,9572,611,848,00:00:30.000,2025-04-15 12:50:30.092
true,true,10200,9584,616,0,00:00:00.000,2025-04-15 12:50:57.119
true,true,11058,10399,659,0,00:00:00.000,2025-04-15 13:10:51.312
true,false,11368,10694,674,464,00:00:32.000,2025-04-15 13:17:52.746
true,false,11148,10484,664,534,00:00:32.000,2025-04-15 13:12:54.437
true,false,11471,10789,682,1929,00:00:31.000,2025-04-15 13:20:11.882
true,false,11767,11066,701,283,00:00:33.000,2025-04-15 13:27:32.339
true,true,9792,9205,587,0,00:00:00.000,2025-04-15 12:41:45.547
true,true,9940,9344,596,0,00:00:00.000,2025-04-15 12:44:57.739
true,false,9865,9273,592,33,00:00:33.000,2025-04-15 12:43:23.647
true,false,9934,9338,596,226,00:00:32.000,2025-04-15 12:44:44.727
true,false,10034,9431,603,223,00:00:31.000,2025-04-15 12:47:30.904
true,false,10483,9850,633,1048,00:00:32.000,2025-04-15 12:57:18.509
true,false,11120,10457,663,970,00:00:33.000,2025-04-15 13:12:08.390
true,false,11820,11117,703,280,00:00:32.000,2025-04-15 13:28:31.395
true,false,11977,11263,714,127,00:00:32.000,2025-04-15 13:33:02.689
true,false,9800,9213,587,251,00:00:30.000,2025-04-15 12:41:54.558
true,false,10089,9484,605,753,00:00:31.000,2025-04-15 12:48:43.976
true,true,10013,9411,602,0,00:00:00.000,2025-04-15 12:46:52.862
true,false,10293,9673,620,316,00:00:32.000,2025-04-15 12:52:56.245
true,true,10527,9892,635,0,00:00:00.000,2025-04-15 12:58:20.579
true,false,10889,10234,655,253,00:00:31.000,2025-04-15 13:06:35.066
true,false,10929,10273,656,157,00:00:31.000,2025-04-15 13:07:33.124
true,true,10993,10336,657,0,00:00:00.000,2025-04-15 13:09:17.224
true,true,10843,10192,651,0,00:00:00.000,2025-04-15 13:05:25.996
true,false,10869,10217,652,156,00:00:31.000,2025-04-15 13:06:09.041
true,true,11410,10729,681,0,00:00:00.000,2025-04-15 13:19:09.811
true,false,11659,10965,694,605,00:00:32.000,2025-04-15 13:24:44.166
true,false,11829,11125,704,562,00:00:30.000,2025-04-15 13:28:40.405
true,true,11858,11153,705,0,00:00:00.000,2025-04-15 13:29:32.457
true,false,11920,11211,709,531,00:00:31.000,2025-04-15 13:31:29.585
false,false,11922,11213,709,593,00:00:31.000,2025-04-15 13:31:31.587
false,false,11924,11215,709,658,00:00:32.000,2025-04-15 13:31:33.588
false,false,2306,2179,127,1102,00:00:31.000,2025-04-05 22:41:20.351
false,false,2301,2174,127,948,00:00:33.000,2025-04-05 22:38:50.301
false,false,2304,2177,127,1041,00:00:33.000,2025-04-05 22:40:20.328
false,false,2305,2178,127,1071,00:00:30.000,2025-04-05 22:40:50.337
false,false,2303,2176,127,1008,00:00:30.000,2025-04-05 22:39:50.317
false,false,2302,2175,127,978,00:00:30.000,2025-04-05 22:39:20.306
false,false,2307,2180,127,1134,00:00:32.000,2025-04-05 22:41:50.363
false,false,2308,2181,127,1166,00:00:32.000,2025-04-05 22:42:20.374
false,false,2311,2184,127,1262,00:00:31.000,2025-04-05 22:43:50.414
false,false,2309,2182,127,1198,00:00:32.000,2025-04-05 22:42:50.389
false,false,2312,2185,127,1292,00:00:30.000,2025-04-05 22:44:20.429
false,false,2310,2183,127,1231,00:00:33.000,2025-04-05 22:43:20.401
false,false,2313,2186,127,1324,00:00:32.000,2025-04-05 22:44:50.440
false,false,2318,2191,127,1485,00:00:33.000,2025-04-05 22:47:20.499
false,false,2317,2190,127,1452,00:00:32.000,2025-04-05 22:46:50.486
false,false,2315,2188,127,1389,00:00:33.000,2025-04-05 22:45:50.465
false,false,2316,2189,127,1420,00:00:31.000,2025-04-05 22:46:20.478
false,false,2314,2187,127,1356,00:00:32.000,2025-04-05 22:45:20.450
false,false,2319,2192,127,1515,00:00:30.000,2025-04-05 22:47:50.515
false,true,2320,2193,127,0,00:00:00.000,2025-04-05 22:48:50.539
false,false,2320,2193,127,1546,00:00:31.000,2025-04-05 22:48:20.529
false,true,2320,2193,127,0,00:00:00.000,2025-04-05 22:49:50.564
false,true,2320,2193,127,0,00:00:00.000,2025-04-05 22:49:20.552
false,true,2320,2193,127,0,00:00:00.000,2025-04-05 22:50:20.568
false,true,2320,2193,127,0,00:00:00.000,2025-04-05 22:51:20.594
false,false,2321,2194,127,30,00:00:30.000,2025-04-05 22:51:50.609
false,true,2320,2193,127,0,00:00:00.000,2025-04-05 22:50:50.579
false,false,2324,2197,127,125,00:00:32.000,2025-04-05 22:53:20.640
false,false,2323,2196,127,93,00:00:32.000,2025-04-05 22:52:50.629
false,false,2322,2195,127,61,00:00:31.000,2025-04-05 22:52:20.618
false,false,2325,2198,127,158,00:00:33.000,2025-04-05 22:53:50.651
false,false,2328,2201,127,254,00:00:32.000,2025-04-05 22:55:20.687
false,false,2327,2200,127,222,00:00:33.000,2025-04-05 22:54:50.674
false,false,2326,2199,127,189,00:00:31.000,2025-04-05 22:54:20.663
false,false,2331,2203,128,351,00:00:32.000,2025-04-05 22:56:50.716
false,false,2330,2202,128,319,00:00:32.000,2025-04-05 22:56:20.708
false,false,2334,2206,128,447,00:00:32.000,2025-04-05 22:58:20.754
false,false,2332,2204,128,384,00:00:33.000,2025-04-05 22:57:20.731
false,false,2329,2202,127,287,00:00:33.000,2025-04-05 22:55:50.694
false,false,2333,2205,128,415,00:00:31.000,2025-04-05 22:57:50.741
false,false,2335,2207,128,477,00:00:30.000,2025-04-05 22:58:50.767
false,false,2336,2208,128,510,00:00:33.000,2025-04-05 22:59:20.780
false,true,2338,2210,128,0,00:00:00.000,2025-04-05 23:00:50.814
false,false,2337,2209,128,543,00:00:33.000,2025-04-05 22:59:50.788
false,true,2338,2210,128,0,00:00:00.000,2025-04-05 23:01:20.830
false,false,2338,2210,128,576,00:00:33.000,2025-04-05 23:00:20.799
false,true,2338,2210,128,0,00:00:00.000,2025-04-05 23:01:50.839
false,true,2338,2210,128,0,00:00:00.000,2025-04-05 23:02:20.855
false,true,2338,2210,128,0,00:00:00.000,2025-04-05 23:02:50.870
false,false,2340,2212,128,60,00:00:30.000,2025-04-05 23:04:20.904
false,false,2339,2211,128,30,00:00:30.000,2025-04-05 23:03:50.896
false,false,2341,2213,128,92,00:00:32.000,2025-04-05 23:04:50.919
false,true,2338,2210,128,0,00:00:00.000,2025-04-05 23:03:20.883
false,false,2343,2215,128,156,00:00:33.000,2025-04-05 23:05:50.932
false,false,2342,2214,128,123,00:00:31.000,2025-04-05 23:05:20.925
false,false,2344,2216,128,186,00:00:30.000,2025-04-05 23:06:20.936
false,false,2345,2217,128,218,00:00:32.000,2025-04-05 23:06:50.945
false,false,2346,2218,128,248,00:00:30.000,2025-04-05 23:07:20.959
false,false,2347,2219,128,278,00:00:30.000,2025-04-05 23:07:50.968
false,true,2347,2219,128,0,00:00:00.000,2025-04-05 23:08:20.978
false,true,2347,2219,128,0,00:00:00.000,2025-04-05 23:09:51.017
false,true,2347,2219,128,0,00:00:00.000,2025-04-05 23:08:50.993
false,true,2347,2219,128,0,00:00:00.000,2025-04-05 23:09:21.006
false,true,2347,2219,128,0,00:00:00.000,2025-04-05 23:10:21.030
false,true,2347,2219,128,0,00:00:00.000,2025-04-05 23:10:51.037
false,false,2348,2220,128,33,00:00:33.000,2025-04-05 23:11:21.051
false,false,2349,2221,128,66,00:00:33.000,2025-04-05 23:11:51.064
false,false,2353,2225,128,190,00:00:30.000,2025-04-05 23:13:51.102
false,false,2351,2223,128,127,00:00:31.000,2025-04-05 23:12:51.078
false,false,2352,2224,128,160,00:00:33.000,2025-04-05 23:13:21.093
false,false,2350,2222,128,96,00:00:30.000,2025-04-05 23:12:21.078
false,false,2354,2226,128,223,00:00:33.000,2025-04-05 23:14:21.114
false,false,2356,2228,128,288,00:00:32.000,2025-04-05 23:15:21.139
false,false,2355,2227,128,256,00:00:33.000,2025-04-05 23:14:51.126
false,false,2357,2229,128,319,00:00:31.000,2025-04-05 23:15:51.154
false,false,2358,2230,128,351,00:00:32.000,2025-04-05 23:16:21.161
false,true,2358,2230,128,0,00:00:00.000,2025-04-05 23:16:51.173
false,true,2358,2230,128,0,00:00:00.000,2025-04-05 23:17:51.194
false,true,2358,2230,128,0,00:00:00.000,2025-04-05 23:18:21.206
false,true,2358,2230,128,0,00:00:00.000,2025-04-05 23:17:21.183
false,true,2358,2230,128,0,00:00:00.000,2025-04-05 23:18:51.217
false,false,2359,2231,128,31,00:00:31.000,2025-04-05 23:19:51.232
false,false,2361,2232,129,95,00:00:33.000,2025-04-05 23:20:51.259
false,true,2358,2230,128,0,00:00:00.000,2025-04-05 23:19:21.222
false,false,2360,2232,128,62,00:00:31.000,2025-04-05 23:20:21.245
false,false,2363,2234,129,159,00:00:31.000,2025-04-05 23:21:51.288
false,false,2365,2236,129,224,00:00:32.000,2025-04-05 23:22:51.313
false,false,2366,2237,129,255,00:00:31.000,2025-04-05 23:23:21.327
false,false,2362,2233,129,128,00:00:33.000,2025-04-05 23:21:21.274
false,false,2367,2238,129,286,00:00:31.000,2025-04-05 23:23:51.339
false,false,2364,2235,129,192,00:00:33.000,2025-04-05 23:22:21.298
false,false,2368,2239,129,319,00:00:33.000,2025-04-05 23:24:21.350
false,false,2369,2240,129,350,00:00:31.000,2025-04-05 23:24:51.362
false,false,2370,2241,129,382,00:00:32.000,2025-04-05 23:25:21.374
false,false,2372,2243,129,445,00:00:30.000,2025-04-05 23:26:21.399
false,false,2371,2242,129,415,00:00:33.000,2025-04-05 23:25:51.384
false,false,2373,2244,129,478,00:00:33.000,2025-04-05 23:26:51.407
false,false,2374,2245,129,511,00:00:33.000,2025-04-05 23:27:21.420
false,false,2375,2246,129,542,00:00:31.000,2025-04-05 23:27:51.434
false,false,2378,2249,129,635,00:00:32.000,2025-04-05 23:29:21.477
false,false,2377,2248,129,603,00:00:30.000,2025-04-05 23:28:51.463
false,false,2380,2250,130,697,00:00:31.000,2025-04-05 23:30:21.499
false,false,2379,2249,130,666,00:00:31.000,2025-04-05 23:29:51.487
false,false,2376,2247,129,573,00:00:31.000,2025-04-05 23:28:21.449
false,true,2380,2250,130,0,00:00:00.000,2025-04-05 23:30:51.508
false,true,2380,2250,130,0,00:00:00.000,2025-04-05 23:31:21.521
false,true,2380,2250,130,0,00:00:00.000,2025-04-05 23:31:51.532
false,true,2380,2250,130,0,00:00:00.000,2025-04-05 23:32:51.556
false,true,2380,2250,130,0,00:00:00.000,2025-04-05 23:32:21.544
false,true,2380,2250,130,0,00:00:00.000,2025-04-05 23:33:21.568
false,false,2381,2251,130,32,00:00:32.000,2025-04-05 23:33:51.581
false,false,2382,2252,130,62,00:00:30.000,2025-04-05 23:34:21.585
false,true,2383,2253,130,0,00:00:00.000,2025-04-05 23:35:21.611
false,true,2383,2253,130,0,00:00:00.000,2025-04-05 23:36:51.644
false,true,2383,2253,130,0,00:00:00.000,2025-04-05 23:35:51.626
false,true,2383,2253,130,0,00:00:00.000,2025-04-05 23:36:21.637
false,false,2383,2253,130,95,00:00:33.000,2025-04-05 23:34:51.597
false,true,2383,2253,130,0,00:00:00.000,2025-04-05 23:37:21.653
false,true,2383,2253,130,0,00:00:00.000,2025-04-05 23:37:51.665
false,false,2385,2255,130,62,00:00:32.000,2025-04-05 23:38:51.686
false,false,2384,2254,130,30,00:00:30.000,2025-04-05 23:38:21.674
false,false,2386,2256,130,93,00:00:31.000,2025-04-05 23:39:21.700
false,false,2389,2257,132,185,00:00:31.000,2025-04-05 23:40:51.736
false,false,2388,2256,132,154,00:00:31.000,2025-04-05 23:40:21.723
false,false,2390,2258,132,217,00:00:32.000,2025-04-05 23:41:21.746
false,false,2387,2256,131,123,00:00:30.000,2025-04-05 23:39:51.710
false,false,2391,2259,132,247,00:00:30.000,2025-04-05 23:41:51.752
false,false,4014,3786,228,189,00:00:31.000,2025-04-06 18:46:48.069
false,false,4013,3785,228,158,00:00:31.000,2025-04-06 18:46:18.057
false,false,4016,3788,228,252,00:00:33.000,2025-04-06 18:47:48.089
false,false,4017,3789,228,284,00:00:32.000,2025-04-06 18:48:18.097
false,false,4012,3784,228,127,00:00:33.000,2025-04-06 18:45:48.046
false,false,4015,3787,228,219,00:00:30.000,2025-04-06 18:47:18.081
false,false,4018,3790,228,317,00:00:33.000,2025-04-06 18:48:48.109
false,false,4019,3791,228,350,00:00:33.000,2025-04-06 18:49:18.121
false,true,4022,3794,228,0,00:00:00.000,2025-04-06 18:51:18.169
false,false,4021,3793,228,413,00:00:30.000,2025-04-06 18:50:18.147
false,false,4022,3794,228,444,00:00:31.000,2025-04-06 18:50:48.159
false,true,4022,3794,228,0,00:00:00.000,2025-04-06 18:51:48.181
false,true,4022,3794,228,0,00:00:00.000,2025-04-06 18:52:18.193
false,false,4020,3792,228,383,00:00:33.000,2025-04-06 18:49:48.134
false,true,4022,3794,228,0,00:00:00.000,2025-04-06 18:53:18.217
false,true,4022,3794,228,0,00:00:00.000,2025-04-06 18:52:48.205
false,true,4022,3794,228,0,00:00:00.000,2025-04-06 18:53:48.225
false,false,4023,3795,228,32,00:00:32.000,2025-04-06 18:54:18.237
false,false,4024,3796,228,62,00:00:30.000,2025-04-06 18:54:48.248
false,false,4025,3797,228,94,00:00:32.000,2025-04-06 18:55:18.260
false,false,4027,3799,228,158,00:00:31.000,2025-04-06 18:56:18.283
false,false,4030,3802,228,253,00:00:33.000,2025-04-06 18:57:48.317
false,false,4028,3800,228,188,00:00:30.000,2025-04-06 18:56:48.295
false,false,4031,3803,228,284,00:00:31.000,2025-04-06 18:58:18.330
false,false,4026,3798,228,127,00:00:33.000,2025-04-06 18:55:48.271
false,false,4029,3801,228,220,00:00:32.000,2025-04-06 18:57:18.307
false,false,4032,3804,228,316,00:00:32.000,2025-04-06 18:58:48.341
false,false,4033,3805,228,349,00:00:33.000,2025-04-06 18:59:18.351
false,false,4037,3809,228,476,00:00:33.000,2025-04-06 19:01:18.394
false,false,4034,3806,228,380,00:00:31.000,2025-04-06 18:59:48.363
false,false,4035,3807,228,412,00:00:32.000,2025-04-06 19:00:18.373
false,false,4036,3808,228,443,00:00:31.000,2025-04-06 19:00:48.382
false,false,4038,3810,228,508,00:00:32.000,2025-04-06 19:01:48.404
false,false,4039,3811,228,539,00:00:31.000,2025-04-06 19:02:18.416
false,false,4040,3812,228,571,00:00:32.000,2025-04-06 19:02:48.428
false,false,4042,3814,228,633,00:00:32.000,2025-04-06 19:03:48.451
false,false,4041,3813,228,601,00:00:30.000,2025-04-06 19:03:18.440
false,false,4044,3816,228,696,00:00:30.000,2025-04-06 19:04:48.476
false,false,4046,3817,229,759,00:00:32.000,2025-04-06 19:05:48.498
false,false,4045,3817,228,727,00:00:31.000,2025-04-06 19:05:18.486
false,false,4043,3815,228,666,00:00:33.000,2025-04-06 19:04:18.463
false,false,4047,3818,229,792,00:00:33.000,2025-04-06 19:06:18.508
false,false,4048,3819,229,825,00:00:33.000,2025-04-06 19:06:48.520
false,false,4049,3820,229,858,00:00:33.000,2025-04-06 19:07:18.531
false,false,4050,3821,229,888,00:00:30.000,2025-04-06 19:07:48.543
false,false,4051,3822,229,919,00:00:31.000,2025-04-06 19:08:18.555
false,true,4051,3822,229,0,00:00:00.000,2025-04-06 19:08:48.565
false,true,4051,3822,229,0,00:00:00.000,2025-04-06 19:09:48.587
false,false,4052,3823,229,31,00:00:31.000,2025-04-06 19:11:48.619
false,true,4051,3822,229,0,00:00:00.000,2025-04-06 19:09:18.576
false,true,4051,3822,229,0,00:00:00.000,2025-04-06 19:10:18.597
false,true,4051,3822,229,0,00:00:00.000,2025-04-06 19:10:48.607
false,true,4051,3822,229,0,00:00:00.000,2025-04-06 19:11:18.610
false,false,4054,3824,230,94,00:00:33.000,2025-04-06 19:12:48.638
false,true,4055,3825,230,0,00:00:00.000,2025-04-06 19:13:48.657
false,false,4053,3823,230,61,00:00:30.000,2025-04-06 19:12:18.630
false,false,4055,3825,230,125,00:00:31.000,2025-04-06 19:13:18.648
false,true,4055,3825,230,0,00:00:00.000,2025-04-06 19:14:18.666
false,true,4055,3825,230,0,00:00:00.000,2025-04-06 19:14:48.677
false,true,4055,3825,230,0,00:00:00.000,2025-04-06 19:15:48.701
false,false,4057,3827,230,62,00:00:30.000,2025-04-06 19:17:18.734
false,false,4056,3826,230,32,00:00:32.000,2025-04-06 19:16:48.724
false,true,4055,3825,230,0,00:00:00.000,2025-04-06 19:16:18.712
false,false,4058,3827,231,92,00:00:30.000,2025-04-06 19:17:48.746
false,false,4059,3828,231,122,00:00:30.000,2025-04-06 19:18:18.755
false,true,4055,3825,230,0,00:00:00.000,2025-04-06 19:15:18.689
false,true,4061,3828,233,0,00:00:00.000,2025-04-06 19:20:18.797
false,false,4061,3828,233,184,00:00:32.000,2025-04-06 19:19:18.778
false,false,4060,3828,232,152,00:00:30.000,2025-04-06 19:18:48.766
false,true,4061,3828,233,0,00:00:00.000,2025-04-06 19:19:48.790
false,true,4061,3828,233,0,00:00:00.000,2025-04-06 19:21:18.814
false,true,4061,3828,233,0,00:00:00.000,2025-04-06 19:22:18.832
false,true,4061,3828,233,0,00:00:00.000,2025-04-06 19:20:48.804
false,true,4061,3828,233,0,00:00:00.000,2025-04-06 19:23:18.856
false,true,4061,3828,233,0,00:00:00.000,2025-04-06 19:22:48.844
false,true,4061,3828,233,0,00:00:00.000,2025-04-06 19:21:48.822
false,true,4061,3828,233,0,00:00:00.000,2025-04-06 19:23:48.867
false,true,4061,3828,233,0,00:00:00.000,2025-04-06 19:25:18.893
false,true,4061,3828,233,0,00:00:00.000,2025-04-06 19:24:18.871
false,true,4061,3828,233,0,00:00:00.000,2025-04-06 19:24:48.881
false,false,4062,3829,233,33,00:00:33.000,2025-04-06 19:25:48.902
false,false,4064,3831,233,98,00:00:32.000,2025-04-06 19:26:48.915
false,false,4066,3833,233,161,00:00:33.000,2025-04-06 19:27:48.934
false,false,4063,3830,233,66,00:00:33.000,2025-04-06 19:26:18.904
false,false,4065,3832,233,128,00:00:30.000,2025-04-06 19:27:18.927
false,true,4066,3833,233,0,00:00:00.000,2025-04-06 19:28:18.945
false,true,4066,3833,233,0,00:00:00.000,2025-04-06 19:28:48.955
false,true,4066,3833,233,0,00:00:00.000,2025-04-06 19:29:48.977
false,true,4066,3833,233,0,00:00:00.000,2025-04-06 19:30:18.986
false,false,4067,3834,233,31,00:00:31.000,2025-04-06 19:31:19.002
false,true,4066,3833,233,0,00:00:00.000,2025-04-06 19:29:18.966
false,false,4068,3835,233,61,00:00:30.000,2025-04-06 19:31:49.010
false,false,4071,3838,233,156,00:00:30.000,2025-04-06 19:33:19.039
false,false,4072,3839,233,186,00:00:30.000,2025-04-06 19:33:49.049
false,false,4070,3837,233,126,00:00:32.000,2025-04-06 19:32:49.032
false,true,4066,3833,233,0,00:00:00.000,2025-04-06 19:30:48.993
false,false,4069,3836,233,94,00:00:33.000,2025-04-06 19:32:19.022
false,false,4073,3840,233,216,00:00:30.000,2025-04-06 19:34:19.061
false,true,4073,3840,233,0,00:00:00.000,2025-04-06 19:34:49.073
false,true,4073,3840,233,0,00:00:00.000,2025-04-06 19:35:49.097
false,true,4073,3840,233,0,00:00:00.000,2025-04-06 19:35:19.085
false,true,4073,3840,233,0,00:00:00.000,2025-04-06 19:36:19.106
false,true,4073,3840,233,0,00:00:00.000,2025-04-06 19:36:49.117
false,true,4073,3840,233,0,00:00:00.000,2025-04-06 19:37:19.128
false,false,4075,3842,233,61,00:00:31.000,2025-04-06 19:38:19.147
false,false,4076,3843,233,93,00:00:32.000,2025-04-06 19:38:49.159
false,false,4077,3844,233,123,00:00:30.000,2025-04-06 19:39:19.168
false,false,4078,3845,233,154,00:00:31.000,2025-04-06 19:39:49.180
false,false,4074,3841,233,30,00:00:30.000,2025-04-06 19:37:49.136
false,false,4080,3847,233,218,00:00:33.000,2025-04-06 19:40:49.198
false,false,4079,3846,233,185,00:00:31.000,2025-04-06 19:40:19.186
false,false,4081,3848,233,251,00:00:33.000,2025-04-06 19:41:19.208
false,true,4081,3848,233,0,00:00:00.000,2025-04-06 19:41:49.220
false,true,4081,3848,233,0,00:00:00.000,2025-04-06 19:42:19.231
false,true,4081,3848,233,0,00:00:00.000,2025-04-06 19:42:49.242
false,true,4081,3848,233,0,00:00:00.000,2025-04-06 19:43:19.254
false,true,4081,3848,233,0,00:00:00.000,2025-04-06 19:44:19.276
false,true,4081,3848,233,0,00:00:00.000,2025-04-06 19:43:49.266
false,false,4082,3848,234,30,00:00:30.000,2025-04-06 19:44:49.284
false,false,4083,3849,234,61,00:00:31.000,2025-04-06 19:45:19.294
false,false,4084,3850,234,94,00:00:33.000,2025-04-06 19:45:49.299
false,false,4085,3851,234,125,00:00:31.000,2025-04-06 19:46:19.309
false,false,951,896,55,30,00:00:30.000,2025-04-05 07:44:29.948
false,true,950,895,55,0,00:00:00.000,2025-04-05 07:43:59.936
false,true,950,895,55,0,00:00:00.000,2025-04-05 07:43:29.926
false,true,950,895,55,0,00:00:00.000,2025-04-05 07:42:59.917
false,true,950,895,55,0,00:00:00.000,2025-04-05 07:42:29.905
false,true,950,895,55,0,00:00:00.000,2025-04-05 07:41:59.891
false,false,955,900,55,158,00:00:32.000,2025-04-05 07:46:29.987
false,false,953,898,55,93,00:00:31.000,2025-04-05 07:45:29.969
false,false,954,899,55,126,00:00:33.000,2025-04-05 07:45:59.972
false,false,957,902,55,220,00:00:32.000,2025-04-05 07:47:30.010
false,false,956,901,55,188,00:00:30.000,2025-04-05 07:46:59.998
false,false,952,897,55,62,00:00:32.000,2025-04-05 07:44:59.961
false,false,963,908,55,406,00:00:31.000,2025-04-05 07:50:30.082
false,false,960,905,55,314,00:00:31.000,2025-04-05 07:49:00.049
false,false,961,906,55,345,00:00:31.000,2025-04-05 07:49:30.056
false,false,962,907,55,375,00:00:30.000,2025-04-05 07:50:00.071
false,false,959,904,55,283,00:00:32.000,2025-04-05 07:48:30.036
false,false,958,903,55,251,00:00:31.000,2025-04-05 07:48:00.025
false,true,964,909,55,0,00:00:00.000,2025-04-05 07:52:30.117
false,true,964,909,55,0,00:00:00.000,2025-04-05 07:52:00.107
false,true,964,909,55,0,00:00:00.000,2025-04-05 07:51:30.098
false,false,964,909,55,439,00:00:33.000,2025-04-05 07:51:00.093
false,true,964,909,55,0,00:00:00.000,2025-04-05 07:53:30.127
false,true,964,909,55,0,00:00:00.000,2025-04-05 07:53:00.121
false,true,964,909,55,0,00:00:00.000,2025-04-05 07:54:00.143
false,false,965,910,55,31,00:00:31.000,2025-04-05 07:54:30.157
false,false,967,912,55,93,00:00:31.000,2025-04-05 07:55:30.176
false,false,968,913,55,124,00:00:31.000,2025-04-05 07:56:00.176
false,false,969,914,55,154,00:00:30.000,2025-04-05 07:56:30.187
false,false,970,915,55,184,00:00:30.000,2025-04-05 07:57:00.200
false,false,972,917,55,247,00:00:33.000,2025-04-05 07:58:00.224
false,false,966,911,55,62,00:00:31.000,2025-04-05 07:55:00.170
false,false,971,916,55,214,00:00:30.000,2025-04-05 07:57:30.213
false,true,973,918,55,0,00:00:00.000,2025-04-05 07:59:00.247
false,false,973,918,55,277,00:00:30.000,2025-04-05 07:58:30.237
false,true,973,918,55,0,00:00:00.000,2025-04-05 07:59:30.257
false,true,973,918,55,0,00:00:00.000,2025-04-05 08:00:30.282
false,true,973,918,55,0,00:00:00.000,2025-04-05 08:01:00.283
false,false,975,920,55,64,00:00:32.000,2025-04-05 08:02:30.318
false,true,973,918,55,0,00:00:00.000,2025-04-05 08:00:00.269
false,true,973,918,55,0,00:00:00.000,2025-04-05 08:01:30.298
false,false,974,919,55,32,00:00:32.000,2025-04-05 08:02:00.306
false,false,977,922,55,129,00:00:33.000,2025-04-05 08:03:30.343
false,false,979,924,55,192,00:00:31.000,2025-04-05 08:04:30.370
false,false,976,921,55,96,00:00:32.000,2025-04-05 08:03:00.329
false,false,978,923,55,161,00:00:32.000,2025-04-05 08:04:00.358
false,false,981,926,55,256,00:00:33.000,2025-04-05 08:05:30.399
false,false,980,925,55,223,00:00:31.000,2025-04-05 08:05:00.385
false,false,985,929,56,382,00:00:31.000,2025-04-05 08:07:30.448
false,false,984,928,56,351,00:00:31.000,2025-04-05 08:07:00.436
false,false,983,928,55,320,00:00:32.000,2025-04-05 08:06:30.425
false,true,986,930,56,0,00:00:00.000,2025-04-05 08:08:30.470
false,false,986,930,56,415,00:00:33.000,2025-04-05 08:08:00.463
false,false,982,927,55,288,00:00:32.000,2025-04-05 08:06:00.413
false,true,986,930,56,0,00:00:00.000,2025-04-05 08:09:00.481
false,true,986,930,56,0,00:00:00.000,2025-04-05 08:10:30.519
false,false,987,930,57,32,00:00:32.000,2025-04-05 08:11:30.530
false,true,986,930,56,0,00:00:00.000,2025-04-05 08:11:00.524
false,true,986,930,56,0,00:00:00.000,2025-04-05 08:10:00.507
false,true,986,930,56,0,00:00:00.000,2025-04-05 08:09:30.493
false,false,988,931,57,62,00:00:30.000,2025-04-05 08:12:00.535
false,true,988,931,57,0,00:00:00.000,2025-04-05 08:13:00.563
false,true,988,931,57,0,00:00:00.000,2025-04-05 08:13:30.576
false,true,988,931,57,0,00:00:00.000,2025-04-05 08:14:30.595
false,true,988,931,57,0,00:00:00.000,2025-04-05 08:14:00.583
false,true,988,931,57,0,00:00:00.000,2025-04-05 08:15:00.609
false,true,988,931,57,0,00:00:00.000,2025-04-05 08:12:30.549
false,true,989,932,57,0,00:00:00.000,2025-04-05 08:16:00.636
false,true,989,932,57,0,00:00:00.000,2025-04-05 08:17:00.650
false,true,989,932,57,0,00:00:00.000,2025-04-05 08:16:30.643
false,true,989,932,57,0,00:00:00.000,2025-04-05 08:18:30.678
false,false,989,932,57,33,00:00:33.000,2025-04-05 08:15:30.622
false,true,989,932,57,0,00:00:00.000,2025-04-05 08:18:00.675
false,true,989,932,57,0,00:00:00.000,2025-04-05 08:17:30.665
false,false,990,933,57,33,00:00:33.000,2025-04-05 08:19:00.692
false,false,992,935,57,99,00:00:33.000,2025-04-05 08:20:00.714
false,false,993,936,57,131,00:00:32.000,2025-04-05 08:20:30.719
false,false,991,934,57,66,00:00:33.000,2025-04-05 08:19:30.702
false,false,995,938,57,195,00:00:33.000,2025-04-05 08:21:30.741
false,false,994,937,57,162,00:00:31.000,2025-04-05 08:21:00.734
false,false,998,941,57,290,00:00:31.000,2025-04-05 08:23:00.760
false,false,999,942,57,322,00:00:32.000,2025-04-05 08:23:30.770
false,false,997,940,57,259,00:00:33.000,2025-04-05 08:22:30.759
false,false,996,939,57,226,00:00:31.000,2025-04-05 08:22:00.753
false,false,1000,943,57,354,00:00:32.000,2025-04-05 08:24:00.781
false,false,1001,944,57,385,00:00:31.000,2025-04-05 08:24:30.794
false,false,1002,945,57,417,00:00:32.000,2025-04-05 08:25:00.806
false,false,1003,946,57,447,00:00:30.000,2025-04-05 08:25:30.814
false,false,1007,950,57,572,00:00:32.000,2025-04-05 08:27:30.859
false,false,1004,947,57,479,00:00:32.000,2025-04-05 08:26:00.828
false,false,1005,948,57,509,00:00:30.000,2025-04-05 08:26:30.836
false,false,1006,949,57,540,00:00:31.000,2025-04-05 08:27:00.848
false,false,1008,951,57,604,00:00:32.000,2025-04-05 08:28:00.872
false,true,1008,951,57,0,00:00:00.000,2025-04-05 08:29:00.898
false,true,1008,951,57,0,00:00:00.000,2025-04-05 08:30:00.917
false,true,1008,951,57,0,00:00:00.000,2025-04-05 08:29:30.903
false,true,1008,951,57,0,00:00:00.000,2025-04-05 08:28:30.883
false,true,1008,951,57,0,00:00:00.000,2025-04-05 08:30:30.931
false,true,1008,951,57,0,00:00:00.000,2025-04-05 08:31:00.944
false,false,1010,953,57,63,00:00:31.000,2025-04-05 08:32:00.955
false,false,1013,955,58,157,00:00:30.000,2025-04-05 08:33:30.992
false,false,1009,952,57,32,00:00:32.000,2025-04-05 08:31:30.949
false,false,1011,953,58,95,00:00:32.000,2025-04-05 08:32:30.965
false,false,1012,954,58,127,00:00:32.000,2025-04-05 08:33:00.977
false,false,1014,956,58,187,00:00:30.000,2025-04-05 08:34:00.999
false,true,1015,957,58,0,00:00:00.000,2025-04-05 08:35:01.022
false,true,1015,957,58,0,00:00:00.000,2025-04-05 08:35:31.036
false,false,1015,957,58,220,00:00:33.000,2025-04-05 08:34:31.011
false,true,1015,957,58,0,00:00:00.000,2025-04-05 08:36:01.051
false,true,1015,957,58,0,00:00:00.000,2025-04-05 08:36:31.062
false,true,1015,957,58,0,00:00:00.000,2025-04-05 08:37:31.081
false,true,1015,957,58,0,00:00:00.000,2025-04-05 08:37:01.066
false,false,1017,959,58,63,00:00:31.000,2025-04-05 08:38:31.102
false,false,1019,960,59,127,00:00:33.000,2025-04-05 08:39:31.127
false,true,1019,960,59,0,00:00:00.000,2025-04-05 08:40:01.142
false,false,1018,960,58,94,00:00:31.000,2025-04-05 08:39:01.116
false,true,1019,960,59,0,00:00:00.000,2025-04-05 08:40:31.156
false,false,1016,958,58,32,00:00:32.000,2025-04-05 08:38:01.091
false,true,1019,960,59,0,00:00:00.000,2025-04-05 08:41:01.166
false,true,1019,960,59,0,00:00:00.000,2025-04-05 08:41:31.179
false,true,1019,960,59,0,00:00:00.000,2025-04-05 08:42:01.190
false,true,1019,960,59,0,00:00:00.000,2025-04-05 08:42:31.202
false,false,1020,961,59,31,00:00:31.000,2025-04-05 08:43:01.214
false,false,1021,962,59,64,00:00:33.000,2025-04-05 08:43:31.225
false,false,1023,963,60,127,00:00:30.000,2025-04-05 08:44:31.241
false,false,1022,962,60,97,00:00:33.000,2025-04-05 08:44:01.238
false,false,1025,965,60,190,00:00:33.000,2025-04-05 08:45:31.267
false,false,1024,964,60,157,00:00:30.000,2025-04-05 08:45:01.256
false,true,2088,1970,118,0,00:00:00.000,2025-04-05 20:36:47.429
false,true,2088,1970,118,0,00:00:00.000,2025-04-05 20:35:17.392
false,true,2088,1970,118,0,00:00:00.000,2025-04-05 20:36:17.414
false,false,2088,1970,118,184,00:00:32.000,2025-04-05 20:34:17.373
false,true,2088,1970,118,0,00:00:00.000,2025-04-05 20:35:47.402
false,true,2088,1970,118,0,00:00:00.000,2025-04-05 20:34:47.378
false,false,2093,1974,119,160,00:00:33.000,2025-04-05 20:39:47.497
false,false,2089,1971,118,32,00:00:32.000,2025-04-05 20:37:47.457
false,false,2090,1972,118,65,00:00:33.000,2025-04-05 20:38:17.462
false,false,2092,1974,118,127,00:00:31.000,2025-04-05 20:39:17.486
false,false,2091,1973,118,96,00:00:31.000,2025-04-05 20:38:47.472
false,true,2088,1970,118,0,00:00:00.000,2025-04-05 20:37:17.442
false,false,2094,1975,119,191,00:00:31.000,2025-04-05 20:40:17.501
false,false,2096,1977,119,254,00:00:32.000,2025-04-05 20:41:17.524
false,false,2095,1976,119,222,00:00:31.000,2025-04-05 20:40:47.517
false,false,2098,1979,119,317,00:00:32.000,2025-04-05 20:42:17.549
false,false,2099,1980,119,347,00:00:30.000,2025-04-05 20:42:47.561
false,false,2097,1978,119,285,00:00:31.000,2025-04-05 20:41:47.537
false,false,2101,1982,119,413,00:00:33.000,2025-04-05 20:43:47.587
false,false,2103,1984,119,475,00:00:31.000,2025-04-05 20:44:47.617
false,false,2104,1985,119,506,00:00:31.000,2025-04-05 20:45:17.628
false,false,2102,1983,119,444,00:00:31.000,2025-04-05 20:44:17.602
false,false,2100,1981,119,380,00:00:33.000,2025-04-05 20:43:17.575
false,false,2105,1986,119,539,00:00:33.000,2025-04-05 20:45:47.642
false,false,2106,1987,119,571,00:00:32.000,2025-04-05 20:46:17.658
false,false,2108,1989,119,634,00:00:31.000,2025-04-05 20:47:17.677
false,false,2109,1990,119,664,00:00:30.000,2025-04-05 20:47:47.685
false,false,2107,1988,119,603,00:00:32.000,2025-04-05 20:46:47.665
false,false,2110,1991,119,694,00:00:30.000,2025-04-05 20:48:17.692
false,false,2111,1992,119,727,00:00:33.000,2025-04-05 20:48:47.703
false,false,2112,1993,119,759,00:00:32.000,2025-04-05 20:49:17.714
false,false,2113,1994,119,791,00:00:32.000,2025-04-05 20:49:47.728
false,false,2114,1995,119,823,00:00:32.000,2025-04-05 20:50:17.738
false,false,2115,1996,119,853,00:00:30.000,2025-04-05 20:50:47.747
false,false,2116,1997,119,884,00:00:31.000,2025-04-05 20:51:17.754
false,false,2118,1999,119,944,00:00:30.000,2025-04-05 20:52:17.777
false,false,2117,1998,119,914,00:00:30.000,2025-04-05 20:51:47.762
false,false,2119,2000,119,975,00:00:31.000,2025-04-05 20:52:47.790
false,false,2120,2001,119,1005,00:00:30.000,2025-04-05 20:53:17.797
false,false,2121,2002,119,1036,00:00:31.000,2025-04-05 20:53:47.807
false,false,2122,2003,119,1068,00:00:32.000,2025-04-05 20:54:17.822
false,false,2123,2004,119,1099,00:00:31.000,2025-04-05 20:54:47.837
false,false,2124,2005,119,1130,00:00:31.000,2025-04-05 20:55:17.850
false,false,2125,2006,119,1160,00:00:30.000,2025-04-05 20:55:47.865
false,false,2126,2006,120,1191,00:00:31.000,2025-04-05 20:56:17.880
false,false,2127,2007,120,1223,00:00:32.000,2025-04-05 20:56:47.894
false,false,2128,2008,120,1256,00:00:33.000,2025-04-05 20:57:17.909
false,false,2130,2010,120,1318,00:00:31.000,2025-04-05 20:58:17.931
false,false,2129,2009,120,1287,00:00:31.000,2025-04-05 20:57:47.917
false,false,2132,2012,120,1383,00:00:33.000,2025-04-05 20:59:17.958
false,false,2134,2014,120,1447,00:00:31.000,2025-04-05 21:00:17.978
false,false,2131,2011,120,1350,00:00:32.000,2025-04-05 20:58:47.944
false,false,2133,2013,120,1416,00:00:33.000,2025-04-05 20:59:47.963
false,false,2135,2015,120,1477,00:00:30.000,2025-04-05 21:00:47.992
false,false,2136,2016,120,1508,00:00:31.000,2025-04-05 21:01:18.006
false,false,2137,2017,120,1540,00:00:32.000,2025-04-05 21:01:48.020
false,false,2138,2018,120,1572,00:00:32.000,2025-04-05 21:02:18.028
false,false,2139,2019,120,1604,00:00:32.000,2025-04-05 21:02:48.037
false,false,2141,2021,120,1667,00:00:32.000,2025-04-05 21:03:48.053
false,false,2140,2020,120,1635,00:00:31.000,2025-04-05 21:03:18.045
false,false,2143,2023,120,1733,00:00:33.000,2025-04-05 21:04:48.082
false,false,2144,2024,120,1766,00:00:33.000,2025-04-05 21:05:18.097
false,false,2142,2022,120,1700,00:00:33.000,2025-04-05 21:04:18.068
false,false,2146,2026,120,1832,00:00:33.000,2025-04-05 21:06:18.125
false,false,2145,2025,120,1799,00:00:33.000,2025-04-05 21:05:48.111
false,false,2147,2027,120,1864,00:00:32.000,2025-04-05 21:06:48.141
false,false,2148,2028,120,1897,00:00:33.000,2025-04-05 21:07:18.143
false,false,2149,2029,120,1927,00:00:30.000,2025-04-05 21:07:48.158
false,false,2151,2031,120,1991,00:00:31.000,2025-04-05 21:08:48.179
false,false,2152,2032,120,2022,00:00:31.000,2025-04-05 21:09:18.191
false,false,2153,2032,121,2053,00:00:31.000,2025-04-05 21:09:48.207
false,false,2154,2033,121,2086,00:00:33.000,2025-04-05 21:10:18.215
false,false,2150,2030,120,1960,00:00:33.000,2025-04-05 21:08:18.171
false,false,2155,2034,121,2117,00:00:31.000,2025-04-05 21:10:48.228
false,false,2156,2035,121,2149,00:00:32.000,2025-04-05 21:11:18.242
false,false,2157,2036,121,2181,00:00:32.000,2025-04-05 21:11:48.251
false,false,2158,2037,121,2214,00:00:33.000,2025-04-05 21:12:18.263
false,false,2160,2039,121,2274,00:00:30.000,2025-04-05 21:13:18.288
false,false,2161,2040,121,2304,00:00:30.000,2025-04-05 21:13:48.294
false,false,2162,2041,121,2336,00:00:32.000,2025-04-05 21:14:18.305
false,false,2159,2038,121,2244,00:00:30.000,2025-04-05 21:12:48.276
false,false,2164,2043,121,2401,00:00:32.000,2025-04-05 21:15:18.329
false,false,2165,2044,121,2432,00:00:31.000,2025-04-05 21:15:48.344
false,true,2167,2046,121,0,00:00:00.000,2025-04-05 21:17:18.378
false,false,2166,2045,121,2463,00:00:31.000,2025-04-05 21:16:18.354
false,false,2163,2042,121,2369,00:00:33.000,2025-04-05 21:14:48.316
false,true,2167,2046,121,0,00:00:00.000,2025-04-05 21:19:18.422
false,true,2167,2046,121,0,00:00:00.000,2025-04-05 21:18:48.408
false,true,2167,2046,121,0,00:00:00.000,2025-04-05 21:17:48.392
false,false,2167,2046,121,2494,00:00:31.000,2025-04-05 21:16:48.366
false,true,2167,2046,121,0,00:00:00.000,2025-04-05 21:18:18.401
false,false,2171,2050,121,127,00:00:33.000,2025-04-05 21:21:48.481
false,false,2172,2051,121,158,00:00:31.000,2025-04-05 21:22:18.496
false,true,2167,2046,121,0,00:00:00.000,2025-04-05 21:19:48.432
false,false,2169,2048,121,61,00:00:30.000,2025-04-05 21:20:48.460
false,false,2168,2047,121,31,00:00:31.000,2025-04-05 21:20:18.446
false,false,2170,2049,121,94,00:00:33.000,2025-04-05 21:21:18.474
false,false,2174,2053,121,219,00:00:31.000,2025-04-05 21:23:18.520
false,false,2175,2054,121,250,00:00:31.000,2025-04-05 21:23:48.530
false,false,2176,2055,121,283,00:00:33.000,2025-04-05 21:24:18.544
false,false,2177,2056,121,316,00:00:33.000,2025-04-05 21:24:48.559
false,false,2173,2052,121,188,00:00:30.000,2025-04-05 21:22:48.506
false,false,2182,2060,122,471,00:00:31.000,2025-04-05 21:27:18.628
false,false,2178,2057,121,348,00:00:32.000,2025-04-05 21:25:18.574
false,false,2179,2058,121,378,00:00:30.000,2025-04-05 21:25:48.584
false,false,2185,2063,122,565,00:00:31.000,2025-04-05 21:28:48.658
false,false,2180,2059,121,408,00:00:30.000,2025-04-05 21:26:18.599
false,false,2184,2062,122,534,00:00:31.000,2025-04-05 21:28:18.653
false,false,2181,2059,122,440,00:00:32.000,2025-04-05 21:26:48.614
false,false,2186,2064,122,596,00:00:31.000,2025-04-05 21:29:18.669
false,false,2183,2061,122,503,00:00:32.000,2025-04-05 21:27:48.640
false,false,2189,2067,122,691,00:00:31.000,2025-04-05 21:30:48.706
false,false,2192,2070,122,788,00:00:33.000,2025-04-05 21:32:18.745
false,false,2188,2066,122,660,00:00:33.000,2025-04-05 21:30:18.695
false,false,2187,2065,122,627,00:00:31.000,2025-04-05 21:29:48.683
false,false,2193,2071,122,819,00:00:31.000,2025-04-05 21:32:48.757
false,false,2194,2072,122,852,00:00:33.000,2025-04-05 21:33:18.768
false,false,2196,2074,122,915,00:00:30.000,2025-04-05 21:34:18.790
false,false,2191,2069,122,755,00:00:32.000,2025-04-05 21:31:48.732
false,false,2190,2068,122,723,00:00:32.000,2025-04-05 21:31:18.720
false,false,2198,2075,123,978,00:00:31.000,2025-04-05 21:35:18.816
false,false,2201,2078,123,1073,00:00:33.000,2025-04-05 21:36:48.855
false,false,2195,2073,122,885,00:00:33.000,2025-04-05 21:33:48.777
false,false,2197,2074,123,947,00:00:32.000,2025-04-05 21:34:48.802
false,false,2202,2079,123,1104,00:00:31.000,2025-04-05 21:37:18.870
false,false,2199,2076,123,1010,00:00:32.000,2025-04-05 21:35:48.826
false,false,2200,2077,123,1040,00:00:30.000,2025-04-05 21:36:18.841
false,false,2397,2265,132,437,00:00:31.000,2025-04-05 23:44:51.818
false,false,2394,2262,132,344,00:00:33.000,2025-04-05 23:43:21.784
false,false,2396,2264,132,406,00:00:32.000,2025-04-05 23:44:21.809
false,false,2392,2260,132,280,00:00:33.000,2025-04-05 23:42:21.758
false,false,2393,2261,132,311,00:00:31.000,2025-04-05 23:42:51.771
false,false,2395,2263,132,374,00:00:30.000,2025-04-05 23:43:51.796
false,false,2399,2267,132,503,00:00:33.000,2025-04-05 23:45:51.834
false,false,2402,2270,132,594,00:00:30.000,2025-04-05 23:47:21.869
false,false,2398,2266,132,470,00:00:33.000,2025-04-05 23:45:21.825
false,false,2403,2271,132,625,00:00:31.000,2025-04-05 23:47:51.877
false,false,2401,2269,132,564,00:00:31.000,2025-04-05 23:46:51.858
false,false,2400,2268,132,533,00:00:30.000,2025-04-05 23:46:21.844
false,false,2407,2275,132,750,00:00:30.000,2025-04-05 23:49:51.931
false,false,2404,2272,132,658,00:00:33.000,2025-04-05 23:48:21.891
false,false,2405,2273,132,688,00:00:30.000,2025-04-05 23:48:51.908
false,false,2408,2276,132,780,00:00:30.000,2025-04-05 23:50:21.946
false,false,2406,2274,132,720,00:00:32.000,2025-04-05 23:49:21.917
false,false,2409,2277,132,812,00:00:32.000,2025-04-05 23:50:51.955
false,false,2410,2278,132,845,00:00:33.000,2025-04-05 23:51:21.969
false,false,2412,2280,132,906,00:00:30.000,2025-04-05 23:52:21.983
false,false,2415,2283,132,1002,00:00:33.000,2025-04-05 23:53:52.018
false,false,2411,2279,132,876,00:00:31.000,2025-04-05 23:51:51.977
false,false,2414,2282,132,969,00:00:32.000,2025-04-05 23:53:22.005
false,false,2416,2283,133,1034,00:00:32.000,2025-04-05 23:54:22.031
false,false,2413,2281,132,937,00:00:31.000,2025-04-05 23:52:51.994
false,false,2417,2283,134,1066,00:00:32.000,2025-04-05 23:54:52.046
false,false,2418,2284,134,1098,00:00:32.000,2025-04-05 23:55:22.057
false,false,2419,2285,134,1129,00:00:31.000,2025-04-05 23:55:52.067
false,false,2420,2286,134,1160,00:00:31.000,2025-04-05 23:56:22.077
false,false,2421,2287,134,1191,00:00:31.000,2025-04-05 23:56:52.087
false,false,2422,2288,134,1224,00:00:33.000,2025-04-05 23:57:22.096
false,false,2425,2291,134,1319,00:00:32.000,2025-04-05 23:58:52.141
false,false,2424,2290,134,1287,00:00:33.000,2025-04-05 23:58:22.126
false,false,2426,2292,134,1352,00:00:33.000,2025-04-05 23:59:22.155
false,false,2427,2292,135,1382,00:00:30.000,2025-04-05 23:59:52.161
false,false,2423,2289,134,1254,00:00:30.000,2025-04-05 23:57:52.111
false,false,2430,2295,135,1479,00:00:32.000,2025-04-06 00:01:22.200
false,false,2428,2293,135,1414,00:00:32.000,2025-04-06 00:00:22.175
false,false,2429,2294,135,1447,00:00:33.000,2025-04-06 00:00:52.185
false,false,2432,2297,135,1543,00:00:32.000,2025-04-06 00:02:22.230
false,false,2431,2296,135,1511,00:00:32.000,2025-04-06 00:01:52.215
false,false,2434,2299,135,1606,00:00:33.000,2025-04-06 00:03:22.251
false,false,2435,2300,135,1639,00:00:33.000,2025-04-06 00:03:52.266
false,false,2433,2298,135,1573,00:00:30.000,2025-04-06 00:02:52.243
false,false,2436,2301,135,1672,00:00:33.000,2025-04-06 00:04:22.280
false,false,2437,2302,135,1705,00:00:33.000,2025-04-06 00:04:52.293
false,false,2438,2303,135,1735,00:00:30.000,2025-04-06 00:05:22.303
false,false,2440,2305,135,1800,00:00:33.000,2025-04-06 00:06:22.325
false,false,2439,2304,135,1767,00:00:32.000,2025-04-06 00:05:52.315
false,false,2441,2306,135,1831,00:00:31.000,2025-04-06 00:06:52.336
false,false,2442,2307,135,1861,00:00:30.000,2025-04-06 00:07:22.343
false,false,2443,2308,135,1892,00:00:31.000,2025-04-06 00:07:52.348
false,false,2444,2309,135,1924,00:00:32.000,2025-04-06 00:08:22.358
false,false,2447,2312,135,2020,00:00:33.000,2025-04-06 00:09:52.389
false,false,2446,2311,135,1987,00:00:33.000,2025-04-06 00:09:22.375
false,false,2445,2310,135,1954,00:00:30.000,2025-04-06 00:08:52.370
false,false,2448,2313,135,2053,00:00:33.000,2025-04-06 00:10:22.404
false,false,2449,2314,135,2084,00:00:31.000,2025-04-06 00:10:52.419
false,false,2454,2319,135,2243,00:00:31.000,2025-04-06 00:13:22.472
false,false,2453,2318,135,2212,00:00:33.000,2025-04-06 00:12:52.456
false,false,2452,2317,135,2179,00:00:31.000,2025-04-06 00:12:22.441
false,false,2455,2320,135,2274,00:00:31.000,2025-04-06 00:13:52.482
false,false,2450,2315,135,2117,00:00:33.000,2025-04-06 00:11:22.428
false,false,2451,2316,135,2148,00:00:31.000,2025-04-06 00:11:52.438
false,false,2456,2321,135,2307,00:00:33.000,2025-04-06 00:14:22.497
false,true,2459,2323,136,0,00:00:00.000,2025-04-06 00:16:22.539
false,false,2458,2322,136,2369,00:00:32.000,2025-04-06 00:15:22.522
false,false,2457,2321,136,2337,00:00:30.000,2025-04-06 00:14:52.507
false,false,2459,2323,136,2401,00:00:32.000,2025-04-06 00:15:52.530
false,true,2459,2323,136,0,00:00:00.000,2025-04-06 00:16:52.547
false,true,2459,2323,136,0,00:00:00.000,2025-04-06 00:17:22.558
false,true,2459,2323,136,0,00:00:00.000,2025-04-06 00:17:52.563
false,true,2459,2323,136,0,00:00:00.000,2025-04-06 00:18:52.579
false,false,2461,2325,136,63,00:00:33.000,2025-04-06 00:19:52.608
false,false,2462,2326,136,93,00:00:30.000,2025-04-06 00:20:22.611
false,false,2465,2329,136,189,00:00:31.000,2025-04-06 00:21:52.646
false,false,2463,2327,136,125,00:00:32.000,2025-04-06 00:20:52.622
false,false,2460,2324,136,30,00:00:30.000,2025-04-06 00:19:22.594
false,true,2459,2323,136,0,00:00:00.000,2025-04-06 00:18:22.564
false,false,2464,2328,136,158,00:00:33.000,2025-04-06 00:21:22.636
false,false,2466,2330,136,220,00:00:31.000,2025-04-06 00:22:22.651
false,false,2468,2332,136,283,00:00:32.000,2025-04-06 00:23:22.675
false,false,2467,2331,136,251,00:00:31.000,2025-04-06 00:22:52.663
false,false,2469,2333,136,316,00:00:33.000,2025-04-06 00:23:52.686
false,false,2471,2334,137,378,00:00:32.000,2025-04-06 00:24:52.709
false,false,2472,2335,137,408,00:00:30.000,2025-04-06 00:25:22.719
false,false,2470,2333,137,346,00:00:30.000,2025-04-06 00:24:22.698
false,false,2476,2338,138,533,00:00:31.000,2025-04-06 00:27:22.767
false,false,2474,2337,137,469,00:00:31.000,2025-04-06 00:26:22.741
false,false,2473,2336,137,438,00:00:30.000,2025-04-06 00:25:52.730
false,false,2478,2340,138,596,00:00:33.000,2025-04-06 00:28:22.795
false,false,2477,2339,138,563,00:00:30.000,2025-04-06 00:27:52.780
false,false,2475,2338,137,502,00:00:33.000,2025-04-06 00:26:52.755
false,true,2478,2340,138,0,00:00:00.000,2025-04-06 00:29:52.829
false,true,2478,2340,138,0,00:00:00.000,2025-04-06 00:28:52.805
false,true,2478,2340,138,0,00:00:00.000,2025-04-06 00:30:22.842
false,true,2478,2340,138,0,00:00:00.000,2025-04-06 00:30:52.845
false,true,2478,2340,138,0,00:00:00.000,2025-04-06 00:29:22.819
false,true,2478,2340,138,0,00:00:00.000,2025-04-06 00:31:22.857
false,false,2480,2342,138,65,00:00:32.000,2025-04-06 00:32:22.880
false,false,2479,2341,138,33,00:00:33.000,2025-04-06 00:31:52.870
false,false,2481,2342,139,98,00:00:33.000,2025-04-06 00:32:52.895
false,false,2482,2343,139,129,00:00:31.000,2025-04-06 00:33:22.904
false,true,2482,2343,139,0,00:00:00.000,2025-04-06 00:34:22.932
false,true,2482,2343,139,0,00:00:00.000,2025-04-06 00:33:52.917
false,true,2482,2343,139,0,00:00:00.000,2025-04-06 00:34:52.945
false,true,2482,2343,139,0,00:00:00.000,2025-04-06 00:35:22.950
false,true,2482,2343,139,0,00:00:00.000,2025-04-06 00:36:22.979
false,true,2482,2343,139,0,00:00:00.000,2025-04-06 00:35:52.964
false,true,2484,2345,139,0,00:00:00.000,2025-04-06 00:37:53.007
false,true,2484,2345,139,0,00:00:00.000,2025-04-06 00:38:23.015
false,false,2483,2344,139,31,00:00:31.000,2025-04-06 00:36:52.990
false,true,2484,2345,139,0,00:00:00.000,2025-04-06 00:38:53.020
false,false,2484,2345,139,63,00:00:32.000,2025-04-06 00:37:23.004
false,true,2484,2345,139,0,00:00:00.000,2025-04-06 00:39:23.032
false,true,2484,2345,139,0,00:00:00.000,2025-04-06 00:40:23.057
false,true,2484,2345,139,0,00:00:00.000,2025-04-06 00:39:53.044
false,false,2485,2346,139,32,00:00:32.000,2025-04-06 00:40:53.070
false,false,2487,2348,139,95,00:00:30.000,2025-04-06 00:41:53.094
false,false,2486,2347,139,65,00:00:33.000,2025-04-06 00:41:23.083
false,false,2488,2348,140,128,00:00:33.000,2025-04-06 00:42:23.109
false,false,2489,2349,140,159,00:00:31.000,2025-04-06 00:42:53.120
false,false,2490,2350,140,190,00:00:31.000,2025-04-06 00:43:23.131
false,false,2491,2351,140,222,00:00:32.000,2025-04-06 00:43:53.145
false,false,2493,2353,140,286,00:00:33.000,2025-04-06 00:44:53.164
false,false,2492,2352,140,253,00:00:31.000,2025-04-06 00:44:23.160
false,false,2494,2354,140,318,00:00:32.000,2025-04-06 00:45:23.178
false,true,5294,5001,293,0,00:00:00.000,2025-04-07 09:38:03.388
false,true,5294,5001,293,0,00:00:00.000,2025-04-07 09:39:03.401
false,false,5296,5002,294,66,00:00:33.000,2025-04-07 09:40:03.428
false,false,5295,5002,293,33,00:00:33.000,2025-04-07 09:39:33.414
false,true,5294,5001,293,0,00:00:00.000,2025-04-07 09:38:33.398
false,true,5294,5001,293,0,00:00:00.000,2025-04-07 09:37:33.374
false,false,5301,5007,294,230,00:00:33.000,2025-04-07 09:42:33.485
false,false,5297,5003,294,98,00:00:32.000,2025-04-07 09:40:33.441
false,false,5300,5006,294,197,00:00:33.000,2025-04-07 09:42:03.471
false,false,5298,5004,294,131,00:00:33.000,2025-04-07 09:41:03.456
false,false,5302,5008,294,262,00:00:32.000,2025-04-07 09:43:03.499
false,false,5299,5005,294,164,00:00:33.000,2025-04-07 09:41:33.462
false,false,5304,5009,295,323,00:00:31.000,2025-04-07 09:44:03.527
false,false,5303,5009,294,292,00:00:30.000,2025-04-07 09:43:33.512
false,true,5307,5012,295,0,00:00:00.000,2025-04-07 09:46:03.573
false,false,5305,5010,295,355,00:00:32.000,2025-04-07 09:44:33.539
false,false,5306,5011,295,388,00:00:33.000,2025-04-07 09:45:03.552
false,false,5307,5012,295,419,00:00:31.000,2025-04-07 09:45:33.561
false,true,5307,5012,295,0,00:00:00.000,2025-04-07 09:47:03.594
false,true,5307,5012,295,0,00:00:00.000,2025-04-07 09:48:03.618
false,true,5307,5012,295,0,00:00:00.000,2025-04-07 09:48:33.629
false,true,5307,5012,295,0,00:00:00.000,2025-04-07 09:46:33.583
false,false,5308,5013,295,31,00:00:31.000,2025-04-07 09:49:03.641
false,true,5307,5012,295,0,00:00:00.000,2025-04-07 09:47:33.608
false,false,5309,5014,295,64,00:00:33.000,2025-04-07 09:49:33.649
false,false,5311,5016,295,128,00:00:31.000,2025-04-07 09:50:33.668
false,false,5312,5017,295,158,00:00:30.000,2025-04-07 09:51:03.679
false,false,5310,5015,295,97,00:00:33.000,2025-04-07 09:50:03.661
false,false,5313,5018,295,190,00:00:32.000,2025-04-07 09:51:33.690
false,false,5314,5019,295,221,00:00:31.000,2025-04-07 09:52:03.700
false,false,5315,5020,295,252,00:00:31.000,2025-04-07 09:52:33.703
false,false,5316,5021,295,284,00:00:32.000,2025-04-07 09:53:03.717
false,false,5320,5024,296,408,00:00:30.000,2025-04-07 09:55:03.764
false,false,5319,5024,295,378,00:00:31.000,2025-04-07 09:54:33.751
false,false,5317,5022,295,316,00:00:32.000,2025-04-07 09:53:33.728
false,false,5318,5023,295,347,00:00:31.000,2025-04-07 09:54:03.741
false,false,5321,5025,296,438,00:00:30.000,2025-04-07 09:55:33.777
false,false,5325,5029,296,564,00:00:31.000,2025-04-07 09:57:33.820
false,false,5324,5028,296,533,00:00:33.000,2025-04-07 09:57:03.806
false,false,5323,5027,296,500,00:00:30.000,2025-04-07 09:56:33.795
false,false,5322,5026,296,470,00:00:32.000,2025-04-07 09:56:03.791
false,false,5326,5030,296,596,00:00:32.000,2025-04-07 09:58:03.829
false,false,5327,5031,296,629,00:00:33.000,2025-04-07 09:58:33.843
false,false,5329,5033,296,692,00:00:30.000,2025-04-07 09:59:33.862
false,false,5331,5035,296,755,00:00:31.000,2025-04-07 10:00:33.890
false,false,5328,5032,296,662,00:00:33.000,2025-04-07 09:59:03.851
false,false,5330,5034,296,724,00:00:32.000,2025-04-07 10:00:03.876
false,false,5332,5036,296,785,00:00:30.000,2025-04-07 10:01:03.903
false,false,5333,5036,297,817,00:00:32.000,2025-04-07 10:01:33.918
false,false,5336,5039,297,913,00:00:32.000,2025-04-07 10:03:03.948
false,false,5338,5041,297,975,00:00:30.000,2025-04-07 10:04:03.966
false,false,5334,5037,297,850,00:00:33.000,2025-04-07 10:02:03.930
false,false,5337,5040,297,945,00:00:32.000,2025-04-07 10:03:33.956
false,false,5339,5042,297,1006,00:00:31.000,2025-04-07 10:04:33.980
false,false,5335,5038,297,881,00:00:31.000,2025-04-07 10:02:33.936
false,false,5341,5044,297,1068,00:00:31.000,2025-04-07 10:05:34.003
false,false,5340,5043,297,1037,00:00:31.000,2025-04-07 10:05:03.991
false,false,5343,5046,297,1128,00:00:30.000,2025-04-07 10:06:34.029
false,false,5342,5045,297,1098,00:00:30.000,2025-04-07 10:06:04.018
false,false,5344,5047,297,1160,00:00:32.000,2025-04-07 10:07:04.043
false,false,5345,5048,297,1191,00:00:31.000,2025-04-07 10:07:34.052
false,false,5347,5049,298,1254,00:00:30.000,2025-04-07 10:08:34.071
false,false,5346,5048,298,1224,00:00:33.000,2025-04-07 10:08:04.060
false,false,5348,5050,298,1287,00:00:33.000,2025-04-07 10:09:04.078
false,false,5349,5051,298,1319,00:00:32.000,2025-04-07 10:09:34.092
false,false,5350,5052,298,1350,00:00:31.000,2025-04-07 10:10:04.105
false,false,5352,5054,298,1412,00:00:32.000,2025-04-07 10:11:04.123
false,false,5355,5057,298,1509,00:00:33.000,2025-04-07 10:12:34.158
false,false,5356,5058,298,1542,00:00:33.000,2025-04-07 10:13:04.171
false,false,5354,5056,298,1476,00:00:32.000,2025-04-07 10:12:04.146
false,false,5351,5053,298,1380,00:00:30.000,2025-04-07 10:10:34.116
false,false,5353,5055,298,1444,00:00:32.000,2025-04-07 10:11:34.136
false,false,5358,5060,298,1604,00:00:32.000,2025-04-07 10:14:04.193
false,false,5359,5061,298,1636,00:00:32.000,2025-04-07 10:14:34.208
false,false,5357,5059,298,1572,00:00:30.000,2025-04-07 10:13:34.182
false,false,5360,5062,298,1668,00:00:32.000,2025-04-07 10:15:04.220
false,false,5362,5064,298,1730,00:00:32.000,2025-04-07 10:16:04.249
false,false,5361,5063,298,1698,00:00:30.000,2025-04-07 10:15:34.235
false,false,5365,5067,298,1825,00:00:31.000,2025-04-07 10:17:34.273
false,false,5364,5066,298,1794,00:00:31.000,2025-04-07 10:17:04.269
false,false,5363,5065,298,1763,00:00:33.000,2025-04-07 10:16:34.261
false,false,5367,5069,298,1888,00:00:32.000,2025-04-07 10:18:34.295
false,false,5370,5072,298,1980,00:00:30.000,2025-04-07 10:20:04.329
false,false,5368,5070,298,1918,00:00:30.000,2025-04-07 10:19:04.306
false,false,5369,5071,298,1950,00:00:32.000,2025-04-07 10:19:34.315
false,false,5366,5068,298,1856,00:00:31.000,2025-04-07 10:18:04.284
false,false,5371,5073,298,2011,00:00:31.000,2025-04-07 10:20:34.342
false,false,5373,5075,298,2074,00:00:31.000,2025-04-07 10:21:34.369
false,true,5373,5075,298,0,00:00:00.000,2025-04-07 10:22:34.394
false,true,5373,5075,298,0,00:00:00.000,2025-04-07 10:23:04.406
false,true,5373,5075,298,0,00:00:00.000,2025-04-07 10:22:04.380
false,false,5372,5074,298,2043,00:00:32.000,2025-04-07 10:21:04.356
false,true,5373,5075,298,0,00:00:00.000,2025-04-07 10:23:34.415
false,true,5373,5075,298,0,00:00:00.000,2025-04-07 10:24:04.425
false,false,5375,5076,299,63,00:00:31.000,2025-04-07 10:25:34.459
false,false,5376,5077,299,96,00:00:33.000,2025-04-07 10:26:04.473
false,false,5374,5075,299,32,00:00:32.000,2025-04-07 10:25:04.447
false,true,5373,5075,298,0,00:00:00.000,2025-04-07 10:24:34.436
false,false,5377,5078,299,128,00:00:32.000,2025-04-07 10:26:34.482
false,false,5378,5079,299,160,00:00:32.000,2025-04-07 10:27:04.488
false,false,5379,5080,299,192,00:00:32.000,2025-04-07 10:27:34.500
false,false,5381,5082,299,254,00:00:31.000,2025-04-07 10:28:34.524
false,false,5383,5084,299,317,00:00:31.000,2025-04-07 10:29:34.551
false,false,5382,5083,299,286,00:00:32.000,2025-04-07 10:29:04.538
false,false,5384,5085,299,350,00:00:33.000,2025-04-07 10:30:04.566
false,false,5380,5081,299,223,00:00:31.000,2025-04-07 10:28:04.512
false,false,5386,5087,299,414,00:00:32.000,2025-04-07 10:31:04.589
false,true,5387,5088,299,0,00:00:00.000,2025-04-07 10:32:04.614
false,false,5387,5088,299,447,00:00:33.000,2025-04-07 10:31:34.601
false,true,5387,5088,299,0,00:00:00.000,2025-04-07 10:33:04.639
false,true,5387,5088,299,0,00:00:00.000,2025-04-07 10:33:34.646
false,false,5385,5086,299,382,00:00:32.000,2025-04-07 10:30:34.575
false,true,5387,5088,299,0,00:00:00.000,2025-04-07 10:32:34.626
false,true,4367,4116,251,0,00:00:00.000,2025-04-06 22:59:22.575
false,true,4367,4116,251,0,00:00:00.000,2025-04-06 23:00:22.589
false,true,4367,4116,251,0,00:00:00.000,2025-04-06 22:58:52.570
false,false,4367,4116,251,693,00:00:30.000,2025-04-06 22:58:22.562
false,true,4367,4116,251,0,00:00:00.000,2025-04-06 22:59:52.584
false,false,4366,4115,251,663,00:00:33.000,2025-04-06 22:57:52.554
false,true,4367,4116,251,0,00:00:00.000,2025-04-06 23:00:52.598
false,true,4367,4116,251,0,00:00:00.000,2025-04-06 23:01:22.607
false,false,4372,4121,251,157,00:00:31.000,2025-04-06 23:03:52.641
false,false,4370,4119,251,93,00:00:31.000,2025-04-06 23:02:52.627
false,false,4368,4117,251,30,00:00:30.000,2025-04-06 23:01:52.615
false,false,4369,4118,251,62,00:00:32.000,2025-04-06 23:02:22.622
false,false,4371,4120,251,126,00:00:33.000,2025-04-06 23:03:22.634
false,false,4373,4122,251,187,00:00:30.000,2025-04-06 23:04:22.647
false,false,4375,4124,251,247,00:00:30.000,2025-04-06 23:05:22.663
false,false,4376,4125,251,278,00:00:31.000,2025-04-06 23:05:52.671
false,false,4374,4123,251,217,00:00:30.000,2025-04-06 23:04:52.655
false,false,4377,4126,251,309,00:00:31.000,2025-04-06 23:06:22.679
false,false,4378,4127,251,341,00:00:32.000,2025-04-06 23:06:52.687
false,false,4379,4128,251,371,00:00:30.000,2025-04-06 23:07:22.696
false,false,4380,4129,251,403,00:00:32.000,2025-04-06 23:07:52.702
false,false,4381,4130,251,433,00:00:30.000,2025-04-06 23:08:22.711
false,false,4382,4131,251,464,00:00:31.000,2025-04-06 23:08:52.719
false,false,4383,4132,251,495,00:00:31.000,2025-04-06 23:09:22.725
false,false,4384,4133,251,528,00:00:33.000,2025-04-06 23:09:52.732
false,false,4385,4134,251,560,00:00:32.000,2025-04-06 23:10:22.739
false,false,4386,4135,251,591,00:00:31.000,2025-04-06 23:10:52.746
false,false,4390,4139,251,716,00:00:30.000,2025-04-06 23:12:52.774
false,false,4387,4136,251,621,00:00:30.000,2025-04-06 23:11:22.755
false,false,4391,4140,251,748,00:00:32.000,2025-04-06 23:13:22.779
false,false,4389,4138,251,686,00:00:32.000,2025-04-06 23:12:22.770
false,false,4388,4137,251,654,00:00:33.000,2025-04-06 23:11:52.763
false,false,4392,4141,251,780,00:00:32.000,2025-04-06 23:13:52.785
false,false,4393,4142,251,810,00:00:30.000,2025-04-06 23:14:22.794
false,true,4393,4142,251,0,00:00:00.000,2025-04-06 23:14:52.802
false,true,4393,4142,251,0,00:00:00.000,2025-04-06 23:15:52.819
false,true,4393,4142,251,0,00:00:00.000,2025-04-06 23:15:22.811
false,true,4393,4142,251,0,00:00:00.000,2025-04-06 23:16:52.829
false,true,4393,4142,251,0,00:00:00.000,2025-04-06 23:16:22.826
false,true,4393,4142,251,0,00:00:00.000,2025-04-06 23:17:22.836
false,false,4395,4144,251,63,00:00:32.000,2025-04-06 23:18:22.849
false,false,4394,4143,251,31,00:00:31.000,2025-04-06 23:17:52.842
false,false,4397,4146,251,128,00:00:33.000,2025-04-06 23:19:22.866
false,false,4398,4147,251,160,00:00:32.000,2025-04-06 23:19:52.868
false,false,4399,4148,251,193,00:00:33.000,2025-04-06 23:20:22.871
false,false,4400,4149,251,226,00:00:33.000,2025-04-06 23:20:52.875
false,false,4401,4150,251,259,00:00:33.000,2025-04-06 23:21:22.882
false,false,4396,4145,251,95,00:00:32.000,2025-04-06 23:18:52.858
false,false,4403,4152,251,321,00:00:32.000,2025-04-06 23:22:22.891
false,false,4404,4153,251,354,00:00:33.000,2025-04-06 23:22:52.900
false,false,4402,4151,251,289,00:00:30.000,2025-04-06 23:21:52.883
false,true,4404,4153,251,0,00:00:00.000,2025-04-06 23:23:52.914
false,true,4404,4153,251,0,00:00:00.000,2025-04-06 23:24:52.926
false,true,4404,4153,251,0,00:00:00.000,2025-04-06 23:23:22.908
false,true,4404,4153,251,0,00:00:00.000,2025-04-06 23:24:22.920
false,true,4404,4153,251,0,00:00:00.000,2025-04-06 23:25:52.940
false,true,4404,4153,251,0,00:00:00.000,2025-04-06 23:25:22.932
false,false,4405,4154,251,32,00:00:32.000,2025-04-06 23:26:22.944
false,true,4407,4156,251,0,00:00:00.000,2025-04-06 23:27:52.969
false,false,4406,4155,251,62,00:00:30.000,2025-04-06 23:26:52.952
false,false,4407,4156,251,94,00:00:32.000,2025-04-06 23:27:22.960
false,true,4407,4156,251,0,00:00:00.000,2025-04-06 23:28:52.983
false,true,4407,4156,251,0,00:00:00.000,2025-04-06 23:29:22.989
false,true,4407,4156,251,0,00:00:00.000,2025-04-06 23:28:22.977
false,true,4407,4156,251,0,00:00:00.000,2025-04-06 23:31:23.005
false,true,4407,4156,251,0,00:00:00.000,2025-04-06 23:29:52.990
false,true,4407,4156,251,0,00:00:00.000,2025-04-06 23:30:52.998
false,true,4407,4156,251,0,00:00:00.000,2025-04-06 23:31:53.010
false,true,4407,4156,251,0,00:00:00.000,2025-04-06 23:32:23.012
false,true,4407,4156,251,0,00:00:00.000,2025-04-06 23:30:22.992
false,true,4407,4156,251,0,00:00:00.000,2025-04-06 23:32:53.017
false,true,4407,4156,251,0,00:00:00.000,2025-04-06 23:33:23.024
false,false,4408,4157,251,33,00:00:33.000,2025-04-06 23:33:53.029
false,false,4411,4159,252,126,00:00:30.000,2025-04-06 23:35:23.052
false,false,4409,4158,251,64,00:00:31.000,2025-04-06 23:34:23.036
false,false,4410,4159,251,96,00:00:32.000,2025-04-06 23:34:53.043
false,false,4412,4160,252,158,00:00:32.000,2025-04-06 23:35:53.054
false,false,4414,4162,252,221,00:00:30.000,2025-04-06 23:36:53.061
false,false,4413,4161,252,191,00:00:33.000,2025-04-06 23:36:23.060
false,true,4414,4162,252,0,00:00:00.000,2025-04-06 23:37:23.064
false,true,4414,4162,252,0,00:00:00.000,2025-04-06 23:38:23.081
false,true,4414,4162,252,0,00:00:00.000,2025-04-06 23:37:53.072
false,true,4414,4162,252,0,00:00:00.000,2025-04-06 23:38:53.089
false,true,4414,4162,252,0,00:00:00.000,2025-04-06 23:39:23.096
false,true,4414,4162,252,0,00:00:00.000,2025-04-06 23:39:53.104
false,false,4415,4163,252,33,00:00:33.000,2025-04-06 23:40:23.106
false,false,4416,4164,252,63,00:00:30.000,2025-04-06 23:40:53.112
false,false,4418,4166,252,128,00:00:33.000,2025-04-06 23:41:53.128
false,true,4418,4166,252,0,00:00:00.000,2025-04-06 23:42:53.142
false,false,4417,4165,252,95,00:00:32.000,2025-04-06 23:41:23.119
false,true,4418,4166,252,0,00:00:00.000,2025-04-06 23:42:23.136
false,true,4418,4166,252,0,00:00:00.000,2025-04-06 23:43:23.148
false,true,4418,4166,252,0,00:00:00.000,2025-04-06 23:43:53.157
false,true,4418,4166,252,0,00:00:00.000,2025-04-06 23:44:23.165
false,true,4418,4166,252,0,00:00:00.000,2025-04-06 23:44:53.172
false,false,4419,4167,252,32,00:00:32.000,2025-04-06 23:45:23.179
false,false,4420,4168,252,63,00:00:31.000,2025-04-06 23:45:53.186
false,true,4420,4168,252,0,00:00:00.000,2025-04-06 23:46:53.200
false,true,4420,4168,252,0,00:00:00.000,2025-04-06 23:46:23.194
false,true,4420,4168,252,0,00:00:00.000,2025-04-06 23:47:23.206
false,true,4420,4168,252,0,00:00:00.000,2025-04-06 23:47:53.210
false,true,4420,4168,252,0,00:00:00.000,2025-04-06 23:49:53.240
false,true,4420,4168,252,0,00:00:00.000,2025-04-06 23:48:23.216
false,true,4420,4168,252,0,00:00:00.000,2025-04-06 23:50:23.248
false,true,4420,4168,252,0,00:00:00.000,2025-04-06 23:49:23.231
false,true,4420,4168,252,0,00:00:00.000,2025-04-06 23:48:53.222
false,true,4420,4168,252,0,00:00:00.000,2025-04-06 23:51:23.261
false,true,4420,4168,252,0,00:00:00.000,2025-04-06 23:50:53.253
false,true,4420,4168,252,0,00:00:00.000,2025-04-06 23:51:53.268
false,false,4421,4169,252,31,00:00:31.000,2025-04-06 23:52:23.270
false,false,4422,4170,252,61,00:00:30.000,2025-04-06 23:52:53.272
false,false,4423,4171,252,92,00:00:31.000,2025-04-06 23:53:23.279
false,false,4425,4173,252,156,00:00:32.000,2025-04-06 23:54:23.294
false,false,4424,4172,252,124,00:00:32.000,2025-04-06 23:53:53.288
false,true,4428,4175,253,0,00:00:00.000,2025-04-06 23:56:23.321
false,false,4427,4174,253,216,00:00:30.000,2025-04-06 23:55:23.307
false,true,4428,4175,253,0,00:00:00.000,2025-04-06 23:56:53.327
false,false,4428,4175,253,247,00:00:31.000,2025-04-06 23:55:53.314
false,false,4426,4173,253,186,00:00:30.000,2025-04-06 23:54:53.300
false,true,4428,4175,253,0,00:00:00.000,2025-04-06 23:57:23.335
false,true,4428,4175,253,0,00:00:00.000,2025-04-06 23:58:23.349
false,true,4428,4175,253,0,00:00:00.000,2025-04-06 23:57:53.341
false,true,4428,4175,253,0,00:00:00.000,2025-04-06 23:58:53.357
false,false,4429,4176,253,30,00:00:30.000,2025-04-06 23:59:23.364
false,false,4430,4177,253,60,00:00:30.000,2025-04-06 23:59:53.370
false,true,4430,4177,253,0,00:00:00.000,2025-04-07 00:00:53.377
false,true,4430,4177,253,0,00:00:00.000,2025-04-07 00:01:23.383
false,true,4430,4177,253,0,00:00:00.000,2025-04-07 00:00:23.372
false,true,5081,4795,286,0,00:00:00.000,2025-04-07 07:27:30.376
false,true,5081,4795,286,0,00:00:00.000,2025-04-07 07:28:30.399
false,false,5082,4796,286,30,00:00:30.000,2025-04-07 07:29:00.414
false,false,5083,4797,286,60,00:00:30.000,2025-04-07 07:29:30.425
false,false,5084,4798,286,91,00:00:31.000,2025-04-07 07:30:00.436
false,true,5081,4795,286,0,00:00:00.000,2025-04-07 07:28:00.387
false,true,5085,4799,286,0,00:00:00.000,2025-04-07 07:31:30.475
false,false,5085,4799,286,122,00:00:31.000,2025-04-07 07:30:30.449
false,true,5085,4799,286,0,00:00:00.000,2025-04-07 07:32:00.489
false,true,5085,4799,286,0,00:00:00.000,2025-04-07 07:31:00.461
false,true,5085,4799,286,0,00:00:00.000,2025-04-07 07:32:30.502
false,true,5085,4799,286,0,00:00:00.000,2025-04-07 07:33:00.516
false,false,5086,4800,286,32,00:00:32.000,2025-04-07 07:34:00.538
false,true,5085,4799,286,0,00:00:00.000,2025-04-07 07:33:30.530
false,false,5088,4802,286,95,00:00:33.000,2025-04-07 07:35:00.568
false,false,5087,4801,286,62,00:00:30.000,2025-04-07 07:34:30.553
false,false,5089,4803,286,127,00:00:32.000,2025-04-07 07:35:30.583
false,false,5090,4804,286,157,00:00:30.000,2025-04-07 07:36:00.596
false,false,5094,4807,287,282,00:00:30.000,2025-04-07 07:38:00.644
false,false,5091,4805,286,187,00:00:30.000,2025-04-07 07:36:30.610
false,false,5092,4806,286,219,00:00:32.000,2025-04-07 07:37:00.623
false,false,5093,4807,286,252,00:00:33.000,2025-04-07 07:37:30.636
false,false,5098,4811,287,408,00:00:31.000,2025-04-07 07:40:00.690
false,false,5095,4808,287,315,00:00:33.000,2025-04-07 07:38:30.657
false,false,5096,4809,287,347,00:00:32.000,2025-04-07 07:39:00.672
false,false,5099,4812,287,439,00:00:31.000,2025-04-07 07:40:30.701
false,false,5100,4813,287,472,00:00:33.000,2025-04-07 07:41:00.713
false,false,5102,4815,287,535,00:00:30.000,2025-04-07 07:42:00.739
false,false,5103,4816,287,565,00:00:30.000,2025-04-07 07:42:30.754
false,false,5101,4814,287,505,00:00:33.000,2025-04-07 07:41:30.726
false,false,5104,4817,287,595,00:00:30.000,2025-04-07 07:43:00.765
false,false,5108,4821,287,720,00:00:30.000,2025-04-07 07:45:00.811
false,false,5097,4810,287,377,00:00:30.000,2025-04-07 07:39:30.683
false,false,5106,4819,287,657,00:00:31.000,2025-04-07 07:44:00.790
false,false,5105,4818,287,626,00:00:31.000,2025-04-07 07:43:30.776
false,false,5109,4822,287,750,00:00:30.000,2025-04-07 07:45:30.823
false,false,5107,4820,287,690,00:00:33.000,2025-04-07 07:44:30.801
false,true,5111,4824,287,0,00:00:00.000,2025-04-07 07:47:30.869
false,true,5111,4824,287,0,00:00:00.000,2025-04-07 07:47:00.854
false,false,5110,4823,287,781,00:00:31.000,2025-04-07 07:46:00.833
false,false,5111,4824,287,814,00:00:33.000,2025-04-07 07:46:30.845
false,true,5111,4824,287,0,00:00:00.000,2025-04-07 07:48:30.888
false,true,5111,4824,287,0,00:00:00.000,2025-04-07 07:48:00.883
false,true,5111,4824,287,0,00:00:00.000,2025-04-07 07:49:00.899
false,false,5114,4827,287,92,00:00:30.000,2025-04-07 07:51:00.943
false,true,5111,4824,287,0,00:00:00.000,2025-04-07 07:49:30.911
false,false,5112,4825,287,32,00:00:32.000,2025-04-07 07:50:00.925
false,false,5115,4828,287,123,00:00:31.000,2025-04-07 07:51:30.954
false,false,5116,4829,287,156,00:00:33.000,2025-04-07 07:52:00.967
false,false,5113,4826,287,62,00:00:30.000,2025-04-07 07:50:30.931
false,false,5118,4831,287,217,00:00:31.000,2025-04-07 07:53:00.982
false,false,5119,4832,287,249,00:00:32.000,2025-04-07 07:53:30.996
false,false,5117,4830,287,186,00:00:30.000,2025-04-07 07:52:30.981
false,false,5120,4833,287,281,00:00:32.000,2025-04-07 07:54:01.010
false,false,5121,4834,287,311,00:00:30.000,2025-04-07 07:54:31.024
false,true,5123,4836,287,0,00:00:00.000,2025-04-07 07:56:01.063
false,true,5123,4836,287,0,00:00:00.000,2025-04-07 07:56:31.078
false,false,5122,4835,287,341,00:00:30.000,2025-04-07 07:55:01.036
false,false,5123,4836,287,371,00:00:30.000,2025-04-07 07:55:31.049
false,true,5123,4836,287,0,00:00:00.000,2025-04-07 07:58:01.112
false,true,5123,4836,287,0,00:00:00.000,2025-04-07 07:57:31.099
false,true,5123,4836,287,0,00:00:00.000,2025-04-07 07:58:31.125
false,false,5125,4838,287,60,00:00:30.000,2025-04-07 07:59:31.148
false,true,5123,4836,287,0,00:00:00.000,2025-04-07 07:57:01.090
false,false,5124,4837,287,30,00:00:30.000,2025-04-07 07:59:01.133
false,false,5127,4840,287,121,00:00:31.000,2025-04-07 08:00:31.170
false,false,5131,4844,287,247,00:00:32.000,2025-04-07 08:02:31.201
false,false,5130,4843,287,215,00:00:32.000,2025-04-07 08:02:01.200
false,false,5126,4839,287,90,00:00:30.000,2025-04-07 08:00:01.164
false,false,5128,4841,287,151,00:00:30.000,2025-04-07 08:01:01.181
false,false,5129,4842,287,183,00:00:32.000,2025-04-07 08:01:31.188
false,false,5134,4847,287,338,00:00:30.000,2025-04-07 08:04:01.231
false,false,5132,4845,287,278,00:00:31.000,2025-04-07 08:03:01.214
false,false,5135,4848,287,368,00:00:30.000,2025-04-07 08:04:31.242
false,false,5137,4850,287,430,00:00:32.000,2025-04-07 08:05:31.269
false,false,5136,4849,287,398,00:00:30.000,2025-04-07 08:05:01.256
false,false,5133,4846,287,308,00:00:30.000,2025-04-07 08:03:31.227
false,false,5139,4852,287,491,00:00:31.000,2025-04-07 08:06:31.295
false,false,5138,4851,287,460,00:00:30.000,2025-04-07 08:06:01.283
false,false,5141,4854,287,553,00:00:32.000,2025-04-07 08:07:31.316
false,false,5143,4856,287,616,00:00:32.000,2025-04-07 08:08:31.345
false,false,5145,4858,287,677,00:00:31.000,2025-04-07 08:09:31.367
false,false,5142,4855,287,584,00:00:31.000,2025-04-07 08:08:01.331
false,false,5140,4853,287,521,00:00:30.000,2025-04-07 08:07:01.310
false,false,5144,4857,287,646,00:00:30.000,2025-04-07 08:09:01.356
false,false,5148,4860,288,771,00:00:31.000,2025-04-07 08:11:01.395
false,false,5149,4861,288,802,00:00:31.000,2025-04-07 08:11:31.405
false,false,5147,4859,288,740,00:00:31.000,2025-04-07 08:10:31.391
false,false,5146,4858,288,709,00:00:32.000,2025-04-07 08:10:01.381
false,false,5152,4864,288,897,00:00:33.000,2025-04-07 08:13:01.448
false,false,5151,4863,288,864,00:00:32.000,2025-04-07 08:12:31.435
false,false,5150,4862,288,832,00:00:30.000,2025-04-07 08:12:01.420
false,false,5155,4867,288,991,00:00:30.000,2025-04-07 08:14:31.478
false,false,5154,4866,288,961,00:00:31.000,2025-04-07 08:14:01.466
false,false,5153,4865,288,930,00:00:33.000,2025-04-07 08:13:31.462
false,false,5156,4868,288,1022,00:00:31.000,2025-04-07 08:15:01.490
false,false,5157,4869,288,1054,00:00:32.000,2025-04-07 08:15:31.502
false,false,5158,4870,288,1086,00:00:32.000,2025-04-07 08:16:01.517
false,false,5159,4871,288,1117,00:00:31.000,2025-04-07 08:16:31.527
false,false,5161,4873,288,1183,00:00:33.000,2025-04-07 08:17:31.547
false,false,5160,4872,288,1150,00:00:33.000,2025-04-07 08:17:01.538
false,false,5162,4874,288,1214,00:00:31.000,2025-04-07 08:18:01.561
false,false,5164,4876,288,1278,00:00:31.000,2025-04-07 08:19:01.581
false,false,5167,4879,288,1370,00:00:30.000,2025-04-07 08:20:31.621
false,false,5166,4878,288,1340,00:00:30.000,2025-04-07 08:20:01.607
false,false,5165,4877,288,1310,00:00:32.000,2025-04-07 08:19:31.595
false,false,5163,4875,288,1247,00:00:33.000,2025-04-07 08:18:31.570
false,false,5168,4880,288,1401,00:00:31.000,2025-04-07 08:21:01.626
false,false,5169,4881,288,1434,00:00:33.000,2025-04-07 08:21:31.632
false,false,5172,4884,288,1525,00:00:30.000,2025-04-07 08:23:01.664
false,false,5170,4882,288,1465,00:00:31.000,2025-04-07 08:22:01.642
false,false,5171,4883,288,1495,00:00:30.000,2025-04-07 08:22:31.654
false,false,5173,4885,288,1557,00:00:32.000,2025-04-07 08:23:31.678
false,false,5175,4887,288,1620,00:00:32.000,2025-04-07 08:24:31.698
false,false,5174,4886,288,1588,00:00:31.000,2025-04-07 08:24:01.688
false,false,5176,4888,288,1651,00:00:31.000,2025-04-07 08:25:01.710
false,false,5177,4889,288,1681,00:00:30.000,2025-04-07 08:25:31.725
false,false,5178,4889,289,1711,00:00:30.000,2025-04-07 08:26:01.739
false,false,5179,4890,289,1742,00:00:31.000,2025-04-07 08:26:31.748
false,false,5180,4891,289,1774,00:00:32.000,2025-04-07 08:27:01.760
false,false,5182,4893,289,1837,00:00:33.000,2025-04-07 08:28:01.787
false,false,5181,4892,289,1804,00:00:30.000,2025-04-07 08:27:31.773
false,false,5184,4895,289,1902,00:00:32.000,2025-04-07 08:29:01.808
false,false,5183,4894,289,1870,00:00:33.000,2025-04-07 08:28:31.796
false,false,5185,4896,289,1934,00:00:32.000,2025-04-07 08:29:31.819
false,false,5186,4897,289,1966,00:00:32.000,2025-04-07 08:30:01.832
false,false,5187,4898,289,1997,00:00:31.000,2025-04-07 08:30:31.843
false,false,5189,4900,289,2062,00:00:33.000,2025-04-07 08:31:31.863
false,false,5188,4899,289,2029,00:00:32.000,2025-04-07 08:31:01.850
false,false,5190,4901,289,2095,00:00:33.000,2025-04-07 08:32:01.874
false,false,5191,4902,289,2126,00:00:31.000,2025-04-07 08:32:31.885
false,false,5192,4903,289,2159,00:00:33.000,2025-04-07 08:33:01.900
false,false,3462,3267,195,691,00:00:32.000,2025-04-06 12:19:39.540
false,false,3465,3269,196,785,00:00:31.000,2025-04-06 12:21:09.582
false,false,3464,3268,196,754,00:00:30.000,2025-04-06 12:20:39.568
false,false,3461,3266,195,659,00:00:32.000,2025-04-06 12:19:09.526
false,false,3463,3268,195,724,00:00:33.000,2025-04-06 12:20:09.553
false,false,3467,3271,196,847,00:00:32.000,2025-04-06 12:22:09.610
false,true,3467,3271,196,0,00:00:00.000,2025-04-06 12:23:09.627
false,false,3460,3265,195,627,00:00:30.000,2025-04-06 12:18:39.513
false,true,3467,3271,196,0,00:00:00.000,2025-04-06 12:23:39.641
false,false,3466,3270,196,815,00:00:30.000,2025-04-06 12:21:39.595
false,true,3467,3271,196,0,00:00:00.000,2025-04-06 12:22:39.614
false,true,3467,3271,196,0,00:00:00.000,2025-04-06 12:24:39.666
false,true,3467,3271,196,0,00:00:00.000,2025-04-06 12:24:09.652
false,true,3467,3271,196,0,00:00:00.000,2025-04-06 12:25:09.676
false,false,3468,3272,196,30,00:00:30.000,2025-04-06 12:25:39.687
false,false,3470,3274,196,90,00:00:30.000,2025-04-06 12:26:39.710
false,false,3469,3273,196,60,00:00:30.000,2025-04-06 12:26:09.699
false,false,3472,3276,196,154,00:00:33.000,2025-04-06 12:27:39.730
false,false,3473,3277,196,185,00:00:31.000,2025-04-06 12:28:09.741
false,true,3475,3279,196,0,00:00:00.000,2025-04-06 12:29:39.771
false,false,3471,3275,196,121,00:00:31.000,2025-04-06 12:27:09.719
false,false,3474,3278,196,215,00:00:30.000,2025-04-06 12:28:39.748
false,true,3475,3279,196,0,00:00:00.000,2025-04-06 12:30:09.783
false,true,3475,3279,196,0,00:00:00.000,2025-04-06 12:31:09.803
false,true,3475,3279,196,0,00:00:00.000,2025-04-06 12:30:39.792
false,false,3475,3279,196,246,00:00:31.000,2025-04-06 12:29:09.758
false,true,3475,3279,196,0,00:00:00.000,2025-04-06 12:32:09.830
false,true,3475,3279,196,0,00:00:00.000,2025-04-06 12:31:39.817
false,false,3478,3281,197,95,00:00:31.000,2025-04-06 12:33:39.869
false,false,3476,3280,196,31,00:00:31.000,2025-04-06 12:32:39.842
false,false,3477,3281,196,64,00:00:33.000,2025-04-06 12:33:09.856
false,false,3479,3282,197,128,00:00:33.000,2025-04-06 12:34:09.880
false,false,3480,3283,197,158,00:00:30.000,2025-04-06 12:34:39.893
false,false,3481,3284,197,189,00:00:31.000,2025-04-06 12:35:09.905
false,false,3483,3286,197,255,00:00:33.000,2025-04-06 12:36:09.928
false,false,3482,3285,197,222,00:00:33.000,2025-04-06 12:35:39.915
false,true,3483,3286,197,0,00:00:00.000,2025-04-06 12:36:39.937
false,true,3483,3286,197,0,00:00:00.000,2025-04-06 12:37:09.951
false,true,3483,3286,197,0,00:00:00.000,2025-04-06 12:37:39.963
false,true,3483,3286,197,0,00:00:00.000,2025-04-06 12:38:09.975
false,false,3485,3288,197,61,00:00:31.000,2025-04-06 12:40:10.022
false,false,3484,3287,197,30,00:00:30.000,2025-04-06 12:39:40.010
false,true,3483,3286,197,0,00:00:00.000,2025-04-06 12:38:39.986
false,true,3483,3286,197,0,00:00:00.000,2025-04-06 12:39:09.999
false,false,3488,3291,197,158,00:00:32.000,2025-04-06 12:41:40.057
false,false,3486,3289,197,94,00:00:33.000,2025-04-06 12:40:40.036
false,false,3487,3290,197,126,00:00:32.000,2025-04-06 12:41:10.046
false,false,3490,3293,197,222,00:00:31.000,2025-04-06 12:42:40.079
false,false,3492,3295,197,286,00:00:33.000,2025-04-06 12:43:40.095
false,false,3491,3294,197,253,00:00:31.000,2025-04-06 12:43:10.086
false,false,3489,3292,197,191,00:00:33.000,2025-04-06 12:42:10.067
false,false,3493,3296,197,316,00:00:30.000,2025-04-06 12:44:10.108
false,false,3494,3297,197,348,00:00:32.000,2025-04-06 12:44:40.119
false,false,3498,3301,197,470,00:00:30.000,2025-04-06 12:46:40.154
false,false,3495,3298,197,378,00:00:30.000,2025-04-06 12:45:10.127
false,false,3497,3300,197,440,00:00:31.000,2025-04-06 12:46:10.143
false,false,3500,3303,197,533,00:00:33.000,2025-04-06 12:47:40.178
false,false,3499,3302,197,500,00:00:30.000,2025-04-06 12:47:10.165
false,false,3501,3304,197,564,00:00:31.000,2025-04-06 12:48:10.192
false,false,3503,3306,197,626,00:00:31.000,2025-04-06 12:49:10.216
false,false,3496,3299,197,409,00:00:31.000,2025-04-06 12:45:40.131
false,false,3502,3305,197,595,00:00:31.000,2025-04-06 12:48:40.206
false,false,3505,3307,198,688,00:00:31.000,2025-04-06 12:50:10.240
false,false,3504,3306,198,657,00:00:31.000,2025-04-06 12:49:40.230
false,false,3508,3310,198,779,00:00:30.000,2025-04-06 12:51:40.273
false,false,3507,3309,198,749,00:00:30.000,2025-04-06 12:51:10.261
false,false,3506,3308,198,719,00:00:31.000,2025-04-06 12:50:40.249
false,false,3509,3311,198,812,00:00:33.000,2025-04-06 12:52:10.285
false,false,3510,3312,198,845,00:00:33.000,2025-04-06 12:52:40.296
false,true,3510,3312,198,0,00:00:00.000,2025-04-06 12:53:10.307
false,true,3510,3312,198,0,00:00:00.000,2025-04-06 12:54:40.344
false,true,3510,3312,198,0,00:00:00.000,2025-04-06 12:54:10.331
false,true,3510,3312,198,0,00:00:00.000,2025-04-06 12:53:40.317
false,true,3510,3312,198,0,00:00:00.000,2025-04-06 12:55:10.345
false,true,3510,3312,198,0,00:00:00.000,2025-04-06 12:55:40.357
false,false,3511,3313,198,31,00:00:31.000,2025-04-06 12:56:10.369
false,false,3513,3314,199,96,00:00:32.000,2025-04-06 12:57:10.382
false,false,3514,3315,199,126,00:00:30.000,2025-04-06 12:57:40.396
false,false,3512,3313,199,64,00:00:33.000,2025-04-06 12:56:40.372
false,false,3515,3316,199,157,00:00:31.000,2025-04-06 12:58:10.410
false,false,3517,3318,199,223,00:00:33.000,2025-04-06 12:59:10.437
false,false,3516,3317,199,190,00:00:33.000,2025-04-06 12:58:40.424
false,false,3519,3320,199,285,00:00:32.000,2025-04-06 13:00:10.462
false,true,3519,3320,199,0,00:00:00.000,2025-04-06 13:00:40.474
false,true,3519,3320,199,0,00:00:00.000,2025-04-06 13:01:10.488
false,true,3519,3320,199,0,00:00:00.000,2025-04-06 13:01:40.496
false,true,3519,3320,199,0,00:00:00.000,2025-04-06 13:02:10.509
false,true,3519,3320,199,0,00:00:00.000,2025-04-06 13:02:40.521
false,true,3519,3320,199,0,00:00:00.000,2025-04-06 13:03:10.527
false,false,3520,3321,199,30,00:00:30.000,2025-04-06 13:03:40.539
false,false,3518,3319,199,253,00:00:30.000,2025-04-06 12:59:40.450
false,false,3521,3322,199,60,00:00:30.000,2025-04-06 13:04:10.550
false,true,3522,3323,199,0,00:00:00.000,2025-04-06 13:06:10.599
false,true,3522,3323,199,0,00:00:00.000,2025-04-06 13:05:10.573
false,false,3522,3323,199,90,00:00:30.000,2025-04-06 13:04:40.563
false,true,3522,3323,199,0,00:00:00.000,2025-04-06 13:06:40.611
false,true,3522,3323,199,0,00:00:00.000,2025-04-06 13:05:40.586
false,true,3522,3323,199,0,00:00:00.000,2025-04-06 13:07:10.624
false,false,3524,3325,199,66,00:00:33.000,2025-04-06 13:08:40.649
false,true,3522,3323,199,0,00:00:00.000,2025-04-06 13:07:40.637
false,false,3525,3326,199,99,00:00:33.000,2025-04-06 13:09:10.662
false,false,3523,3324,199,33,00:00:33.000,2025-04-06 13:08:10.639
false,false,3526,3327,199,131,00:00:32.000,2025-04-06 13:09:40.671
false,false,3527,3328,199,161,00:00:30.000,2025-04-06 13:10:10.680
false,false,3530,3330,200,256,00:00:32.000,2025-04-06 13:11:40.719
false,false,3528,3328,200,193,00:00:32.000,2025-04-06 13:10:40.694
false,false,3532,3332,200,322,00:00:33.000,2025-04-06 13:12:40.743
false,false,3529,3329,200,224,00:00:31.000,2025-04-06 13:11:10.708
false,false,3531,3331,200,289,00:00:33.000,2025-04-06 13:12:10.731
false,false,3533,3333,200,354,00:00:32.000,2025-04-06 13:13:10.756
false,false,3535,3335,200,418,00:00:31.000,2025-04-06 13:14:10.779
false,false,3534,3334,200,387,00:00:33.000,2025-04-06 13:13:40.767
false,false,3536,3336,200,450,00:00:32.000,2025-04-06 13:14:40.789
false,false,3537,3337,200,483,00:00:33.000,2025-04-06 13:15:10.800
false,true,3537,3337,200,0,00:00:00.000,2025-04-06 13:15:40.815
false,true,3537,3337,200,0,00:00:00.000,2025-04-06 13:16:10.827
false,true,3537,3337,200,0,00:00:00.000,2025-04-06 13:16:40.840
false,true,3537,3337,200,0,00:00:00.000,2025-04-06 13:17:10.854
false,false,3538,3338,200,31,00:00:31.000,2025-04-06 13:18:40.888
false,true,3537,3337,200,0,00:00:00.000,2025-04-06 13:18:10.878
false,true,3537,3337,200,0,00:00:00.000,2025-04-06 13:17:40.865
false,false,3539,3339,200,64,00:00:33.000,2025-04-06 13:19:10.900
false,false,3540,3340,200,96,00:00:32.000,2025-04-06 13:19:40.911
false,false,3541,3341,200,126,00:00:30.000,2025-04-06 13:20:10.925
false,false,3542,3342,200,157,00:00:31.000,2025-04-06 13:20:40.938
false,false,3543,3343,200,189,00:00:32.000,2025-04-06 13:21:10.948
false,false,3544,3344,200,222,00:00:33.000,2025-04-06 13:21:40.961
false,true,108,104,4,0,00:00:00.000,2025-04-04 22:15:19.850
false,false,110,106,4,62,00:00:31.000,2025-04-04 22:16:49.855
false,true,108,104,4,0,00:00:00.000,2025-04-04 22:15:49.851
false,true,108,104,4,0,00:00:00.000,2025-04-04 22:14:49.848
false,true,108,104,4,0,00:00:00.000,2025-04-04 22:14:19.845
false,false,109,105,4,31,00:00:31.000,2025-04-04 22:16:19.853
false,false,111,107,4,95,00:00:33.000,2025-04-04 22:17:19.858
false,false,112,108,4,128,00:00:33.000,2025-04-04 22:17:49.861
false,false,115,111,4,220,00:00:31.000,2025-04-04 22:19:19.868
false,false,113,109,4,158,00:00:30.000,2025-04-04 22:18:19.864
false,false,114,110,4,189,00:00:31.000,2025-04-04 22:18:49.865
false,false,117,113,4,282,00:00:32.000,2025-04-04 22:20:19.873
false,false,116,112,4,250,00:00:30.000,2025-04-04 22:19:49.870
false,false,118,114,4,315,00:00:33.000,2025-04-04 22:20:49.876
false,true,118,114,4,0,00:00:00.000,2025-04-04 22:21:19.877
false,true,118,114,4,0,00:00:00.000,2025-04-04 22:22:19.881
false,true,118,114,4,0,00:00:00.000,2025-04-04 22:21:49.878
false,true,118,114,4,0,00:00:00.000,2025-04-04 22:23:19.887
false,true,118,114,4,0,00:00:00.000,2025-04-04 22:22:49.884
false,true,118,114,4,0,00:00:00.000,2025-04-04 22:23:49.887
false,false,119,115,4,32,00:00:32.000,2025-04-04 22:24:19.890
false,false,120,116,4,62,00:00:30.000,2025-04-04 22:24:49.891
false,false,122,118,4,125,00:00:30.000,2025-04-04 22:25:49.895
false,false,121,117,4,95,00:00:33.000,2025-04-04 22:25:19.894
false,false,123,119,4,157,00:00:32.000,2025-04-04 22:26:19.897
false,false,125,121,4,218,00:00:30.000,2025-04-04 22:27:19.903
false,false,126,122,4,251,00:00:33.000,2025-04-04 22:27:49.904
false,false,124,120,4,188,00:00:31.000,2025-04-04 22:26:49.900
false,false,129,125,4,348,00:00:33.000,2025-04-04 22:29:19.909
false,false,127,123,4,283,00:00:32.000,2025-04-04 22:28:19.906
false,false,128,124,4,315,00:00:32.000,2025-04-04 22:28:49.908
false,false,130,126,4,379,00:00:31.000,2025-04-04 22:29:49.911
false,false,131,127,4,410,00:00:31.000,2025-04-04 22:30:19.913
false,false,133,129,4,472,00:00:30.000,2025-04-04 22:31:19.917
false,false,134,130,4,504,00:00:32.000,2025-04-04 22:31:49.917
false,false,135,131,4,536,00:00:32.000,2025-04-04 22:32:19.920
false,false,136,132,4,567,00:00:31.000,2025-04-04 22:32:49.921
false,false,132,128,4,442,00:00:32.000,2025-04-04 22:30:49.915
false,false,137,133,4,599,00:00:32.000,2025-04-04 22:33:19.924
false,false,139,135,4,660,00:00:30.000,2025-04-04 22:34:19.929
false,false,138,134,4,630,00:00:31.000,2025-04-04 22:33:49.927
false,false,142,138,4,753,00:00:33.000,2025-04-04 22:35:49.935
false,false,140,136,4,690,00:00:30.000,2025-04-04 22:34:49.931
false,false,141,137,4,720,00:00:30.000,2025-04-04 22:35:19.933
false,false,144,140,4,815,00:00:32.000,2025-04-04 22:36:49.938
false,false,143,139,4,783,00:00:30.000,2025-04-04 22:36:19.936
false,false,146,142,4,879,00:00:32.000,2025-04-04 22:37:49.942
false,false,145,141,4,847,00:00:32.000,2025-04-04 22:37:19.940
false,false,148,144,4,943,00:00:33.000,2025-04-04 22:38:49.946
false,false,147,143,4,910,00:00:31.000,2025-04-04 22:38:19.945
false,false,149,145,4,976,00:00:33.000,2025-04-04 22:39:19.948
false,false,152,148,4,1072,00:00:31.000,2025-04-04 22:40:49.952
false,false,151,147,4,1041,00:00:32.000,2025-04-04 22:40:19.949
false,false,150,146,4,1009,00:00:33.000,2025-04-04 22:39:49.949
false,false,153,149,4,1102,00:00:30.000,2025-04-04 22:41:19.955
false,false,154,150,4,1135,00:00:33.000,2025-04-04 22:41:49.956
false,false,156,151,5,1196,00:00:30.000,2025-04-04 22:42:49.960
false,false,155,151,4,1166,00:00:31.000,2025-04-04 22:42:19.958
false,false,158,153,5,1257,00:00:31.000,2025-04-04 22:43:49.964
false,false,160,155,5,1322,00:00:32.000,2025-04-04 22:44:49.968
false,false,157,152,5,1226,00:00:30.000,2025-04-04 22:43:19.962
false,false,161,156,5,1354,00:00:32.000,2025-04-04 22:45:19.970
false,false,159,154,5,1290,00:00:33.000,2025-04-04 22:44:19.966
false,false,163,158,5,1417,00:00:32.000,2025-04-04 22:46:19.974
false,false,164,159,5,1448,00:00:31.000,2025-04-04 22:46:49.976
false,false,166,161,5,1510,00:00:30.000,2025-04-04 22:47:49.980
false,false,162,157,5,1385,00:00:31.000,2025-04-04 22:45:49.971
false,false,165,160,5,1480,00:00:32.000,2025-04-04 22:47:19.978
false,false,168,163,5,1573,00:00:32.000,2025-04-04 22:48:49.984
false,false,170,165,5,1636,00:00:33.000,2025-04-04 22:49:49.988
false,false,169,164,5,1603,00:00:30.000,2025-04-04 22:49:19.985
false,false,171,166,5,1668,00:00:32.000,2025-04-04 22:50:19.989
false,false,167,162,5,1541,00:00:31.000,2025-04-04 22:48:19.981
false,false,172,166,6,1700,00:00:32.000,2025-04-04 22:50:49.993
false,false,173,167,6,1730,00:00:30.000,2025-04-04 22:51:19.993
false,true,174,168,6,0,00:00:00.000,2025-04-04 22:52:19.997
false,false,174,168,6,1760,00:00:30.000,2025-04-04 22:51:49.995
false,true,174,168,6,0,00:00:00.000,2025-04-04 22:53:20.001
false,true,174,168,6,0,00:00:00.000,2025-04-04 22:53:50.004
false,true,174,168,6,0,00:00:00.000,2025-04-04 22:52:49.999
false,true,174,168,6,0,00:00:00.000,2025-04-04 22:54:20.005
false,true,174,168,6,0,00:00:00.000,2025-04-04 22:55:20.008
false,true,174,168,6,0,00:00:00.000,2025-04-04 22:55:50.009
false,true,174,168,6,0,00:00:00.000,2025-04-04 22:56:20.010
false,true,174,168,6,0,00:00:00.000,2025-04-04 22:56:50.012
false,true,174,168,6,0,00:00:00.000,2025-04-04 22:57:20.012
false,false,175,169,6,33,00:00:33.000,2025-04-04 22:58:20.013
false,true,174,168,6,0,00:00:00.000,2025-04-04 22:54:50.007
false,true,174,168,6,0,00:00:00.000,2025-04-04 22:57:50.012
false,false,179,172,7,160,00:00:31.000,2025-04-04 23:00:20.021
false,false,176,169,7,66,00:00:33.000,2025-04-04 22:58:50.014
false,false,178,171,7,129,00:00:33.000,2025-04-04 22:59:50.019
false,false,177,170,7,96,00:00:30.000,2025-04-04 22:59:20.016
false,false,180,173,7,193,00:00:33.000,2025-04-04 23:00:50.023
false,false,181,174,7,226,00:00:33.000,2025-04-04 23:01:20.023
false,false,182,175,7,257,00:00:31.000,2025-04-04 23:01:50.025
false,false,185,178,7,350,00:00:33.000,2025-04-04 23:03:20.028
false,false,183,176,7,287,00:00:30.000,2025-04-04 23:02:20.026
false,false,184,177,7,317,00:00:30.000,2025-04-04 23:02:50.027
false,false,186,178,8,381,00:00:31.000,2025-04-04 23:03:50.030
false,false,188,180,8,444,00:00:33.000,2025-04-04 23:04:50.033
false,false,187,179,8,411,00:00:30.000,2025-04-04 23:04:20.032
false,false,189,181,8,474,00:00:30.000,2025-04-04 23:05:20.035
false,true,190,182,8,0,00:00:00.000,2025-04-04 23:06:50.040
false,false,190,182,8,504,00:00:30.000,2025-04-04 23:05:50.037
false,true,190,182,8,0,00:00:00.000,2025-04-04 23:06:20.039
false,true,190,182,8,0,00:00:00.000,2025-04-04 23:07:20.042
false,true,190,182,8,0,00:00:00.000,2025-04-04 23:07:50.044
false,true,190,182,8,0,00:00:00.000,2025-04-04 23:08:20.046
false,false,191,183,8,31,00:00:31.000,2025-04-04 23:09:20.050
false,false,193,185,8,94,00:00:31.000,2025-04-04 23:10:20.053
false,false,194,186,8,124,00:00:30.000,2025-04-04 23:10:50.054
false,false,192,184,8,63,00:00:32.000,2025-04-04 23:09:50.051
false,true,190,182,8,0,00:00:00.000,2025-04-04 23:08:50.048
false,false,195,187,8,157,00:00:33.000,2025-04-04 23:11:20.055
false,false,196,188,8,188,00:00:31.000,2025-04-04 23:11:50.056
false,false,197,189,8,219,00:00:31.000,2025-04-04 23:12:20.058
false,true,197,189,8,0,00:00:00.000,2025-04-04 23:12:50.060
false,true,197,189,8,0,00:00:00.000,2025-04-04 23:13:20.062
false,true,197,189,8,0,00:00:00.000,2025-04-04 23:14:50.064
false,true,197,189,8,0,00:00:00.000,2025-04-04 23:15:20.066
false,true,197,189,8,0,00:00:00.000,2025-04-04 23:14:20.063
false,true,197,189,8,0,00:00:00.000,2025-04-04 23:13:50.062
false,false,2670,2518,152,877,00:00:31.000,2025-04-06 02:52:26.196
false,false,2673,2521,152,970,00:00:30.000,2025-04-06 02:53:56.218
false,false,2668,2516,152,816,00:00:31.000,2025-04-06 02:51:26.167
false,false,2669,2517,152,846,00:00:30.000,2025-04-06 02:51:56.181
false,false,2671,2519,152,910,00:00:33.000,2025-04-06 02:52:56.209
false,false,2672,2520,152,940,00:00:30.000,2025-04-06 02:53:26.213
false,false,2674,2522,152,1003,00:00:33.000,2025-04-06 02:54:26.232
false,false,2675,2523,152,1034,00:00:31.000,2025-04-06 02:54:56.246
false,false,2676,2524,152,1067,00:00:33.000,2025-04-06 02:55:26.261
false,false,2678,2526,152,1132,00:00:32.000,2025-04-06 02:56:26.291
false,false,2677,2525,152,1100,00:00:33.000,2025-04-06 02:55:56.276
false,true,2679,2527,152,0,00:00:00.000,2025-04-06 02:57:26.314
false,false,2679,2527,152,1162,00:00:30.000,2025-04-06 02:56:56.305
false,true,2679,2527,152,0,00:00:00.000,2025-04-06 02:58:26.344
false,true,2679,2527,152,0,00:00:00.000,2025-04-06 02:59:26.371
false,true,2679,2527,152,0,00:00:00.000,2025-04-06 02:59:56.382
false,false,2680,2528,152,31,00:00:31.000,2025-04-06 03:00:26.393
false,true,2679,2527,152,0,00:00:00.000,2025-04-06 02:57:56.328
false,false,2683,2531,152,124,00:00:31.000,2025-04-06 03:01:56.434
false,false,2681,2529,152,62,00:00:31.000,2025-04-06 03:00:56.406
false,true,2679,2527,152,0,00:00:00.000,2025-04-06 02:58:56.357
false,false,2682,2530,152,93,00:00:31.000,2025-04-06 03:01:26.421
false,false,2686,2534,152,219,00:00:31.000,2025-04-06 03:03:26.468
false,false,2687,2535,152,252,00:00:33.000,2025-04-06 03:03:56.480
false,false,2684,2532,152,157,00:00:33.000,2025-04-06 03:02:26.445
false,false,2685,2533,152,188,00:00:31.000,2025-04-06 03:02:56.454
false,false,2690,2538,152,344,00:00:30.000,2025-04-06 03:05:26.521
false,false,2688,2536,152,282,00:00:30.000,2025-04-06 03:04:26.492
false,false,2689,2537,152,314,00:00:32.000,2025-04-06 03:04:56.506
false,false,2693,2541,152,440,00:00:32.000,2025-04-06 03:06:56.553
false,false,2691,2539,152,376,00:00:32.000,2025-04-06 03:05:56.529
false,false,2692,2540,152,408,00:00:32.000,2025-04-06 03:06:26.540
false,false,2694,2542,152,470,00:00:30.000,2025-04-06 03:07:26.562
false,false,2695,2543,152,503,00:00:33.000,2025-04-06 03:07:56.571
false,false,2696,2544,152,534,00:00:31.000,2025-04-06 03:08:26.584
false,true,2696,2544,152,0,00:00:00.000,2025-04-06 03:08:56.596
false,true,2696,2544,152,0,00:00:00.000,2025-04-06 03:10:56.645
false,true,2696,2544,152,0,00:00:00.000,2025-04-06 03:10:26.632
false,true,2696,2544,152,0,00:00:00.000,2025-04-06 03:09:56.619
false,true,2696,2544,152,0,00:00:00.000,2025-04-06 03:09:26.607
false,false,2697,2545,152,33,00:00:33.000,2025-04-06 03:11:56.673
false,true,2698,2546,152,0,00:00:00.000,2025-04-06 03:12:56.695
false,true,2698,2546,152,0,00:00:00.000,2025-04-06 03:13:56.717
false,true,2698,2546,152,0,00:00:00.000,2025-04-06 03:13:26.704
false,true,2696,2544,152,0,00:00:00.000,2025-04-06 03:11:26.660
false,false,2698,2546,152,64,00:00:31.000,2025-04-06 03:12:26.688
false,true,2698,2546,152,0,00:00:00.000,2025-04-06 03:14:26.730
false,true,2698,2546,152,0,00:00:00.000,2025-04-06 03:15:26.755
false,false,2700,2548,152,63,00:00:33.000,2025-04-06 03:16:26.773
false,false,2699,2547,152,30,00:00:30.000,2025-04-06 03:15:56.762
false,false,2701,2548,153,93,00:00:30.000,2025-04-06 03:16:56.778
false,true,2698,2546,152,0,00:00:00.000,2025-04-06 03:14:56.740
false,false,2703,2550,153,155,00:00:32.000,2025-04-06 03:17:56.793
false,false,2702,2549,153,123,00:00:30.000,2025-04-06 03:17:26.781
false,false,2704,2551,153,186,00:00:31.000,2025-04-06 03:18:26.801
false,false,2705,2552,153,218,00:00:32.000,2025-04-06 03:18:56.817
false,false,2706,2553,153,249,00:00:31.000,2025-04-06 03:19:26.827
false,false,2707,2554,153,280,00:00:31.000,2025-04-06 03:19:56.838
false,false,2708,2555,153,312,00:00:32.000,2025-04-06 03:20:26.851
false,false,2710,2556,154,375,00:00:32.000,2025-04-06 03:21:26.874
false,false,2712,2558,154,436,00:00:30.000,2025-04-06 03:22:26.902
false,false,2709,2556,153,343,00:00:31.000,2025-04-06 03:20:56.863
false,false,2715,2561,154,529,00:00:30.000,2025-04-06 03:23:56.936
false,false,2711,2557,154,406,00:00:31.000,2025-04-06 03:21:56.887
false,false,2716,2562,154,562,00:00:33.000,2025-04-06 03:24:26.948
false,false,2713,2559,154,469,00:00:33.000,2025-04-06 03:22:56.915
false,false,2714,2560,154,499,00:00:30.000,2025-04-06 03:23:26.929
false,false,2717,2563,154,593,00:00:31.000,2025-04-06 03:24:56.960
false,false,2718,2564,154,624,00:00:31.000,2025-04-06 03:25:26.969
false,false,2719,2565,154,655,00:00:31.000,2025-04-06 03:25:56.982
false,false,2721,2567,154,716,00:00:30.000,2025-04-06 03:26:57.011
false,false,2720,2566,154,686,00:00:31.000,2025-04-06 03:26:26.996
false,false,2722,2568,154,746,00:00:30.000,2025-04-06 03:27:27.022
false,false,2723,2569,154,779,00:00:33.000,2025-04-06 03:27:57.031
false,false,2726,2572,154,874,00:00:30.000,2025-04-06 03:29:27.067
false,false,2727,2573,154,905,00:00:31.000,2025-04-06 03:29:57.082
false,false,2724,2570,154,812,00:00:33.000,2025-04-06 03:28:27.039
false,false,2728,2574,154,935,00:00:30.000,2025-04-06 03:30:27.090
false,false,2725,2571,154,844,00:00:32.000,2025-04-06 03:28:57.053
false,false,2729,2575,154,966,00:00:31.000,2025-04-06 03:30:57.091
false,false,2730,2576,154,997,00:00:31.000,2025-04-06 03:31:27.106
false,false,2731,2577,154,1027,00:00:30.000,2025-04-06 03:31:57.115
false,false,2733,2579,154,1090,00:00:33.000,2025-04-06 03:32:57.137
false,false,2732,2578,154,1057,00:00:30.000,2025-04-06 03:32:27.127
false,false,2734,2580,154,1120,00:00:30.000,2025-04-06 03:33:27.152
false,false,2736,2582,154,1184,00:00:33.000,2025-04-06 03:34:27.169
false,false,2735,2581,154,1151,00:00:31.000,2025-04-06 03:33:57.166
false,false,2737,2583,154,1215,00:00:31.000,2025-04-06 03:34:57.177
false,false,2739,2584,155,1281,00:00:33.000,2025-04-06 03:35:57.195
false,false,2740,2585,155,1311,00:00:30.000,2025-04-06 03:36:27.204
false,false,2741,2586,155,1342,00:00:31.000,2025-04-06 03:36:57.220
false,false,2738,2583,155,1248,00:00:33.000,2025-04-06 03:35:27.183
false,false,2742,2587,155,1374,00:00:32.000,2025-04-06 03:37:27.234
false,false,2743,2588,155,1405,00:00:31.000,2025-04-06 03:37:57.247
false,false,2744,2589,155,1438,00:00:33.000,2025-04-06 03:38:27.261
false,false,2746,2591,155,1502,00:00:33.000,2025-04-06 03:39:27.282
false,false,2747,2592,155,1534,00:00:32.000,2025-04-06 03:39:57.291
false,false,2745,2590,155,1469,00:00:31.000,2025-04-06 03:38:57.270
false,false,2748,2593,155,1566,00:00:32.000,2025-04-06 03:40:27.304
false,false,2749,2594,155,1596,00:00:30.000,2025-04-06 03:40:57.313
false,false,2751,2596,155,1659,00:00:32.000,2025-04-06 03:41:57.341
false,false,2750,2595,155,1627,00:00:31.000,2025-04-06 03:41:27.327
false,true,2753,2598,155,0,00:00:00.000,2025-04-06 03:43:27.372
false,false,2753,2598,155,1722,00:00:32.000,2025-04-06 03:42:57.358
false,false,2752,2597,155,1690,00:00:31.000,2025-04-06 03:42:27.346
false,true,2753,2598,155,0,00:00:00.000,2025-04-06 03:43:57.382
false,true,2753,2598,155,0,00:00:00.000,2025-04-06 03:44:27.393
false,true,2753,2598,155,0,00:00:00.000,2025-04-06 03:45:57.430
false,true,2753,2598,155,0,00:00:00.000,2025-04-06 03:44:57.408
false,true,2753,2598,155,0,00:00:00.000,2025-04-06 03:45:27.419
false,false,2754,2599,155,31,00:00:31.000,2025-04-06 03:46:27.438
false,true,2755,2600,155,0,00:00:00.000,2025-04-06 03:47:27.462
false,false,2755,2600,155,61,00:00:30.000,2025-04-06 03:46:57.451
false,true,2755,2600,155,0,00:00:00.000,2025-04-06 03:48:57.496
false,true,2755,2600,155,0,00:00:00.000,2025-04-06 03:47:57.474
false,true,2755,2600,155,0,00:00:00.000,2025-04-06 03:48:27.483
false,false,2756,2601,155,32,00:00:32.000,2025-04-06 03:50:27.537
false,true,2755,2600,155,0,00:00:00.000,2025-04-06 03:49:27.509
false,true,2755,2600,155,0,00:00:00.000,2025-04-06 03:49:57.522
false,false,2757,2602,155,65,00:00:33.000,2025-04-06 03:50:57.552
false,false,2758,2602,156,98,00:00:33.000,2025-04-06 03:51:27.568
false,false,2760,2604,156,164,00:00:33.000,2025-04-06 03:52:27.589
false,false,2761,2605,156,197,00:00:33.000,2025-04-06 03:52:57.598
false,false,2759,2603,156,131,00:00:33.000,2025-04-06 03:51:57.580
false,false,2762,2606,156,229,00:00:32.000,2025-04-06 03:53:27.610
false,false,2763,2606,157,262,00:00:33.000,2025-04-06 03:53:57.621
false,false,4086,3852,234,156,00:00:31.000,2025-04-06 19:46:49.321
false,false,4089,3855,234,253,00:00:32.000,2025-04-06 19:48:19.355
false,false,4088,3854,234,221,00:00:32.000,2025-04-06 19:47:49.343
false,false,4090,3856,234,283,00:00:30.000,2025-04-06 19:48:49.364
false,false,4091,3857,234,316,00:00:33.000,2025-04-06 19:49:19.374
false,false,4087,3853,234,189,00:00:33.000,2025-04-06 19:47:19.333
false,false,4092,3858,234,347,00:00:31.000,2025-04-06 19:49:49.387
false,false,4093,3859,234,378,00:00:31.000,2025-04-06 19:50:19.396
false,false,4094,3860,234,411,00:00:33.000,2025-04-06 19:50:49.408
false,false,4095,3861,234,444,00:00:33.000,2025-04-06 19:51:19.418
false,false,4096,3862,234,474,00:00:30.000,2025-04-06 19:51:49.430
false,false,4097,3863,234,507,00:00:33.000,2025-04-06 19:52:19.440
false,false,4102,3867,235,661,00:00:32.000,2025-04-06 19:54:49.496
false,false,4100,3865,235,599,00:00:30.000,2025-04-06 19:53:49.473
false,false,4099,3864,235,569,00:00:32.000,2025-04-06 19:53:19.462
false,false,4101,3866,235,629,00:00:30.000,2025-04-06 19:54:19.484
false,false,4098,3863,235,537,00:00:30.000,2025-04-06 19:52:49.450
false,false,4103,3868,235,691,00:00:30.000,2025-04-06 19:55:19.505
false,false,4104,3869,235,722,00:00:31.000,2025-04-06 19:55:49.517
false,false,4106,3871,235,783,00:00:30.000,2025-04-06 19:56:49.538
false,false,4105,3870,235,753,00:00:31.000,2025-04-06 19:56:19.527
false,false,4107,3872,235,814,00:00:31.000,2025-04-06 19:57:19.550
false,false,4108,3872,236,846,00:00:32.000,2025-04-06 19:57:49.561
false,false,4109,3873,236,876,00:00:30.000,2025-04-06 19:58:19.572
false,false,4110,3874,236,907,00:00:31.000,2025-04-06 19:58:49.580
false,false,4114,3878,236,1033,00:00:32.000,2025-04-06 20:00:49.617
false,false,4112,3876,236,970,00:00:30.000,2025-04-06 19:59:49.595
false,false,4113,3877,236,1001,00:00:31.000,2025-04-06 20:00:19.607
false,false,4115,3879,236,1066,00:00:33.000,2025-04-06 20:01:19.629
false,false,4116,3880,236,1099,00:00:33.000,2025-04-06 20:01:49.639
false,false,4111,3875,236,940,00:00:33.000,2025-04-06 19:59:19.591
false,false,4118,3882,236,1162,00:00:30.000,2025-04-06 20:02:49.658
false,false,4117,3881,236,1132,00:00:33.000,2025-04-06 20:02:19.650
false,true,4118,3882,236,0,00:00:00.000,2025-04-06 20:03:19.667
false,true,4118,3882,236,0,00:00:00.000,2025-04-06 20:03:49.678
false,true,4118,3882,236,0,00:00:00.000,2025-04-06 20:04:49.700
false,true,4118,3882,236,0,00:00:00.000,2025-04-06 20:04:19.689
false,true,4118,3882,236,0,00:00:00.000,2025-04-06 20:05:49.723
false,false,4120,3884,236,66,00:00:33.000,2025-04-06 20:06:49.744
false,true,4118,3882,236,0,00:00:00.000,2025-04-06 20:05:19.711
false,false,4119,3883,236,33,00:00:33.000,2025-04-06 20:06:19.734
false,false,4124,3888,236,190,00:00:31.000,2025-04-06 20:08:49.781
false,false,4125,3889,236,220,00:00:30.000,2025-04-06 20:09:19.793
false,true,4125,3889,236,0,00:00:00.000,2025-04-06 20:09:49.800
false,false,4123,3887,236,159,00:00:30.000,2025-04-06 20:08:19.770
false,false,4122,3886,236,129,00:00:30.000,2025-04-06 20:07:49.761
false,false,4121,3885,236,99,00:00:33.000,2025-04-06 20:07:19.750
false,true,4125,3889,236,0,00:00:00.000,2025-04-06 20:10:19.807
false,true,4125,3889,236,0,00:00:00.000,2025-04-06 20:11:19.830
false,true,4125,3889,236,0,00:00:00.000,2025-04-06 20:10:49.819
false,true,4125,3889,236,0,00:00:00.000,2025-04-06 20:12:19.848
false,true,4125,3889,236,0,00:00:00.000,2025-04-06 20:11:49.841
false,false,4128,3892,236,94,00:00:30.000,2025-04-06 20:13:49.876
false,false,4129,3893,236,127,00:00:33.000,2025-04-06 20:14:19.887
false,false,4131,3895,236,189,00:00:32.000,2025-04-06 20:15:19.906
false,false,4126,3890,236,31,00:00:31.000,2025-04-06 20:12:49.856
false,false,4127,3891,236,64,00:00:33.000,2025-04-06 20:13:19.865
false,false,4130,3894,236,157,00:00:30.000,2025-04-06 20:14:49.899
false,true,4134,3898,236,0,00:00:00.000,2025-04-06 20:17:19.944
false,false,4134,3898,236,286,00:00:32.000,2025-04-06 20:16:49.933
false,false,4132,3896,236,221,00:00:32.000,2025-04-06 20:15:49.913
false,false,4133,3897,236,254,00:00:33.000,2025-04-06 20:16:19.922
false,true,4134,3898,236,0,00:00:00.000,2025-04-06 20:17:49.955
false,true,4134,3898,236,0,00:00:00.000,2025-04-06 20:18:19.957
false,true,4134,3898,236,0,00:00:00.000,2025-04-06 20:19:19.978
false,true,4134,3898,236,0,00:00:00.000,2025-04-06 20:19:49.987
false,true,4134,3898,236,0,00:00:00.000,2025-04-06 20:18:49.968
false,false,4135,3899,236,33,00:00:33.000,2025-04-06 20:20:19.994
false,false,4136,3900,236,64,00:00:31.000,2025-04-06 20:20:50.001
false,false,4137,3901,236,95,00:00:31.000,2025-04-06 20:21:20.007
false,false,4140,3903,237,191,00:00:31.000,2025-04-06 20:22:50.039
false,false,4138,3902,236,128,00:00:33.000,2025-04-06 20:21:50.018
false,false,4142,3905,237,254,00:00:33.000,2025-04-06 20:23:50.053
false,false,4139,3902,237,160,00:00:32.000,2025-04-06 20:22:20.028
false,false,4141,3904,237,221,00:00:30.000,2025-04-06 20:23:20.049
false,true,4142,3905,237,0,00:00:00.000,2025-04-06 20:24:20.059
false,true,4142,3905,237,0,00:00:00.000,2025-04-06 20:24:50.070
false,true,4142,3905,237,0,00:00:00.000,2025-04-06 20:26:20.098
false,true,4142,3905,237,0,00:00:00.000,2025-04-06 20:25:50.088
false,true,4142,3905,237,0,00:00:00.000,2025-04-06 20:25:20.079
false,true,4142,3905,237,0,00:00:00.000,2025-04-06 20:26:50.109
false,false,4143,3906,237,30,00:00:30.000,2025-04-06 20:27:20.120
false,false,4144,3906,238,62,00:00:32.000,2025-04-06 20:27:50.125
false,false,4145,3907,238,93,00:00:31.000,2025-04-06 20:28:20.134
false,false,4147,3908,239,158,00:00:33.000,2025-04-06 20:29:20.151
false,true,4147,3908,239,0,00:00:00.000,2025-04-06 20:30:20.172
false,true,4147,3908,239,0,00:00:00.000,2025-04-06 20:29:50.161
false,false,4146,3908,238,125,00:00:32.000,2025-04-06 20:28:50.140
false,true,4147,3908,239,0,00:00:00.000,2025-04-06 20:30:50.183
false,true,4147,3908,239,0,00:00:00.000,2025-04-06 20:31:20.194
false,true,4147,3908,239,0,00:00:00.000,2025-04-06 20:31:50.200
false,false,4149,3910,239,66,00:00:33.000,2025-04-06 20:33:20.233
false,true,4147,3908,239,0,00:00:00.000,2025-04-06 20:32:20.211
false,false,4148,3909,239,33,00:00:33.000,2025-04-06 20:32:50.222
false,false,4154,3915,239,226,00:00:30.000,2025-04-06 20:35:50.284
false,false,4153,3914,239,196,00:00:33.000,2025-04-06 20:35:20.274
false,false,4152,3913,239,163,00:00:33.000,2025-04-06 20:34:50.264
false,false,4155,3916,239,259,00:00:33.000,2025-04-06 20:36:20.295
false,false,4150,3911,239,97,00:00:31.000,2025-04-06 20:33:50.243
false,false,4151,3912,239,130,00:00:33.000,2025-04-06 20:34:20.253
false,false,4156,3917,239,292,00:00:33.000,2025-04-06 20:36:50.306
false,false,4157,3918,239,324,00:00:32.000,2025-04-06 20:37:20.316
false,false,4158,3919,239,355,00:00:31.000,2025-04-06 20:37:50.328
false,false,4160,3921,239,419,00:00:32.000,2025-04-06 20:38:50.343
false,false,4159,3920,239,387,00:00:32.000,2025-04-06 20:38:20.338
false,false,4161,3922,239,452,00:00:33.000,2025-04-06 20:39:20.352
false,false,4163,3924,239,516,00:00:32.000,2025-04-06 20:40:20.375
false,false,4162,3923,239,484,00:00:32.000,2025-04-06 20:39:50.363
false,false,4166,3927,239,612,00:00:33.000,2025-04-06 20:41:50.401
false,false,4164,3925,239,547,00:00:31.000,2025-04-06 20:40:50.385
false,false,4165,3926,239,579,00:00:32.000,2025-04-06 20:41:20.391
false,false,4167,3928,239,644,00:00:32.000,2025-04-06 20:42:20.412
false,true,4167,3928,239,0,00:00:00.000,2025-04-06 20:43:20.429
false,true,4167,3928,239,0,00:00:00.000,2025-04-06 20:44:20.438
false,true,4167,3928,239,0,00:00:00.000,2025-04-06 20:42:50.418
false,true,4167,3928,239,0,00:00:00.000,2025-04-06 20:45:20.460
false,true,4167,3928,239,0,00:00:00.000,2025-04-06 20:43:50.437
false,true,4167,3928,239,0,00:00:00.000,2025-04-06 20:45:50.465
false,true,4167,3928,239,0,00:00:00.000,2025-04-06 20:46:20.474
false,true,4167,3928,239,0,00:00:00.000,2025-04-06 20:44:50.450
false,true,4167,3928,239,0,00:00:00.000,2025-04-06 20:46:50.480
false,true,4167,3928,239,0,00:00:00.000,2025-04-06 20:47:20.489
false,true,4167,3928,239,0,00:00:00.000,2025-04-06 20:47:50.493
false,true,4167,3928,239,0,00:00:00.000,2025-04-06 20:48:20.501
false,false,4168,3929,239,33,00:00:33.000,2025-04-06 20:48:50.511
false,false,4170,3931,239,97,00:00:33.000,2025-04-06 20:49:50.531
false,false,4169,3930,239,64,00:00:31.000,2025-04-06 20:49:20.520
false,false,4171,3932,239,130,00:00:33.000,2025-04-06 20:50:20.541
false,true,874,825,49,0,00:00:00.000,2025-04-05 06:40:58.510
false,true,874,825,49,0,00:00:00.000,2025-04-05 06:39:28.480
false,false,873,824,49,252,00:00:32.000,2025-04-05 06:38:28.460
false,true,874,825,49,0,00:00:00.000,2025-04-05 06:40:28.498
false,false,874,825,49,284,00:00:32.000,2025-04-05 06:38:58.470
false,true,874,825,49,0,00:00:00.000,2025-04-05 06:39:58.492
false,true,874,825,49,0,00:00:00.000,2025-04-05 06:41:28.512
false,false,875,826,49,32,00:00:32.000,2025-04-05 06:42:28.538
false,false,877,828,49,93,00:00:31.000,2025-04-05 06:43:28.556
false,true,874,825,49,0,00:00:00.000,2025-04-05 06:41:58.525
false,false,876,827,49,62,00:00:30.000,2025-04-05 06:42:58.553
false,false,879,830,49,155,00:00:31.000,2025-04-05 06:44:28.581
false,false,880,831,49,185,00:00:30.000,2025-04-05 06:44:58.593
false,false,878,829,49,124,00:00:31.000,2025-04-05 06:43:58.564
false,false,881,831,50,217,00:00:32.000,2025-04-05 06:45:28.597
false,false,882,832,50,249,00:00:32.000,2025-04-05 06:45:58.607
false,false,885,835,50,344,00:00:33.000,2025-04-05 06:47:28.646
false,false,884,834,50,311,00:00:32.000,2025-04-05 06:46:58.634
false,false,883,833,50,279,00:00:30.000,2025-04-05 06:46:28.619
false,true,885,835,50,0,00:00:00.000,2025-04-05 06:47:58.656
false,true,885,835,50,0,00:00:00.000,2025-04-05 06:48:28.668
false,true,885,835,50,0,00:00:00.000,2025-04-05 06:48:58.683
false,true,885,835,50,0,00:00:00.000,2025-04-05 06:49:28.690
false,true,885,835,50,0,00:00:00.000,2025-04-05 06:49:58.697
false,false,886,836,50,33,00:00:33.000,2025-04-05 06:50:58.716
false,false,887,837,50,63,00:00:30.000,2025-04-05 06:51:28.731
false,true,885,835,50,0,00:00:00.000,2025-04-05 06:50:28.703
false,false,889,838,51,126,00:00:31.000,2025-04-05 06:52:28.751
false,false,888,837,51,95,00:00:32.000,2025-04-05 06:51:58.740
false,false,891,840,51,190,00:00:32.000,2025-04-05 06:53:28.773
false,false,890,839,51,158,00:00:32.000,2025-04-05 06:52:58.762
false,false,893,842,51,255,00:00:33.000,2025-04-05 06:54:28.791
false,true,893,842,51,0,00:00:00.000,2025-04-05 06:55:58.826
false,true,893,842,51,0,00:00:00.000,2025-04-05 06:55:28.817
false,true,893,842,51,0,00:00:00.000,2025-04-05 06:54:58.806
false,false,892,841,51,222,00:00:32.000,2025-04-05 06:53:58.777
false,true,893,842,51,0,00:00:00.000,2025-04-05 06:56:28.841
false,true,893,842,51,0,00:00:00.000,2025-04-05 06:56:58.853
false,false,894,843,51,33,00:00:33.000,2025-04-05 06:57:58.873
false,true,893,842,51,0,00:00:00.000,2025-04-05 06:57:28.862
false,false,895,844,51,63,00:00:30.000,2025-04-05 06:58:28.885
false,false,896,845,51,96,00:00:33.000,2025-04-05 06:58:58.892
false,false,898,847,51,160,00:00:31.000,2025-04-05 06:59:58.906
false,false,897,846,51,129,00:00:33.000,2025-04-05 06:59:28.904
false,false,899,848,51,190,00:00:30.000,2025-04-05 07:00:28.921
false,false,900,849,51,222,00:00:32.000,2025-04-05 07:00:58.935
false,true,900,849,51,0,00:00:00.000,2025-04-05 07:01:28.943
false,true,900,849,51,0,00:00:00.000,2025-04-05 07:01:58.957
false,true,900,849,51,0,00:00:00.000,2025-04-05 07:02:28.969
false,true,900,849,51,0,00:00:00.000,2025-04-05 07:03:28.987
false,true,900,849,51,0,00:00:00.000,2025-04-05 07:02:58.975
false,true,900,849,51,0,00:00:00.000,2025-04-05 07:03:59.002
false,false,901,850,51,32,00:00:32.000,2025-04-05 07:04:29.007
false,false,903,852,51,96,00:00:32.000,2025-04-05 07:05:29.031
false,false,902,851,51,64,00:00:32.000,2025-04-05 07:04:59.021
false,false,904,853,51,128,00:00:32.000,2025-04-05 07:05:59.042
false,true,904,853,51,0,00:00:00.000,2025-04-05 07:07:29.079
false,true,904,853,51,0,00:00:00.000,2025-04-05 07:07:59.091
false,true,904,853,51,0,00:00:00.000,2025-04-05 07:06:59.068
false,true,904,853,51,0,00:00:00.000,2025-04-05 07:06:29.054
false,true,904,853,51,0,00:00:00.000,2025-04-05 07:08:59.115
false,true,904,853,51,0,00:00:00.000,2025-04-05 07:08:29.102
false,false,905,854,51,30,00:00:30.000,2025-04-05 07:09:29.125
false,false,906,855,51,62,00:00:32.000,2025-04-05 07:09:59.133
false,false,908,857,51,125,00:00:31.000,2025-04-05 07:10:59.158
false,false,907,856,51,94,00:00:32.000,2025-04-05 07:10:29.146
false,false,909,858,51,156,00:00:31.000,2025-04-05 07:11:29.167
false,false,910,859,51,189,00:00:33.000,2025-04-05 07:11:59.179
false,true,910,859,51,0,00:00:00.000,2025-04-05 07:12:29.189
false,true,910,859,51,0,00:00:00.000,2025-04-05 07:12:59.194
false,true,910,859,51,0,00:00:00.000,2025-04-05 07:13:29.207
false,true,910,859,51,0,00:00:00.000,2025-04-05 07:14:59.246
false,true,910,859,51,0,00:00:00.000,2025-04-05 07:14:29.235
false,false,912,861,51,61,00:00:31.000,2025-04-05 07:15:59.270
false,false,913,862,51,93,00:00:32.000,2025-04-05 07:16:29.281
false,false,915,864,51,159,00:00:33.000,2025-04-05 07:17:29.306
false,false,911,860,51,30,00:00:30.000,2025-04-05 07:15:29.258
false,true,910,859,51,0,00:00:00.000,2025-04-05 07:13:59.220
false,false,914,863,51,126,00:00:33.000,2025-04-05 07:16:59.292
false,false,917,866,51,222,00:00:31.000,2025-04-05 07:18:29.333
false,false,916,865,51,191,00:00:32.000,2025-04-05 07:17:59.321
false,false,919,868,51,286,00:00:31.000,2025-04-05 07:19:29.357
false,false,918,867,51,255,00:00:33.000,2025-04-05 07:18:59.344
false,false,921,870,51,349,00:00:31.000,2025-04-05 07:20:29.377
false,false,920,869,51,318,00:00:32.000,2025-04-05 07:19:59.364
false,false,924,873,51,442,00:00:30.000,2025-04-05 07:21:59.409
false,false,922,871,51,380,00:00:31.000,2025-04-05 07:20:59.383
false,false,925,874,51,473,00:00:31.000,2025-04-05 07:22:29.424
false,true,925,874,51,0,00:00:00.000,2025-04-05 07:22:59.436
false,true,925,874,51,0,00:00:00.000,2025-04-05 07:23:29.443
false,true,925,874,51,0,00:00:00.000,2025-04-05 07:24:29.465
false,true,925,874,51,0,00:00:00.000,2025-04-05 07:23:59.454
false,false,923,872,51,412,00:00:32.000,2025-04-05 07:21:29.395
false,true,925,874,51,0,00:00:00.000,2025-04-05 07:24:59.477
false,true,925,874,51,0,00:00:00.000,2025-04-05 07:25:29.487
false,false,926,875,51,31,00:00:31.000,2025-04-05 07:25:59.500
false,false,927,876,51,64,00:00:33.000,2025-04-05 07:26:29.515
false,false,930,879,51,161,00:00:32.000,2025-04-05 07:27:59.542
false,false,929,878,51,129,00:00:32.000,2025-04-05 07:27:29.538
false,false,928,877,51,97,00:00:33.000,2025-04-05 07:26:59.523
false,false,932,881,51,226,00:00:33.000,2025-04-05 07:28:59.567
false,false,931,880,51,193,00:00:32.000,2025-04-05 07:28:29.552
false,false,933,882,51,259,00:00:33.000,2025-04-05 07:29:29.576
false,false,934,883,51,291,00:00:32.000,2025-04-05 07:29:59.591
false,false,935,884,51,322,00:00:31.000,2025-04-05 07:30:29.604
false,true,935,884,51,0,00:00:00.000,2025-04-05 07:30:59.619
false,true,935,884,51,0,00:00:00.000,2025-04-05 07:31:59.645
false,true,935,884,51,0,00:00:00.000,2025-04-05 07:31:29.633
false,true,935,884,51,0,00:00:00.000,2025-04-05 07:32:59.673
false,true,935,884,51,0,00:00:00.000,2025-04-05 07:32:29.658
false,false,936,884,52,31,00:00:31.000,2025-04-05 07:33:59.699
false,true,935,884,51,0,00:00:00.000,2025-04-05 07:33:29.684
false,false,938,886,52,92,00:00:31.000,2025-04-05 07:34:59.721
false,false,937,885,52,61,00:00:30.000,2025-04-05 07:34:29.713
false,false,941,888,53,188,00:00:31.000,2025-04-05 07:36:29.761
false,false,939,887,52,124,00:00:32.000,2025-04-05 07:35:29.736
false,false,942,888,54,218,00:00:30.000,2025-04-05 07:36:59.773
false,false,943,889,54,249,00:00:31.000,2025-04-05 07:37:29.788
false,false,940,887,53,157,00:00:33.000,2025-04-05 07:35:59.748
false,false,944,890,54,279,00:00:30.000,2025-04-05 07:37:59.801
false,false,946,892,54,341,00:00:31.000,2025-04-05 07:38:59.826
false,false,945,891,54,310,00:00:31.000,2025-04-05 07:38:29.813
false,false,947,893,54,374,00:00:33.000,2025-04-05 07:39:29.837
false,false,949,895,54,435,00:00:30.000,2025-04-05 07:40:29.863
false,true,950,895,55,0,00:00:00.000,2025-04-05 07:41:29.883
false,false,950,895,55,466,00:00:31.000,2025-04-05 07:40:59.874
false,false,948,894,54,405,00:00:31.000,2025-04-05 07:39:59.851
false,false,297,285,12,565,00:00:31.000,2025-04-05 00:20:20.403
false,false,295,283,12,501,00:00:33.000,2025-04-05 00:19:20.379
false,false,294,282,12,468,00:00:33.000,2025-04-05 00:18:50.379
false,false,296,284,12,534,00:00:33.000,2025-04-05 00:19:50.394
false,false,298,286,12,598,00:00:33.000,2025-04-05 00:20:50.418
false,false,299,287,12,631,00:00:33.000,2025-04-05 00:21:20.423
false,false,300,288,12,664,00:00:33.000,2025-04-05 00:21:50.437
false,false,301,289,12,694,00:00:30.000,2025-04-05 00:22:20.447
false,false,303,291,12,757,00:00:30.000,2025-04-05 00:23:20.469
false,false,304,292,12,788,00:00:31.000,2025-04-05 00:23:50.485
false,false,305,293,12,820,00:00:32.000,2025-04-05 00:24:20.488
false,false,302,290,12,727,00:00:33.000,2025-04-05 00:22:50.461
false,false,306,294,12,852,00:00:32.000,2025-04-05 00:24:50.499
false,false,309,297,12,950,00:00:33.000,2025-04-05 00:26:20.521
false,false,307,295,12,884,00:00:32.000,2025-04-05 00:25:20.501
false,false,308,296,12,917,00:00:33.000,2025-04-05 00:25:50.512
false,false,310,298,12,980,00:00:30.000,2025-04-05 00:26:50.536
false,false,311,299,12,1012,00:00:32.000,2025-04-05 00:27:20.544
false,false,312,300,12,1045,00:00:33.000,2025-04-05 00:27:50.551
false,false,313,301,12,1076,00:00:31.000,2025-04-05 00:28:20.554
false,false,315,303,12,1138,00:00:31.000,2025-04-05 00:29:20.568
false,false,314,302,12,1107,00:00:31.000,2025-04-05 00:28:50.559
false,false,317,305,12,1202,00:00:33.000,2025-04-05 00:30:20.588
false,false,316,304,12,1169,00:00:31.000,2025-04-05 00:29:50.574
false,false,318,306,12,1233,00:00:31.000,2025-04-05 00:30:50.597
false,false,321,309,12,1328,00:00:33.000,2025-04-05 00:32:20.627
false,false,319,307,12,1265,00:00:32.000,2025-04-05 00:31:20.609
false,false,320,308,12,1295,00:00:30.000,2025-04-05 00:31:50.624
false,false,322,310,12,1361,00:00:33.000,2025-04-05 00:32:50.630
false,false,323,311,12,1394,00:00:33.000,2025-04-05 00:33:20.635
false,false,325,313,12,1459,00:00:32.000,2025-04-05 00:34:20.655
false,false,326,314,12,1490,00:00:31.000,2025-04-05 00:34:50.667
false,false,324,312,12,1427,00:00:33.000,2025-04-05 00:33:50.649
false,false,328,316,12,1553,00:00:32.000,2025-04-05 00:35:50.685
false,false,327,315,12,1521,00:00:31.000,2025-04-05 00:35:20.672
false,false,329,317,12,1583,00:00:30.000,2025-04-05 00:36:20.700
false,false,331,319,12,1648,00:00:32.000,2025-04-05 00:37:20.721
false,false,333,321,12,1709,00:00:30.000,2025-04-05 00:38:20.744
false,false,332,320,12,1679,00:00:31.000,2025-04-05 00:37:50.732
false,false,330,318,12,1616,00:00:33.000,2025-04-05 00:36:50.715
false,false,334,322,12,1742,00:00:33.000,2025-04-05 00:38:50.753
false,false,335,323,12,1772,00:00:30.000,2025-04-05 00:39:20.755
false,false,337,325,12,1836,00:00:33.000,2025-04-05 00:40:20.770
false,false,336,324,12,1803,00:00:31.000,2025-04-05 00:39:50.759
false,false,341,329,12,1960,00:00:31.000,2025-04-05 00:42:20.818
false,false,338,326,12,1866,00:00:30.000,2025-04-05 00:40:50.786
false,false,339,327,12,1897,00:00:31.000,2025-04-05 00:41:20.801
false,false,340,328,12,1929,00:00:32.000,2025-04-05 00:41:50.816
false,false,345,332,13,2089,00:00:33.000,2025-04-05 00:44:20.853
false,false,343,330,13,2024,00:00:31.000,2025-04-05 00:43:20.836
false,false,342,329,13,1993,00:00:33.000,2025-04-05 00:42:50.823
false,false,347,334,13,2151,00:00:32.000,2025-04-05 00:45:20.869
false,true,347,334,13,0,00:00:00.000,2025-04-05 00:46:20.894
false,true,347,334,13,0,00:00:00.000,2025-04-05 00:45:50.879
false,false,344,331,13,2056,00:00:32.000,2025-04-05 00:43:50.843
false,false,346,333,13,2119,00:00:30.000,2025-04-05 00:44:50.862
false,true,347,334,13,0,00:00:00.000,2025-04-05 00:46:50.908
false,true,347,334,13,0,00:00:00.000,2025-04-05 00:47:20.911
false,false,348,335,13,31,00:00:31.000,2025-04-05 00:48:50.955
false,true,347,334,13,0,00:00:00.000,2025-04-05 00:47:50.925
false,false,350,337,13,93,00:00:31.000,2025-04-05 00:49:50.968
false,true,347,334,13,0,00:00:00.000,2025-04-05 00:48:20.941
false,false,349,336,13,62,00:00:31.000,2025-04-05 00:49:20.962
false,false,351,338,13,125,00:00:32.000,2025-04-05 00:50:20.980
false,false,354,341,13,220,00:00:31.000,2025-04-05 00:51:51.011
false,false,355,342,13,251,00:00:31.000,2025-04-05 00:52:21.020
false,false,352,339,13,156,00:00:31.000,2025-04-05 00:50:50.992
false,false,356,343,13,282,00:00:31.000,2025-04-05 00:52:51.025
false,false,357,344,13,314,00:00:32.000,2025-04-05 00:53:21.039
false,false,353,340,13,189,00:00:33.000,2025-04-05 00:51:21.001
false,false,359,345,14,377,00:00:33.000,2025-04-05 00:54:21.060
false,false,358,344,14,344,00:00:30.000,2025-04-05 00:53:51.045
false,false,360,346,14,410,00:00:33.000,2025-04-05 00:54:51.072
false,false,361,347,14,443,00:00:33.000,2025-04-05 00:55:21.084
false,false,362,348,14,475,00:00:32.000,2025-04-05 00:55:51.099
false,false,364,350,14,541,00:00:33.000,2025-04-05 00:56:51.125
false,false,363,349,14,508,00:00:33.000,2025-04-05 00:56:21.114
false,false,365,351,14,573,00:00:32.000,2025-04-05 00:57:21.137
false,false,366,351,15,605,00:00:32.000,2025-04-05 00:57:51.146
false,false,370,355,15,733,00:00:31.000,2025-04-05 00:59:51.188
false,false,369,354,15,702,00:00:33.000,2025-04-05 00:59:21.181
false,false,368,353,15,669,00:00:31.000,2025-04-05 00:58:51.176
false,false,367,352,15,638,00:00:33.000,2025-04-05 00:58:21.162
false,false,371,356,15,763,00:00:30.000,2025-04-05 01:00:21.201
false,false,374,359,15,854,00:00:31.000,2025-04-05 01:01:51.234
false,false,373,358,15,823,00:00:30.000,2025-04-05 01:01:21.219
false,false,372,357,15,793,00:00:30.000,2025-04-05 01:00:51.215
false,false,376,361,15,918,00:00:33.000,2025-04-05 01:02:51.250
false,false,375,360,15,885,00:00:31.000,2025-04-05 01:02:21.235
false,false,377,361,16,950,00:00:32.000,2025-04-05 01:03:21.254
false,true,377,361,16,0,00:00:00.000,2025-04-05 01:03:51.264
false,true,377,361,16,0,00:00:00.000,2025-04-05 01:04:21.277
false,true,377,361,16,0,00:00:00.000,2025-04-05 01:05:21.303
false,true,377,361,16,0,00:00:00.000,2025-04-05 01:04:51.292
false,true,377,361,16,0,00:00:00.000,2025-04-05 01:06:21.332
false,true,377,361,16,0,00:00:00.000,2025-04-05 01:05:51.316
false,false,378,362,16,31,00:00:31.000,2025-04-05 01:06:51.343
false,false,380,363,17,93,00:00:32.000,2025-04-05 01:07:51.355
false,false,379,363,16,61,00:00:30.000,2025-04-05 01:07:21.351
false,false,381,364,17,126,00:00:33.000,2025-04-05 01:08:21.365
false,false,382,365,17,157,00:00:31.000,2025-04-05 01:08:51.376
false,false,384,367,17,219,00:00:30.000,2025-04-05 01:09:51.403
false,false,385,368,17,250,00:00:31.000,2025-04-05 01:10:21.417
false,false,383,366,17,189,00:00:32.000,2025-04-05 01:09:21.392
false,false,386,369,17,283,00:00:33.000,2025-04-05 01:10:51.430
false,false,388,371,17,346,00:00:32.000,2025-04-05 01:11:51.444
false,false,389,372,17,378,00:00:32.000,2025-04-05 01:12:21.457
false,false,387,370,17,314,00:00:31.000,2025-04-05 01:11:21.438
false,false,391,372,19,441,00:00:31.000,2025-04-05 01:13:21.476
false,false,390,372,18,410,00:00:32.000,2025-04-05 01:12:51.465
false,false,393,374,19,503,00:00:31.000,2025-04-05 01:14:21.505
false,false,392,373,19,472,00:00:31.000,2025-04-05 01:13:51.491
false,false,394,375,19,534,00:00:31.000,2025-04-05 01:14:51.516
false,false,396,377,19,596,00:00:32.000,2025-04-05 01:15:51.536
false,false,397,378,19,628,00:00:32.000,2025-04-05 01:16:21.549
false,false,399,379,20,693,00:00:32.000,2025-04-05 01:17:21.572
false,false,400,380,20,723,00:00:30.000,2025-04-05 01:17:51.582
false,false,395,376,19,564,00:00:30.000,2025-04-05 01:15:21.522
false,false,398,379,19,661,00:00:33.000,2025-04-05 01:16:51.558
false,false,403,383,20,819,00:00:33.000,2025-04-05 01:19:21.618
false,false,402,382,20,786,00:00:30.000,2025-04-05 01:18:51.605
false,true,403,383,20,0,00:00:00.000,2025-04-05 01:20:51.652
false,true,403,383,20,0,00:00:00.000,2025-04-05 01:20:21.640
false,false,401,381,20,756,00:00:33.000,2025-04-05 01:18:21.590
false,true,403,383,20,0,00:00:00.000,2025-04-05 01:19:51.626
false,true,403,383,20,0,00:00:00.000,2025-04-05 01:21:21.656
false,true,403,383,20,0,00:00:00.000,2025-04-05 01:21:51.670
false,true,1132,1070,62,0,00:00:00.000,2025-04-05 09:51:02.770
false,false,1135,1073,62,98,00:00:32.000,2025-04-05 09:52:32.798
false,false,1134,1072,62,66,00:00:33.000,2025-04-05 09:52:02.787
false,true,1132,1070,62,0,00:00:00.000,2025-04-05 09:50:02.754
false,true,1132,1070,62,0,00:00:00.000,2025-04-05 09:50:32.761
false,false,1133,1071,62,33,00:00:33.000,2025-04-05 09:51:32.778
false,true,1135,1073,62,0,00:00:00.000,2025-04-05 09:53:02.813
false,true,1135,1073,62,0,00:00:00.000,2025-04-05 09:54:32.844
false,true,1135,1073,62,0,00:00:00.000,2025-04-05 09:53:32.815
false,true,1135,1073,62,0,00:00:00.000,2025-04-05 09:54:02.830
false,true,1135,1073,62,0,00:00:00.000,2025-04-05 09:55:02.853
false,true,1135,1073,62,0,00:00:00.000,2025-04-05 09:55:32.859
false,false,1136,1073,63,31,00:00:31.000,2025-04-05 09:56:02.859
false,false,1137,1074,63,62,00:00:31.000,2025-04-05 09:56:32.872
false,false,1138,1075,63,94,00:00:32.000,2025-04-05 09:57:02.885
false,false,1141,1077,64,188,00:00:30.000,2025-04-05 09:58:32.926
false,false,1140,1076,64,158,00:00:31.000,2025-04-05 09:58:02.913
false,false,1139,1076,63,127,00:00:33.000,2025-04-05 09:57:32.898
false,true,1141,1077,64,0,00:00:00.000,2025-04-05 09:59:32.947
false,true,1141,1077,64,0,00:00:00.000,2025-04-05 09:59:02.941
false,true,1141,1077,64,0,00:00:00.000,2025-04-05 10:00:32.966
false,true,1141,1077,64,0,00:00:00.000,2025-04-05 10:01:32.985
false,true,1141,1077,64,0,00:00:00.000,2025-04-05 10:01:02.976
false,false,1142,1078,64,30,00:00:30.000,2025-04-05 10:02:02.999
false,false,1143,1079,64,61,00:00:31.000,2025-04-05 10:02:33.012
false,false,1144,1080,64,94,00:00:33.000,2025-04-05 10:03:03.028
false,false,1147,1083,64,186,00:00:30.000,2025-04-05 10:04:33.064
false,false,1146,1082,64,156,00:00:32.000,2025-04-05 10:04:03.050
false,true,1141,1077,64,0,00:00:00.000,2025-04-05 10:00:02.955
false,false,1145,1081,64,124,00:00:30.000,2025-04-05 10:03:33.040
false,false,1148,1084,64,217,00:00:31.000,2025-04-05 10:05:03.069
false,false,1149,1085,64,249,00:00:32.000,2025-04-05 10:05:33.073
false,false,1152,1088,64,344,00:00:31.000,2025-04-05 10:07:03.098
false,false,1153,1089,64,376,00:00:32.000,2025-04-05 10:07:33.108
false,false,1150,1086,64,281,00:00:32.000,2025-04-05 10:06:03.078
false,false,1151,1087,64,313,00:00:32.000,2025-04-05 10:06:33.093
false,false,1154,1090,64,409,00:00:33.000,2025-04-05 10:08:03.118
false,false,1155,1090,65,442,00:00:33.000,2025-04-05 10:08:33.129
false,false,1157,1092,65,507,00:00:33.000,2025-04-05 10:09:33.157
false,false,1158,1093,65,537,00:00:30.000,2025-04-05 10:10:03.165
false,false,1156,1091,65,474,00:00:32.000,2025-04-05 10:09:03.143
false,false,1160,1095,65,598,00:00:31.000,2025-04-05 10:11:03.185
false,false,1159,1094,65,567,00:00:30.000,2025-04-05 10:10:33.173
false,false,1165,1100,65,754,00:00:30.000,2025-04-05 10:13:33.240
false,false,1161,1096,65,628,00:00:30.000,2025-04-05 10:11:33.197
false,false,1162,1097,65,659,00:00:31.000,2025-04-05 10:12:03.210
false,false,1164,1099,65,724,00:00:33.000,2025-04-05 10:13:03.234
false,false,1163,1098,65,691,00:00:32.000,2025-04-05 10:12:33.219
false,false,1166,1101,65,787,00:00:33.000,2025-04-05 10:14:03.255
false,false,1167,1102,65,818,00:00:31.000,2025-04-05 10:14:33.269
false,false,1170,1104,66,912,00:00:32.000,2025-04-05 10:16:03.301
false,false,1172,1105,67,975,00:00:32.000,2025-04-05 10:17:03.329
false,false,1171,1105,66,943,00:00:31.000,2025-04-05 10:16:33.315
false,false,1168,1102,66,850,00:00:32.000,2025-04-05 10:15:03.278
false,false,1169,1103,66,880,00:00:30.000,2025-04-05 10:15:33.292
false,false,1173,1106,67,1007,00:00:32.000,2025-04-05 10:17:33.344
false,false,1174,1107,67,1039,00:00:32.000,2025-04-05 10:18:03.356
false,false,1178,1111,67,1162,00:00:31.000,2025-04-05 10:20:03.408
false,false,1177,1110,67,1131,00:00:30.000,2025-04-05 10:19:33.396
false,false,1176,1109,67,1101,00:00:32.000,2025-04-05 10:19:03.381
false,false,1179,1112,67,1194,00:00:32.000,2025-04-05 10:20:33.421
false,false,1175,1108,67,1069,00:00:30.000,2025-04-05 10:18:33.366
false,false,1180,1113,67,1227,00:00:33.000,2025-04-05 10:21:03.435
false,false,1181,1114,67,1257,00:00:30.000,2025-04-05 10:21:33.440
false,false,1182,1115,67,1290,00:00:33.000,2025-04-05 10:22:03.448
false,false,1185,1118,67,1383,00:00:30.000,2025-04-05 10:23:33.482
false,false,1183,1116,67,1321,00:00:31.000,2025-04-05 10:22:33.463
false,false,1184,1117,67,1353,00:00:32.000,2025-04-05 10:23:03.477
false,false,1186,1119,67,1415,00:00:32.000,2025-04-05 10:24:03.488
false,false,1187,1120,67,1448,00:00:33.000,2025-04-05 10:24:33.497
false,false,1189,1122,67,1509,00:00:31.000,2025-04-05 10:25:33.509
false,false,1191,1124,67,1574,00:00:32.000,2025-04-05 10:26:33.536
false,false,1188,1121,67,1478,00:00:30.000,2025-04-05 10:25:03.505
false,false,1190,1123,67,1542,00:00:33.000,2025-04-05 10:26:03.521
false,false,1192,1124,68,1604,00:00:30.000,2025-04-05 10:27:03.547
false,false,1197,1129,68,1764,00:00:31.000,2025-04-05 10:29:33.603
false,false,1194,1126,68,1667,00:00:33.000,2025-04-05 10:28:03.569
false,false,1195,1127,68,1700,00:00:33.000,2025-04-05 10:28:33.581
false,false,1193,1125,68,1634,00:00:30.000,2025-04-05 10:27:33.558
false,false,1196,1128,68,1733,00:00:33.000,2025-04-05 10:29:03.595
false,false,1198,1130,68,1795,00:00:31.000,2025-04-05 10:30:03.611
false,false,1199,1131,68,1826,00:00:31.000,2025-04-05 10:30:33.620
false,false,1202,1134,68,1922,00:00:33.000,2025-04-05 10:32:03.653
false,false,1200,1132,68,1858,00:00:32.000,2025-04-05 10:31:03.631
false,false,1201,1133,68,1889,00:00:31.000,2025-04-05 10:31:33.642
false,false,1203,1135,68,1955,00:00:33.000,2025-04-05 10:32:33.663
false,false,1204,1136,68,1988,00:00:33.000,2025-04-05 10:33:03.672
false,true,1204,1136,68,0,00:00:00.000,2025-04-05 10:35:03.719
false,true,1204,1136,68,0,00:00:00.000,2025-04-05 10:33:33.687
false,true,1204,1136,68,0,00:00:00.000,2025-04-05 10:34:03.700
false,true,1204,1136,68,0,00:00:00.000,2025-04-05 10:34:33.711
false,true,1204,1136,68,0,00:00:00.000,2025-04-05 10:35:33.723
false,false,1208,1140,68,126,00:00:32.000,2025-04-05 10:38:03.784
false,false,1207,1139,68,94,00:00:32.000,2025-04-05 10:37:33.771
false,false,1205,1137,68,32,00:00:32.000,2025-04-05 10:36:33.748
false,false,1206,1138,68,62,00:00:30.000,2025-04-05 10:37:03.761
false,true,1204,1136,68,0,00:00:00.000,2025-04-05 10:36:03.737
false,false,1209,1141,68,156,00:00:30.000,2025-04-05 10:38:33.797
false,false,1211,1143,68,217,00:00:30.000,2025-04-05 10:39:33.824
false,false,1210,1142,68,187,00:00:31.000,2025-04-05 10:39:03.812
false,false,1213,1145,68,279,00:00:30.000,2025-04-05 10:40:33.847
false,false,1212,1144,68,249,00:00:32.000,2025-04-05 10:40:03.838
false,false,1215,1147,68,342,00:00:31.000,2025-04-05 10:41:33.872
false,false,1214,1146,68,311,00:00:32.000,2025-04-05 10:41:03.856
false,false,1219,1149,70,469,00:00:33.000,2025-04-05 10:43:33.918
false,false,1218,1148,70,436,00:00:31.000,2025-04-05 10:43:03.906
false,false,1217,1148,69,405,00:00:33.000,2025-04-05 10:42:33.894
false,false,1216,1147,69,372,00:00:30.000,2025-04-05 10:42:03.883
false,false,1220,1150,70,501,00:00:32.000,2025-04-05 10:44:03.930
false,false,1221,1151,70,534,00:00:33.000,2025-04-05 10:44:33.937
false,false,1222,1152,70,564,00:00:30.000,2025-04-05 10:45:03.950
false,false,1224,1153,71,628,00:00:31.000,2025-04-05 10:46:03.978
false,false,1223,1152,71,597,00:00:33.000,2025-04-05 10:45:33.964
false,false,1225,1154,71,660,00:00:32.000,2025-04-05 10:46:33.990
false,false,1226,1155,71,690,00:00:30.000,2025-04-05 10:47:03.996
false,true,1226,1155,71,0,00:00:00.000,2025-04-05 10:48:04.018
false,true,1226,1155,71,0,00:00:00.000,2025-04-05 10:48:34.031
false,true,1226,1155,71,0,00:00:00.000,2025-04-05 10:47:34.005
false,true,1226,1155,71,0,00:00:00.000,2025-04-05 10:49:34.052
false,true,1226,1155,71,0,00:00:00.000,2025-04-05 10:50:04.067
false,false,1227,1156,71,32,00:00:32.000,2025-04-05 10:50:34.073
false,false,1228,1157,71,62,00:00:30.000,2025-04-05 10:51:04.083
false,true,1226,1155,71,0,00:00:00.000,2025-04-05 10:49:04.041
false,false,1230,1159,71,127,00:00:33.000,2025-04-05 10:52:04.111
false,false,1231,1160,71,160,00:00:33.000,2025-04-05 10:52:34.126
false,false,1232,1161,71,191,00:00:31.000,2025-04-05 10:53:04.133
false,false,1229,1158,71,94,00:00:32.000,2025-04-05 10:51:34.097
false,false,1233,1162,71,221,00:00:30.000,2025-04-05 10:53:34.146
false,false,4805,4539,266,1327,00:00:33.000,2025-04-07 04:19:25.745
false,false,4807,4540,267,1389,00:00:31.000,2025-04-07 04:20:25.773
false,false,4804,4538,266,1294,00:00:31.000,2025-04-07 04:18:55.731
false,false,4803,4537,266,1263,00:00:33.000,2025-04-07 04:18:25.716
false,false,4802,4536,266,1230,00:00:32.000,2025-04-07 04:17:55.706
false,false,4808,4541,267,1420,00:00:31.000,2025-04-07 04:20:55.784
false,false,4809,4542,267,1452,00:00:32.000,2025-04-07 04:21:25.788
false,false,4810,4543,267,1483,00:00:31.000,2025-04-07 04:21:55.802
false,false,4806,4539,267,1358,00:00:31.000,2025-04-07 04:19:55.758
false,false,4811,4544,267,1513,00:00:30.000,2025-04-07 04:22:25.812
false,false,4812,4545,267,1545,00:00:32.000,2025-04-07 04:22:55.826
false,false,4814,4547,267,1608,00:00:30.000,2025-04-07 04:23:55.856
false,false,4816,4549,267,1670,00:00:31.000,2025-04-07 04:24:55.886
false,false,4813,4546,267,1578,00:00:33.000,2025-04-07 04:23:25.841
false,false,4817,4550,267,1703,00:00:33.000,2025-04-07 04:25:25.898
false,false,4819,4552,267,1766,00:00:30.000,2025-04-07 04:26:25.925
false,false,4818,4551,267,1736,00:00:33.000,2025-04-07 04:25:55.913
false,false,4815,4548,267,1639,00:00:31.000,2025-04-07 04:24:25.871
false,false,4820,4553,267,1797,00:00:31.000,2025-04-07 04:26:55.939
false,false,4823,4556,267,1895,00:00:32.000,2025-04-07 04:28:25.973
false,false,4821,4554,267,1830,00:00:33.000,2025-04-07 04:27:25.949
false,false,4825,4557,268,1958,00:00:31.000,2025-04-07 04:29:26.001
false,false,4822,4555,267,1863,00:00:33.000,2025-04-07 04:27:55.959
false,false,4824,4556,268,1927,00:00:32.000,2025-04-07 04:28:55.987
false,true,4828,4559,269,0,00:00:00.000,2025-04-07 04:32:26.065
false,true,4828,4559,269,0,00:00:00.000,2025-04-07 04:31:56.059
false,false,4827,4558,269,2022,00:00:32.000,2025-04-07 04:30:26.022
false,false,4828,4559,269,2053,00:00:31.000,2025-04-07 04:30:56.037
false,false,4826,4557,269,1990,00:00:32.000,2025-04-07 04:29:56.015
false,true,4828,4559,269,0,00:00:00.000,2025-04-07 04:31:26.052
false,false,4829,4560,269,32,00:00:32.000,2025-04-07 04:34:26.115
false,true,4828,4559,269,0,00:00:00.000,2025-04-07 04:32:56.074
false,false,4830,4561,269,64,00:00:32.000,2025-04-07 04:34:56.128
false,true,4828,4559,269,0,00:00:00.000,2025-04-07 04:33:26.088
false,true,4828,4559,269,0,00:00:00.000,2025-04-07 04:33:56.100
false,false,4832,4563,269,129,00:00:32.000,2025-04-07 04:35:56.158
false,false,4834,4565,269,193,00:00:32.000,2025-04-07 04:36:56.186
false,false,4833,4564,269,161,00:00:32.000,2025-04-07 04:36:26.171
false,false,4836,4567,269,256,00:00:33.000,2025-04-07 04:37:56.215
false,false,4837,4568,269,288,00:00:32.000,2025-04-07 04:38:26.227
false,false,4831,4562,269,97,00:00:33.000,2025-04-07 04:35:26.143
false,false,4835,4566,269,223,00:00:30.000,2025-04-07 04:37:26.200
false,true,4838,4569,269,0,00:00:00.000,2025-04-07 04:39:26.254
false,true,4838,4569,269,0,00:00:00.000,2025-04-07 04:40:26.283
false,true,4838,4569,269,0,00:00:00.000,2025-04-07 04:39:56.269
false,false,4838,4569,269,321,00:00:33.000,2025-04-07 04:38:56.239
false,true,4838,4569,269,0,00:00:00.000,2025-04-07 04:41:26.311
false,true,4838,4569,269,0,00:00:00.000,2025-04-07 04:41:56.321
false,false,4839,4569,270,32,00:00:32.000,2025-04-07 04:42:26.336
false,true,4838,4569,269,0,00:00:00.000,2025-04-07 04:40:56.299
false,false,4840,4570,270,65,00:00:33.000,2025-04-07 04:42:56.347
false,false,4841,4571,270,96,00:00:31.000,2025-04-07 04:43:26.361
false,false,4842,4572,270,127,00:00:31.000,2025-04-07 04:43:56.372
false,false,4844,4574,270,192,00:00:32.000,2025-04-07 04:44:56.400
false,false,4845,4575,270,222,00:00:30.000,2025-04-07 04:45:26.410
false,false,4843,4573,270,160,00:00:33.000,2025-04-07 04:44:26.386
false,false,4847,4577,270,284,00:00:32.000,2025-04-07 04:46:26.436
false,false,4849,4579,270,346,00:00:31.000,2025-04-07 04:47:26.464
false,false,4848,4578,270,315,00:00:31.000,2025-04-07 04:46:56.450
false,true,4850,4580,270,0,00:00:00.000,2025-04-07 04:48:26.490
false,false,4846,4576,270,252,00:00:30.000,2025-04-07 04:45:56.422
false,false,4850,4580,270,378,00:00:32.000,2025-04-07 04:47:56.479
false,true,4850,4580,270,0,00:00:00.000,2025-04-07 04:50:26.544
false,false,4851,4581,270,30,00:00:30.000,2025-04-07 04:51:26.570
false,true,4850,4580,270,0,00:00:00.000,2025-04-07 04:50:56.555
false,true,4850,4580,270,0,00:00:00.000,2025-04-07 04:49:26.520
false,true,4850,4580,270,0,00:00:00.000,2025-04-07 04:49:56.531
false,false,4852,4582,270,61,00:00:31.000,2025-04-07 04:51:56.583
false,true,4850,4580,270,0,00:00:00.000,2025-04-07 04:48:56.505
false,false,4855,4585,270,155,00:00:30.000,2025-04-07 04:53:26.625
false,false,4854,4584,270,125,00:00:33.000,2025-04-07 04:52:56.610
false,false,4853,4583,270,92,00:00:31.000,2025-04-07 04:52:26.598
false,false,4857,4587,270,220,00:00:33.000,2025-04-07 04:54:26.649
false,false,4858,4587,271,253,00:00:33.000,2025-04-07 04:54:56.663
false,false,4859,4588,271,284,00:00:31.000,2025-04-07 04:55:26.675
false,false,4856,4586,270,187,00:00:32.000,2025-04-07 04:53:56.639
false,false,4861,4590,271,347,00:00:31.000,2025-04-07 04:56:26.702
false,false,4860,4589,271,316,00:00:32.000,2025-04-07 04:55:56.687
false,false,4862,4591,271,378,00:00:31.000,2025-04-07 04:56:56.714
false,false,4865,4594,271,473,00:00:32.000,2025-04-07 04:58:26.748
false,false,4864,4593,271,441,00:00:31.000,2025-04-07 04:57:56.735
false,false,4863,4592,271,410,00:00:32.000,2025-04-07 04:57:26.722
false,false,4866,4595,271,504,00:00:31.000,2025-04-07 04:58:56.758
false,false,4867,4596,271,537,00:00:33.000,2025-04-07 04:59:26.769
false,false,4868,4597,271,570,00:00:33.000,2025-04-07 04:59:56.782
false,false,4870,4599,271,633,00:00:32.000,2025-04-07 05:00:56.804
false,false,4872,4601,271,698,00:00:32.000,2025-04-07 05:01:56.827
false,false,4869,4598,271,601,00:00:31.000,2025-04-07 05:00:26.790
false,false,4873,4602,271,730,00:00:32.000,2025-04-07 05:02:26.840
false,false,4871,4600,271,666,00:00:33.000,2025-04-07 05:01:26.815
false,false,4874,4603,271,761,00:00:31.000,2025-04-07 05:02:56.848
false,false,4877,4605,272,852,00:00:30.000,2025-04-07 05:04:26.880
false,false,4875,4604,271,792,00:00:31.000,2025-04-07 05:03:26.862
false,false,4876,4605,271,822,00:00:30.000,2025-04-07 05:03:56.871
false,false,4878,4606,272,882,00:00:30.000,2025-04-07 05:04:56.895
false,false,4879,4607,272,912,00:00:30.000,2025-04-07 05:05:26.909
false,false,4881,4609,272,977,00:00:33.000,2025-04-07 05:06:26.937
false,false,4883,4611,272,1037,00:00:30.000,2025-04-07 05:07:26.962
false,false,4880,4608,272,944,00:00:32.000,2025-04-07 05:05:56.923
false,false,4882,4610,272,1007,00:00:30.000,2025-04-07 05:06:56.950
false,true,4885,4613,272,0,00:00:00.000,2025-04-07 05:08:57.004
false,false,4884,4612,272,1067,00:00:30.000,2025-04-07 05:07:56.974
false,false,4885,4613,272,1098,00:00:31.000,2025-04-07 05:08:26.989
false,true,4885,4613,272,0,00:00:00.000,2025-04-07 05:09:27.018
false,true,4885,4613,272,0,00:00:00.000,2025-04-07 05:09:57.033
false,true,4885,4613,272,0,00:00:00.000,2025-04-07 05:11:27.072
false,true,4885,4613,272,0,00:00:00.000,2025-04-07 05:11:57.085
false,true,4885,4613,272,0,00:00:00.000,2025-04-07 05:10:27.047
false,true,4885,4613,272,0,00:00:00.000,2025-04-07 05:10:57.061
false,true,4885,4613,272,0,00:00:00.000,2025-04-07 05:12:27.099
false,true,4885,4613,272,0,00:00:00.000,2025-04-07 05:14:27.156
false,false,4886,4614,272,33,00:00:33.000,2025-04-07 05:14:57.162
false,true,4885,4613,272,0,00:00:00.000,2025-04-07 05:13:57.142
false,true,4885,4613,272,0,00:00:00.000,2025-04-07 05:12:57.113
false,true,4885,4613,272,0,00:00:00.000,2025-04-07 05:13:27.127
false,false,4888,4616,272,96,00:00:31.000,2025-04-07 05:15:57.186
false,false,4889,4616,273,126,00:00:30.000,2025-04-07 05:16:27.196
false,false,4890,4617,273,158,00:00:32.000,2025-04-07 05:16:57.206
false,false,4891,4618,273,191,00:00:33.000,2025-04-07 05:17:27.221
false,false,4887,4615,272,65,00:00:32.000,2025-04-07 05:15:27.176
false,false,4705,4442,263,253,00:00:31.000,2025-04-07 03:14:24.781
false,false,4706,4443,263,286,00:00:33.000,2025-04-07 03:14:54.783
false,false,4703,4440,263,190,00:00:32.000,2025-04-07 03:13:24.778
false,false,4704,4441,263,222,00:00:32.000,2025-04-07 03:13:54.779
false,false,4708,4445,263,351,00:00:32.000,2025-04-07 03:15:54.785
false,false,4707,4444,263,319,00:00:33.000,2025-04-07 03:15:24.784
false,false,4710,4447,263,415,00:00:32.000,2025-04-07 03:16:54.788
false,false,4712,4449,263,480,00:00:32.000,2025-04-07 03:17:54.790
false,false,4713,4450,263,511,00:00:31.000,2025-04-07 03:18:24.791
false,false,4711,4448,263,448,00:00:33.000,2025-04-07 03:17:24.789
false,false,4709,4446,263,383,00:00:32.000,2025-04-07 03:16:24.786
false,false,4714,4451,263,541,00:00:30.000,2025-04-07 03:18:54.793
false,false,4715,4452,263,572,00:00:31.000,2025-04-07 03:19:24.793
false,true,4715,4452,263,0,00:00:00.000,2025-04-07 03:19:54.795
false,true,4715,4452,263,0,00:00:00.000,2025-04-07 03:21:24.798
false,true,4715,4452,263,0,00:00:00.000,2025-04-07 03:20:54.797
false,true,4715,4452,263,0,00:00:00.000,2025-04-07 03:20:24.795
false,false,4716,4453,263,32,00:00:32.000,2025-04-07 03:22:54.801
false,true,4715,4452,263,0,00:00:00.000,2025-04-07 03:22:24.800
false,false,4718,4455,263,95,00:00:31.000,2025-04-07 03:23:54.805
false,false,4719,4456,263,127,00:00:32.000,2025-04-07 03:24:24.807
false,true,4715,4452,263,0,00:00:00.000,2025-04-07 03:21:54.798
false,false,4717,4454,263,64,00:00:32.000,2025-04-07 03:23:24.803
false,false,4720,4457,263,160,00:00:33.000,2025-04-07 03:24:54.808
false,false,4721,4458,263,190,00:00:30.000,2025-04-07 03:25:24.809
false,false,4724,4461,263,289,00:00:33.000,2025-04-07 03:26:54.813
false,false,4723,4460,263,256,00:00:33.000,2025-04-07 03:26:24.812
false,false,4725,4461,264,319,00:00:30.000,2025-04-07 03:27:24.814
false,false,4722,4459,263,223,00:00:33.000,2025-04-07 03:25:54.810
false,false,4727,4463,264,384,00:00:32.000,2025-04-07 03:28:24.817
false,false,4730,4466,264,476,00:00:30.000,2025-04-07 03:29:54.819
false,false,4729,4465,264,446,00:00:30.000,2025-04-07 03:29:24.819
false,false,4728,4464,264,416,00:00:32.000,2025-04-07 03:28:54.818
false,false,4726,4462,264,352,00:00:33.000,2025-04-07 03:27:54.815
false,false,4731,4467,264,506,00:00:30.000,2025-04-07 03:30:24.819
false,false,4736,4472,264,665,00:00:30.000,2025-04-07 03:32:54.824
false,false,4737,4473,264,698,00:00:33.000,2025-04-07 03:33:24.825
false,false,4735,4471,264,635,00:00:32.000,2025-04-07 03:32:24.823
false,false,4732,4468,264,539,00:00:33.000,2025-04-07 03:30:54.820
false,false,4734,4470,264,603,00:00:31.000,2025-04-07 03:31:54.822
false,false,4738,4474,264,729,00:00:31.000,2025-04-07 03:33:54.826
false,false,4733,4469,264,572,00:00:33.000,2025-04-07 03:31:24.821
false,false,4741,4477,264,822,00:00:30.000,2025-04-07 03:35:24.828
false,false,4740,4476,264,792,00:00:30.000,2025-04-07 03:34:54.828
false,false,4742,4478,264,854,00:00:32.000,2025-04-07 03:35:54.829
false,false,4739,4475,264,762,00:00:33.000,2025-04-07 03:34:24.827
false,false,4743,4479,264,886,00:00:32.000,2025-04-07 03:36:24.829
false,false,4745,4481,264,947,00:00:31.000,2025-04-07 03:37:24.831
false,false,4744,4480,264,916,00:00:30.000,2025-04-07 03:36:54.829
false,false,4747,4483,264,1009,00:00:32.000,2025-04-07 03:38:24.831
false,false,4746,4482,264,977,00:00:30.000,2025-04-07 03:37:54.830
false,true,4747,4483,264,0,00:00:00.000,2025-04-07 03:39:24.832
false,true,4747,4483,264,0,00:00:00.000,2025-04-07 03:39:54.833
false,true,4747,4483,264,0,00:00:00.000,2025-04-07 03:40:24.833
false,true,4747,4483,264,0,00:00:00.000,2025-04-07 03:38:54.831
false,true,4747,4483,264,0,00:00:00.000,2025-04-07 03:40:54.833
false,true,4747,4483,264,0,00:00:00.000,2025-04-07 03:41:24.833
false,false,4748,4484,264,31,00:00:31.000,2025-04-07 03:41:54.834
false,false,4749,4485,264,64,00:00:33.000,2025-04-07 03:42:24.834
false,false,4751,4487,264,127,00:00:30.000,2025-04-07 03:43:24.841
false,false,4752,4488,264,160,00:00:33.000,2025-04-07 03:43:54.848
false,false,4750,4486,264,97,00:00:33.000,2025-04-07 03:42:54.834
false,false,4753,4489,264,190,00:00:30.000,2025-04-07 03:44:24.862
false,false,4755,4491,264,256,00:00:33.000,2025-04-07 03:45:24.883
false,false,4754,4490,264,223,00:00:33.000,2025-04-07 03:44:54.871
false,false,4756,4492,264,287,00:00:31.000,2025-04-07 03:45:54.895
false,false,4758,4494,264,347,00:00:30.000,2025-04-07 03:46:54.925
false,true,4758,4494,264,0,00:00:00.000,2025-04-07 03:47:24.937
false,true,4758,4494,264,0,00:00:00.000,2025-04-07 03:47:54.947
false,true,4758,4494,264,0,00:00:00.000,2025-04-07 03:48:54.969
false,true,4758,4494,264,0,00:00:00.000,2025-04-07 03:48:24.958
false,true,4758,4494,264,0,00:00:00.000,2025-04-07 03:49:54.996
false,false,4757,4493,264,317,00:00:30.000,2025-04-07 03:46:24.910
false,true,4758,4494,264,0,00:00:00.000,2025-04-07 03:49:24.983
false,true,4758,4494,264,0,00:00:00.000,2025-04-07 03:51:25.035
false,true,4758,4494,264,0,00:00:00.000,2025-04-07 03:50:25.010
false,true,4758,4494,264,0,00:00:00.000,2025-04-07 03:50:55.022
false,true,4758,4494,264,0,00:00:00.000,2025-04-07 03:52:55.064
false,false,4759,4495,264,32,00:00:32.000,2025-04-07 03:53:25.079
false,true,4758,4494,264,0,00:00:00.000,2025-04-07 03:52:25.050
false,false,4760,4496,264,65,00:00:33.000,2025-04-07 03:53:55.092
false,true,4758,4494,264,0,00:00:00.000,2025-04-07 03:51:55.044
false,false,4762,4498,264,127,00:00:32.000,2025-04-07 03:54:55.115
false,false,4763,4499,264,159,00:00:32.000,2025-04-07 03:55:25.128
false,true,4763,4499,264,0,00:00:00.000,2025-04-07 03:55:55.139
false,true,4763,4499,264,0,00:00:00.000,2025-04-07 03:56:55.162
false,true,4763,4499,264,0,00:00:00.000,2025-04-07 03:56:25.148
false,false,4761,4497,264,95,00:00:30.000,2025-04-07 03:54:25.106
false,true,4763,4499,264,0,00:00:00.000,2025-04-07 03:57:25.176
false,true,4763,4499,264,0,00:00:00.000,2025-04-07 03:57:55.189
false,false,4765,4501,264,65,00:00:32.000,2025-04-07 03:59:25.226
false,false,4766,4502,264,95,00:00:30.000,2025-04-07 03:59:55.240
false,false,4764,4500,264,33,00:00:33.000,2025-04-07 03:58:55.214
false,true,4763,4499,264,0,00:00:00.000,2025-04-07 03:58:25.202
false,false,4767,4503,264,128,00:00:33.000,2025-04-07 04:00:25.255
false,false,4768,4504,264,161,00:00:33.000,2025-04-07 04:00:55.269
false,false,4771,4507,264,255,00:00:31.000,2025-04-07 04:02:25.304
false,false,4770,4506,264,224,00:00:31.000,2025-04-07 04:01:55.295
false,false,4773,4509,264,318,00:00:32.000,2025-04-07 04:03:25.326
false,false,4774,4510,264,350,00:00:32.000,2025-04-07 04:03:55.340
false,false,4772,4508,264,286,00:00:31.000,2025-04-07 04:02:55.312
false,false,4769,4505,264,193,00:00:32.000,2025-04-07 04:01:25.284
false,false,4776,4511,265,414,00:00:32.000,2025-04-07 04:04:55.365
false,false,4775,4511,264,382,00:00:32.000,2025-04-07 04:04:25.350
false,false,4777,4512,265,446,00:00:32.000,2025-04-07 04:05:25.375
false,false,4779,4514,265,509,00:00:30.000,2025-04-07 04:06:25.401
false,false,4778,4513,265,479,00:00:33.000,2025-04-07 04:05:55.390
false,false,4780,4515,265,541,00:00:32.000,2025-04-07 04:06:55.417
false,false,4782,4516,266,603,00:00:32.000,2025-04-07 04:07:55.445
false,false,4783,4517,266,633,00:00:30.000,2025-04-07 04:08:25.457
false,false,4781,4516,265,571,00:00:30.000,2025-04-07 04:07:25.432
false,false,4785,4519,266,696,00:00:31.000,2025-04-07 04:09:25.487
false,false,4784,4518,266,665,00:00:32.000,2025-04-07 04:08:55.472
false,false,4788,4522,266,791,00:00:32.000,2025-04-07 04:10:55.528
false,false,4789,4523,266,821,00:00:30.000,2025-04-07 04:11:25.542
false,false,4790,4524,266,852,00:00:31.000,2025-04-07 04:11:55.555
false,false,4791,4525,266,884,00:00:32.000,2025-04-07 04:12:25.569
false,false,4787,4521,266,759,00:00:32.000,2025-04-07 04:10:25.515
false,false,4793,4527,266,946,00:00:31.000,2025-04-07 04:13:25.596
false,false,4794,4528,266,979,00:00:33.000,2025-04-07 04:13:55.609
false,false,4786,4520,266,727,00:00:31.000,2025-04-07 04:09:55.502
false,false,4795,4529,266,1009,00:00:30.000,2025-04-07 04:14:25.621
false,false,4796,4530,266,1040,00:00:31.000,2025-04-07 04:14:55.636
false,false,4798,4532,266,1103,00:00:31.000,2025-04-07 04:15:55.660
false,false,4797,4531,266,1072,00:00:32.000,2025-04-07 04:15:25.650
false,false,4800,4534,266,1166,00:00:32.000,2025-04-07 04:16:55.682
false,false,4801,4535,266,1198,00:00:32.000,2025-04-07 04:17:25.694
false,false,4799,4533,266,1134,00:00:31.000,2025-04-07 04:16:25.671
false,false,4792,4526,266,915,00:00:31.000,2025-04-07 04:12:55.581
false,true,3283,3096,187,0,00:00:00.000,2025-04-06 10:16:06.652
false,true,3283,3096,187,0,00:00:00.000,2025-04-06 10:16:36.664
false,true,3283,3096,187,0,00:00:00.000,2025-04-06 10:15:36.639
false,false,3283,3096,187,157,00:00:33.000,2025-04-06 10:14:06.598
false,true,3283,3096,187,0,00:00:00.000,2025-04-06 10:15:06.626
false,true,3283,3096,187,0,00:00:00.000,2025-04-06 10:14:36.612
false,true,3283,3096,187,0,00:00:00.000,2025-04-06 10:17:06.677
false,false,3284,3097,187,33,00:00:33.000,2025-04-06 10:17:36.692
false,false,3285,3098,187,64,00:00:31.000,2025-04-06 10:18:06.703
false,false,3288,3101,187,159,00:00:33.000,2025-04-06 10:19:36.743
false,false,3286,3099,187,95,00:00:31.000,2025-04-06 10:18:36.716
false,false,3287,3100,187,126,00:00:31.000,2025-04-06 10:19:06.729
false,false,3291,3104,187,256,00:00:33.000,2025-04-06 10:21:06.785
false,false,3290,3103,187,223,00:00:31.000,2025-04-06 10:20:36.772
false,false,3293,3106,187,320,00:00:32.000,2025-04-06 10:22:06.805
false,false,3292,3105,187,288,00:00:32.000,2025-04-06 10:21:36.794
false,false,3289,3102,187,192,00:00:33.000,2025-04-06 10:20:06.758
false,false,3294,3107,187,352,00:00:32.000,2025-04-06 10:22:36.818
false,false,3295,3108,187,385,00:00:33.000,2025-04-06 10:23:06.829
false,false,3296,3109,187,418,00:00:33.000,2025-04-06 10:23:36.840
false,false,3298,3110,188,480,00:00:30.000,2025-04-06 10:24:36.866
false,true,3298,3110,188,0,00:00:00.000,2025-04-06 10:25:06.880
false,true,3298,3110,188,0,00:00:00.000,2025-04-06 10:25:36.893
false,false,3297,3110,187,450,00:00:32.000,2025-04-06 10:24:06.853
false,true,3298,3110,188,0,00:00:00.000,2025-04-06 10:26:06.903
false,true,3298,3110,188,0,00:00:00.000,2025-04-06 10:27:36.942
false,false,3299,3111,188,30,00:00:30.000,2025-04-06 10:28:06.951
false,false,3301,3113,188,94,00:00:31.000,2025-04-06 10:29:06.976
false,true,3298,3110,188,0,00:00:00.000,2025-04-06 10:27:06.928
false,false,3300,3112,188,63,00:00:33.000,2025-04-06 10:28:36.962
false,true,3298,3110,188,0,00:00:00.000,2025-04-06 10:26:36.916
false,false,3302,3114,188,124,00:00:30.000,2025-04-06 10:29:36.989
false,false,3303,3115,188,155,00:00:31.000,2025-04-06 10:30:07.003
false,false,3306,3116,190,250,00:00:32.000,2025-04-06 10:31:37.045
false,false,3305,3116,189,218,00:00:33.000,2025-04-06 10:31:07.030
false,false,3304,3116,188,185,00:00:30.000,2025-04-06 10:30:37.017
false,false,3307,3117,190,282,00:00:32.000,2025-04-06 10:32:07.056
false,false,3308,3118,190,315,00:00:33.000,2025-04-06 10:32:37.067
false,false,3309,3119,190,345,00:00:30.000,2025-04-06 10:33:07.076
false,false,3311,3121,190,408,00:00:33.000,2025-04-06 10:34:07.098
false,false,3310,3120,190,375,00:00:30.000,2025-04-06 10:33:37.086
false,false,3312,3122,190,439,00:00:31.000,2025-04-06 10:34:37.112
false,false,3315,3125,190,531,00:00:30.000,2025-04-06 10:36:07.151
false,false,3314,3124,190,501,00:00:31.000,2025-04-06 10:35:37.136
false,false,3318,3128,190,628,00:00:33.000,2025-04-06 10:37:37.181
false,false,3313,3123,190,470,00:00:31.000,2025-04-06 10:35:07.126
false,false,3316,3126,190,563,00:00:32.000,2025-04-06 10:36:37.161
false,false,3317,3127,190,595,00:00:32.000,2025-04-06 10:37:07.166
false,false,3319,3129,190,661,00:00:33.000,2025-04-06 10:38:07.193
false,false,3320,3130,190,691,00:00:30.000,2025-04-06 10:38:37.206
false,false,3321,3131,190,723,00:00:32.000,2025-04-06 10:39:07.220
false,false,3325,3135,190,844,00:00:30.000,2025-04-06 10:41:07.280
false,false,3322,3132,190,753,00:00:30.000,2025-04-06 10:39:37.235
false,false,3324,3134,190,814,00:00:30.000,2025-04-06 10:40:37.265
false,false,3323,3133,190,784,00:00:31.000,2025-04-06 10:40:07.250
false,false,3326,3136,190,876,00:00:32.000,2025-04-06 10:41:37.286
false,false,3327,3137,190,906,00:00:30.000,2025-04-06 10:42:07.299
false,false,3331,3140,191,1029,00:00:30.000,2025-04-06 10:44:07.336
false,false,3330,3139,191,999,00:00:31.000,2025-04-06 10:43:37.323
false,false,3332,3141,191,1059,00:00:30.000,2025-04-06 10:44:37.351
false,false,3329,3138,191,968,00:00:31.000,2025-04-06 10:43:07.315
false,false,3328,3138,190,937,00:00:31.000,2025-04-06 10:42:37.311
false,false,3334,3143,191,1122,00:00:31.000,2025-04-06 10:45:37.372
false,false,3333,3142,191,1091,00:00:32.000,2025-04-06 10:45:07.363
false,false,3337,3146,191,1216,00:00:30.000,2025-04-06 10:47:07.410
false,false,3335,3144,191,1154,00:00:32.000,2025-04-06 10:46:07.385
false,false,3338,3147,191,1247,00:00:31.000,2025-04-06 10:47:37.423
false,false,3339,3148,191,1279,00:00:32.000,2025-04-06 10:48:07.436
false,false,3336,3145,191,1186,00:00:32.000,2025-04-06 10:46:37.396
false,false,3341,3150,191,1341,00:00:31.000,2025-04-06 10:49:07.455
false,false,3342,3151,191,1372,00:00:31.000,2025-04-06 10:49:37.467
false,false,3340,3149,191,1310,00:00:31.000,2025-04-06 10:48:37.448
false,false,3345,3154,191,1467,00:00:31.000,2025-04-06 10:51:07.498
false,false,3344,3153,191,1436,00:00:33.000,2025-04-06 10:50:37.490
false,false,3343,3152,191,1403,00:00:31.000,2025-04-06 10:50:07.481
false,false,3346,3155,191,1500,00:00:33.000,2025-04-06 10:51:37.509
false,false,3348,3157,191,1561,00:00:31.000,2025-04-06 10:52:37.528
false,false,3350,3158,192,1625,00:00:31.000,2025-04-06 10:53:37.550
false,false,3347,3156,191,1530,00:00:30.000,2025-04-06 10:52:07.516
false,false,3349,3157,192,1594,00:00:33.000,2025-04-06 10:53:07.536
false,false,3352,3160,192,1686,00:00:30.000,2025-04-06 10:54:37.574
false,false,3351,3159,192,1656,00:00:31.000,2025-04-06 10:54:07.563
false,false,3353,3161,192,1718,00:00:32.000,2025-04-06 10:55:07.587
false,true,3353,3161,192,0,00:00:00.000,2025-04-06 10:56:07.606
false,true,3353,3161,192,0,00:00:00.000,2025-04-06 10:56:37.616
false,true,3353,3161,192,0,00:00:00.000,2025-04-06 10:58:07.652
false,true,3353,3161,192,0,00:00:00.000,2025-04-06 10:55:37.599
false,true,3353,3161,192,0,00:00:00.000,2025-04-06 10:58:37.662
false,true,3353,3161,192,0,00:00:00.000,2025-04-06 10:57:37.637
false,true,3353,3161,192,0,00:00:00.000,2025-04-06 10:57:07.630
false,true,3353,3161,192,0,00:00:00.000,2025-04-06 10:59:07.668
false,true,3353,3161,192,0,00:00:00.000,2025-04-06 10:59:37.682
false,true,3353,3161,192,0,00:00:00.000,2025-04-06 11:00:37.700
false,true,3353,3161,192,0,00:00:00.000,2025-04-06 11:01:07.715
false,true,3353,3161,192,0,00:00:00.000,2025-04-06 11:00:07.694
false,false,3354,3162,192,32,00:00:32.000,2025-04-06 11:01:37.729
false,false,3355,3163,192,64,00:00:32.000,2025-04-06 11:02:07.737
false,false,3359,3167,192,190,00:00:30.000,2025-04-06 11:04:07.786
false,false,3356,3164,192,97,00:00:33.000,2025-04-06 11:02:37.751
false,false,3358,3166,192,160,00:00:30.000,2025-04-06 11:03:37.775
false,false,3360,3168,192,222,00:00:32.000,2025-04-06 11:04:37.798
false,false,3361,3169,192,252,00:00:30.000,2025-04-06 11:05:07.812
false,false,3357,3165,192,130,00:00:33.000,2025-04-06 11:03:07.764
false,false,3362,3170,192,284,00:00:32.000,2025-04-06 11:05:37.821
false,false,3364,3172,192,348,00:00:33.000,2025-04-06 11:06:37.840
false,false,3363,3171,192,315,00:00:31.000,2025-04-06 11:06:07.830
false,false,3365,3173,192,379,00:00:31.000,2025-04-06 11:07:07.853
false,false,3367,3175,192,442,00:00:32.000,2025-04-06 11:08:07.872
false,false,3366,3174,192,410,00:00:31.000,2025-04-06 11:07:37.861
false,false,3368,3176,192,474,00:00:32.000,2025-04-06 11:08:37.885
false,false,3370,3178,192,539,00:00:33.000,2025-04-06 11:09:37.908
false,false,3373,3180,193,633,00:00:31.000,2025-04-06 11:11:07.940
false,false,3369,3177,192,506,00:00:32.000,2025-04-06 11:09:07.895
false,false,3371,3178,193,569,00:00:30.000,2025-04-06 11:10:07.919
false,false,3372,3179,193,602,00:00:33.000,2025-04-06 11:10:37.929
false,false,3375,3182,193,694,00:00:31.000,2025-04-06 11:12:07.963
false,false,3378,3185,193,790,00:00:33.000,2025-04-06 11:13:37.998
false,false,3377,3184,193,757,00:00:32.000,2025-04-06 11:13:07.986
false,false,3376,3183,193,725,00:00:31.000,2025-04-06 11:12:37.976
false,false,3374,3181,193,663,00:00:30.000,2025-04-06 11:11:37.953
false,false,3379,3186,193,820,00:00:30.000,2025-04-06 11:14:08.011
false,false,3380,3187,193,853,00:00:33.000,2025-04-06 11:14:38.026
false,false,3383,3190,193,945,00:00:31.000,2025-04-06 11:16:08.057
false,true,3383,3190,193,0,00:00:00.000,2025-04-06 11:16:38.070
false,false,3381,3188,193,884,00:00:31.000,2025-04-06 11:15:08.037
false,false,3382,3189,193,914,00:00:30.000,2025-04-06 11:15:38.048
false,true,3383,3190,193,0,00:00:00.000,2025-04-06 11:17:08.081
false,false,1793,1693,100,126,00:00:30.000,2025-04-05 17:21:42.957
false,false,1796,1696,100,222,00:00:30.000,2025-04-05 17:23:12.990
false,false,1795,1695,100,192,00:00:33.000,2025-04-05 17:22:42.979
false,false,1794,1694,100,159,00:00:33.000,2025-04-05 17:22:12.971
false,false,1798,1698,100,283,00:00:31.000,2025-04-05 17:24:13.012
false,false,1797,1697,100,252,00:00:30.000,2025-04-05 17:23:42.998
false,false,1799,1699,100,314,00:00:31.000,2025-04-05 17:24:43.026
false,false,1802,1702,100,407,00:00:31.000,2025-04-05 17:26:13.056
false,false,1801,1701,100,376,00:00:30.000,2025-04-05 17:25:43.051
false,false,1800,1700,100,346,00:00:32.000,2025-04-05 17:25:13.037
false,false,1803,1703,100,440,00:00:33.000,2025-04-05 17:26:43.065
false,false,1804,1704,100,470,00:00:30.000,2025-04-05 17:27:13.077
false,false,1805,1705,100,500,00:00:30.000,2025-04-05 17:27:43.092
false,true,1805,1705,100,0,00:00:00.000,2025-04-05 17:28:13.099
false,true,1805,1705,100,0,00:00:00.000,2025-04-05 17:28:43.113
false,true,1805,1705,100,0,00:00:00.000,2025-04-05 17:29:43.138
false,true,1805,1705,100,0,00:00:00.000,2025-04-05 17:29:13.126
false,true,1805,1705,100,0,00:00:00.000,2025-04-05 17:30:13.144
false,true,1805,1705,100,0,00:00:00.000,2025-04-05 17:30:43.146
false,false,1808,1708,100,91,00:00:31.000,2025-04-05 17:32:13.185
false,false,1807,1707,100,60,00:00:30.000,2025-04-05 17:31:43.170
false,true,1808,1708,100,0,00:00:00.000,2025-04-05 17:33:43.197
false,true,1808,1708,100,0,00:00:00.000,2025-04-05 17:33:13.191
false,true,1808,1708,100,0,00:00:00.000,2025-04-05 17:32:43.190
false,false,1806,1706,100,30,00:00:30.000,2025-04-05 17:31:13.155
false,true,1808,1708,100,0,00:00:00.000,2025-04-05 17:34:13.212
false,false,1809,1709,100,33,00:00:33.000,2025-04-05 17:35:43.248
false,true,1808,1708,100,0,00:00:00.000,2025-04-05 17:35:13.235
false,true,1808,1708,100,0,00:00:00.000,2025-04-05 17:34:43.221
false,false,1810,1710,100,63,00:00:30.000,2025-04-05 17:36:13.264
false,false,1811,1710,101,93,00:00:30.000,2025-04-05 17:36:43.277
false,false,1812,1711,101,124,00:00:31.000,2025-04-05 17:37:13.282
false,false,1814,1713,101,188,00:00:31.000,2025-04-05 17:38:13.306
false,false,1815,1714,101,219,00:00:31.000,2025-04-05 17:38:43.313
false,false,1813,1712,101,157,00:00:33.000,2025-04-05 17:37:43.294
false,false,1816,1715,101,251,00:00:32.000,2025-04-05 17:39:13.320
false,true,1818,1717,101,0,00:00:00.000,2025-04-05 17:40:43.346
false,true,1818,1717,101,0,00:00:00.000,2025-04-05 17:41:43.367
false,false,1818,1717,101,317,00:00:33.000,2025-04-05 17:40:13.339
false,false,1817,1716,101,284,00:00:33.000,2025-04-05 17:39:43.334
false,true,1818,1717,101,0,00:00:00.000,2025-04-05 17:42:13.379
false,true,1818,1717,101,0,00:00:00.000,2025-04-05 17:41:13.356
false,true,1818,1717,101,0,00:00:00.000,2025-04-05 17:42:43.384
false,true,1818,1717,101,0,00:00:00.000,2025-04-05 17:43:13.395
false,false,1819,1718,101,31,00:00:31.000,2025-04-05 17:43:43.410
false,false,1821,1720,101,97,00:00:33.000,2025-04-05 17:44:43.431
false,false,1823,1722,101,159,00:00:32.000,2025-04-05 17:45:43.458
false,false,1822,1721,101,127,00:00:30.000,2025-04-05 17:45:13.446
false,false,1820,1719,101,64,00:00:33.000,2025-04-05 17:44:13.420
false,false,1825,1724,101,223,00:00:32.000,2025-04-05 17:46:43.478
false,false,1824,1723,101,191,00:00:32.000,2025-04-05 17:46:13.468
false,false,1828,1727,101,316,00:00:31.000,2025-04-05 17:48:13.515
false,false,1826,1725,101,254,00:00:31.000,2025-04-05 17:47:13.492
false,false,1829,1728,101,349,00:00:33.000,2025-04-05 17:48:43.529
false,false,1827,1726,101,285,00:00:31.000,2025-04-05 17:47:43.501
false,false,1830,1729,101,381,00:00:32.000,2025-04-05 17:49:13.537
false,false,1831,1730,101,414,00:00:33.000,2025-04-05 17:49:43.548
false,false,1832,1731,101,447,00:00:33.000,2025-04-05 17:50:13.561
false,true,1832,1731,101,0,00:00:00.000,2025-04-05 17:50:43.575
false,true,1832,1731,101,0,00:00:00.000,2025-04-05 17:51:13.583
false,true,1832,1731,101,0,00:00:00.000,2025-04-05 17:52:13.610
false,true,1832,1731,101,0,00:00:00.000,2025-04-05 17:52:43.623
false,true,1832,1731,101,0,00:00:00.000,2025-04-05 17:51:43.597
false,true,1832,1731,101,0,00:00:00.000,2025-04-05 17:53:13.636
false,false,1833,1732,101,32,00:00:32.000,2025-04-05 17:53:43.636
false,true,1834,1733,101,0,00:00:00.000,2025-04-05 17:54:43.659
false,false,1834,1733,101,62,00:00:30.000,2025-04-05 17:54:13.647
false,true,1834,1733,101,0,00:00:00.000,2025-04-05 17:56:13.697
false,true,1834,1733,101,0,00:00:00.000,2025-04-05 17:55:13.672
false,true,1834,1733,101,0,00:00:00.000,2025-04-05 17:55:43.685
false,true,1834,1733,101,0,00:00:00.000,2025-04-05 17:57:13.723
false,true,1834,1733,101,0,00:00:00.000,2025-04-05 17:56:43.712
false,false,1835,1734,101,32,00:00:32.000,2025-04-05 17:57:43.737
false,false,1837,1735,102,98,00:00:33.000,2025-04-05 17:58:43.761
false,false,1836,1734,102,65,00:00:33.000,2025-04-05 17:58:13.749
false,false,1839,1737,102,163,00:00:33.000,2025-04-05 17:59:43.780
false,false,1840,1738,102,195,00:00:32.000,2025-04-05 18:00:13.789
false,false,1838,1736,102,130,00:00:32.000,2025-04-05 17:59:13.769
false,false,1841,1739,102,225,00:00:30.000,2025-04-05 18:00:43.802
false,true,1841,1739,102,0,00:00:00.000,2025-04-05 18:01:13.815
false,true,1841,1739,102,0,00:00:00.000,2025-04-05 18:02:13.840
false,true,1841,1739,102,0,00:00:00.000,2025-04-05 18:02:43.849
false,true,1841,1739,102,0,00:00:00.000,2025-04-05 18:03:13.861
false,true,1841,1739,102,0,00:00:00.000,2025-04-05 18:03:43.876
false,true,1841,1739,102,0,00:00:00.000,2025-04-05 18:01:43.826
false,false,1844,1742,102,96,00:00:32.000,2025-04-05 18:05:13.909
false,false,1843,1741,102,64,00:00:32.000,2025-04-05 18:04:43.897
false,false,1845,1743,102,126,00:00:30.000,2025-04-05 18:05:43.921
false,false,1842,1740,102,32,00:00:32.000,2025-04-05 18:04:13.886
false,false,1846,1744,102,156,00:00:30.000,2025-04-05 18:06:13.931
false,false,1848,1746,102,220,00:00:32.000,2025-04-05 18:07:13.950
false,false,1850,1748,102,283,00:00:32.000,2025-04-05 18:08:13.977
false,false,1847,1745,102,188,00:00:32.000,2025-04-05 18:06:43.942
false,false,1851,1749,102,315,00:00:32.000,2025-04-05 18:08:43.987
false,false,1849,1747,102,251,00:00:31.000,2025-04-05 18:07:43.964
false,false,1854,1752,102,410,00:00:33.000,2025-04-05 18:10:14.026
false,false,1853,1751,102,377,00:00:32.000,2025-04-05 18:09:44.013
false,false,1855,1753,102,440,00:00:30.000,2025-04-05 18:10:44.026
false,false,1852,1750,102,345,00:00:30.000,2025-04-05 18:09:13.998
false,false,1857,1755,102,502,00:00:30.000,2025-04-05 18:11:44.048
false,false,1856,1754,102,472,00:00:32.000,2025-04-05 18:11:14.038
false,false,1858,1756,102,533,00:00:31.000,2025-04-05 18:12:14.059
false,false,1860,1758,102,595,00:00:32.000,2025-04-05 18:13:14.081
false,false,1861,1759,102,625,00:00:30.000,2025-04-05 18:13:44.096
false,false,1862,1760,102,658,00:00:33.000,2025-04-05 18:14:14.103
false,false,1859,1757,102,563,00:00:30.000,2025-04-05 18:12:44.071
false,false,1863,1761,102,690,00:00:32.000,2025-04-05 18:14:44.114
false,false,1864,1762,102,723,00:00:33.000,2025-04-05 18:15:14.129
false,false,1866,1764,102,785,00:00:30.000,2025-04-05 18:16:14.157
false,false,1865,1763,102,755,00:00:32.000,2025-04-05 18:15:44.142
false,false,1869,1766,103,876,00:00:30.000,2025-04-05 18:17:44.188
false,false,1868,1766,102,846,00:00:30.000,2025-04-05 18:17:14.178
false,false,1870,1767,103,908,00:00:32.000,2025-04-05 18:18:14.198
false,false,1867,1765,102,816,00:00:31.000,2025-04-05 18:16:44.167
false,false,1871,1768,103,941,00:00:33.000,2025-04-05 18:18:44.213
false,false,1872,1769,103,973,00:00:32.000,2025-04-05 18:19:14.222
false,false,1873,1770,103,1003,00:00:30.000,2025-04-05 18:19:44.237
false,false,1874,1771,103,1034,00:00:31.000,2025-04-05 18:20:14.247
false,false,1875,1771,104,1067,00:00:33.000,2025-04-05 18:20:44.262
false,true,1875,1771,104,0,00:00:00.000,2025-04-05 18:21:14.277
false,true,1875,1771,104,0,00:00:00.000,2025-04-05 18:21:44.292
false,true,3811,3594,217,0,00:00:00.000,2025-04-06 16:40:15.401
false,true,3811,3594,217,0,00:00:00.000,2025-04-06 16:39:45.388
false,true,3811,3594,217,0,00:00:00.000,2025-04-06 16:39:15.379
false,false,3811,3594,217,32,00:00:32.000,2025-04-06 16:38:15.356
false,true,3811,3594,217,0,00:00:00.000,2025-04-06 16:38:45.366
false,true,3811,3594,217,0,00:00:00.000,2025-04-06 16:40:45.413
false,false,3812,3595,217,31,00:00:31.000,2025-04-06 16:41:45.436
false,true,3811,3594,217,0,00:00:00.000,2025-04-06 16:41:15.423
false,true,3810,3593,217,0,00:00:00.000,2025-04-06 16:37:45.349
false,false,3813,3596,217,62,00:00:31.000,2025-04-06 16:42:15.447
false,false,3814,3597,217,94,00:00:32.000,2025-04-06 16:42:45.457
false,false,3815,3598,217,127,00:00:33.000,2025-04-06 16:43:15.470
false,false,3816,3599,217,160,00:00:33.000,2025-04-06 16:43:45.472
false,false,3818,3601,217,222,00:00:31.000,2025-04-06 16:44:45.497
false,false,3819,3602,217,253,00:00:31.000,2025-04-06 16:45:15.507
false,false,3817,3600,217,191,00:00:31.000,2025-04-06 16:44:15.484
false,false,3820,3603,217,285,00:00:32.000,2025-04-06 16:45:45.520
false,false,3821,3604,217,318,00:00:33.000,2025-04-06 16:46:15.533
false,false,3822,3605,217,349,00:00:31.000,2025-04-06 16:46:45.546
false,false,3823,3606,217,380,00:00:31.000,2025-04-06 16:47:15.557
false,false,3824,3607,217,413,00:00:33.000,2025-04-06 16:47:45.567
false,false,3825,3608,217,443,00:00:30.000,2025-04-06 16:48:15.573
false,false,3827,3610,217,505,00:00:32.000,2025-04-06 16:49:15.596
false,false,3826,3609,217,473,00:00:30.000,2025-04-06 16:48:45.584
false,false,3830,3613,217,602,00:00:32.000,2025-04-06 16:50:45.625
false,false,3829,3612,217,570,00:00:33.000,2025-04-06 16:50:15.612
false,false,3828,3611,217,537,00:00:32.000,2025-04-06 16:49:45.601
false,false,3833,3616,217,697,00:00:32.000,2025-04-06 16:52:15.645
false,false,3832,3615,217,665,00:00:33.000,2025-04-06 16:51:45.636
false,false,3835,3618,217,759,00:00:30.000,2025-04-06 16:53:15.660
false,false,3834,3617,217,729,00:00:32.000,2025-04-06 16:52:45.649
false,false,3831,3614,217,632,00:00:30.000,2025-04-06 16:51:15.627
false,false,3836,3619,217,792,00:00:33.000,2025-04-06 16:53:45.670
false,false,3837,3620,217,825,00:00:33.000,2025-04-06 16:54:15.681
false,false,3841,3624,217,951,00:00:30.000,2025-04-06 16:56:15.723
false,false,3838,3621,217,858,00:00:33.000,2025-04-06 16:54:45.691
false,false,3839,3622,217,889,00:00:31.000,2025-04-06 16:55:15.704
false,false,3840,3623,217,921,00:00:32.000,2025-04-06 16:55:45.712
false,false,3842,3625,217,982,00:00:31.000,2025-04-06 16:56:45.735
false,false,3843,3626,217,1012,00:00:30.000,2025-04-06 16:57:15.748
false,false,3845,3628,217,1075,00:00:31.000,2025-04-06 16:58:15.768
false,false,3844,3627,217,1044,00:00:32.000,2025-04-06 16:57:45.756
false,false,3846,3629,217,1107,00:00:32.000,2025-04-06 16:58:45.781
false,false,3848,3631,217,1170,00:00:30.000,2025-04-06 16:59:45.805
false,false,3847,3630,217,1140,00:00:33.000,2025-04-06 16:59:15.794
false,false,3850,3633,217,1234,00:00:33.000,2025-04-06 17:00:45.828
false,false,3853,3636,217,1330,00:00:30.000,2025-04-06 17:02:15.855
false,false,3852,3635,217,1300,00:00:33.000,2025-04-06 17:01:45.850
false,false,3854,3637,217,1363,00:00:33.000,2025-04-06 17:02:45.867
false,false,3851,3634,217,1267,00:00:33.000,2025-04-06 17:01:15.841
false,false,3856,3639,217,1424,00:00:30.000,2025-04-06 17:03:45.893
false,false,3855,3638,217,1394,00:00:31.000,2025-04-06 17:03:15.880
false,false,3857,3640,217,1454,00:00:30.000,2025-04-06 17:04:15.905
false,false,3849,3632,217,1201,00:00:31.000,2025-04-06 17:00:15.817
false,false,3858,3641,217,1487,00:00:33.000,2025-04-06 17:04:45.917
false,false,3859,3642,217,1518,00:00:31.000,2025-04-06 17:05:15.928
false,false,3861,3644,217,1583,00:00:33.000,2025-04-06 17:06:15.949
false,false,3864,3647,217,1680,00:00:33.000,2025-04-06 17:07:45.980
false,false,3862,3645,217,1615,00:00:32.000,2025-04-06 17:06:45.955
false,false,3863,3646,217,1647,00:00:32.000,2025-04-06 17:07:15.967
false,false,3860,3643,217,1550,00:00:32.000,2025-04-06 17:05:45.938
false,false,3865,3648,217,1710,00:00:30.000,2025-04-06 17:08:15.987
false,false,3868,3650,218,1802,00:00:32.000,2025-04-06 17:09:46.019
false,false,3867,3650,217,1770,00:00:30.000,2025-04-06 17:09:16.008
false,false,3871,3653,218,1896,00:00:30.000,2025-04-06 17:11:16.048
false,false,3866,3649,217,1740,00:00:30.000,2025-04-06 17:08:45.995
false,false,3869,3651,218,1833,00:00:31.000,2025-04-06 17:10:16.030
false,false,3870,3652,218,1866,00:00:33.000,2025-04-06 17:10:46.039
false,false,3872,3654,218,1927,00:00:31.000,2025-04-06 17:11:46.061
false,false,3874,3656,218,1989,00:00:30.000,2025-04-06 17:12:46.085
false,false,3873,3655,218,1959,00:00:32.000,2025-04-06 17:12:16.072
false,false,3876,3658,218,2053,00:00:33.000,2025-04-06 17:13:46.109
false,false,3878,3660,218,2117,00:00:32.000,2025-04-06 17:14:46.132
false,false,3875,3657,218,2020,00:00:31.000,2025-04-06 17:13:16.097
false,false,3877,3659,218,2085,00:00:32.000,2025-04-06 17:14:16.119
false,false,3879,3661,218,2148,00:00:31.000,2025-04-06 17:15:16.140
false,false,3881,3663,218,2214,00:00:33.000,2025-04-06 17:16:16.162
false,false,3880,3662,218,2181,00:00:33.000,2025-04-06 17:15:46.149
false,false,3884,3666,218,2308,00:00:31.000,2025-04-06 17:17:46.198
false,false,3883,3665,218,2277,00:00:33.000,2025-04-06 17:17:16.185
false,false,3882,3664,218,2244,00:00:30.000,2025-04-06 17:16:46.174
false,false,3885,3667,218,2341,00:00:33.000,2025-04-06 17:18:16.207
false,true,3885,3667,218,0,00:00:00.000,2025-04-06 17:18:46.219
false,true,3885,3667,218,0,00:00:00.000,2025-04-06 17:19:46.241
false,true,3885,3667,218,0,00:00:00.000,2025-04-06 17:19:16.229
false,true,3885,3667,218,0,00:00:00.000,2025-04-06 17:20:46.264
false,true,3885,3667,218,0,00:00:00.000,2025-04-06 17:20:16.251
false,true,3885,3667,218,0,00:00:00.000,2025-04-06 17:21:16.273
false,false,3886,3668,218,32,00:00:32.000,2025-04-06 17:21:46.286
false,false,3887,3668,219,65,00:00:33.000,2025-04-06 17:22:16.297
false,false,3888,3669,219,98,00:00:33.000,2025-04-06 17:22:46.301
false,false,3890,3671,219,160,00:00:32.000,2025-04-06 17:23:46.323
false,false,3891,3672,219,193,00:00:33.000,2025-04-06 17:24:16.336
false,false,3893,3673,220,257,00:00:32.000,2025-04-06 17:25:16.355
false,false,3892,3673,219,225,00:00:32.000,2025-04-06 17:24:46.348
false,false,3889,3670,219,128,00:00:30.000,2025-04-06 17:23:16.312
false,true,3893,3673,220,0,00:00:00.000,2025-04-06 17:25:46.366
false,true,3893,3673,220,0,00:00:00.000,2025-04-06 17:27:16.394
false,true,3893,3673,220,0,00:00:00.000,2025-04-06 17:26:16.375
false,true,3893,3673,220,0,00:00:00.000,2025-04-06 17:26:46.385
false,true,3893,3673,220,0,00:00:00.000,2025-04-06 17:28:16.416
false,false,3894,3674,220,30,00:00:30.000,2025-04-06 17:28:46.426
false,false,3895,3675,220,62,00:00:32.000,2025-04-06 17:29:16.438
false,true,3893,3673,220,0,00:00:00.000,2025-04-06 17:27:46.405
false,false,3897,3677,220,123,00:00:30.000,2025-04-06 17:30:16.460
false,false,3899,3679,220,185,00:00:32.000,2025-04-06 17:31:16.482
false,false,3896,3676,220,93,00:00:31.000,2025-04-06 17:29:46.449
false,false,3898,3678,220,153,00:00:30.000,2025-04-06 17:30:46.470
false,false,3900,3680,220,218,00:00:33.000,2025-04-06 17:31:46.490
false,false,3901,3681,220,250,00:00:32.000,2025-04-06 17:32:16.503
false,false,3903,3683,220,311,00:00:31.000,2025-04-06 17:33:16.525
false,false,3902,3682,220,280,00:00:30.000,2025-04-06 17:32:46.514
false,false,3904,3684,220,341,00:00:30.000,2025-04-06 17:33:46.536
false,false,3906,3686,220,407,00:00:33.000,2025-04-06 17:34:46.553
false,false,3905,3685,220,374,00:00:33.000,2025-04-06 17:34:16.541
false,false,3907,3687,220,438,00:00:31.000,2025-04-06 17:35:16.562
false,false,3909,3688,221,501,00:00:33.000,2025-04-06 17:36:16.583
false,true,3909,3688,221,0,00:00:00.000,2025-04-06 17:36:46.592
false,true,3909,3688,221,0,00:00:00.000,2025-04-06 17:37:46.615
false,true,3909,3688,221,0,00:00:00.000,2025-04-06 17:37:16.604
false,true,3909,3688,221,0,00:00:00.000,2025-04-06 17:38:16.626
false,false,3908,3688,220,468,00:00:30.000,2025-04-06 17:35:46.570
false,true,3909,3688,221,0,00:00:00.000,2025-04-06 17:39:16.650
false,false,3912,3691,221,92,00:00:32.000,2025-04-06 17:40:46.681
false,true,3909,3688,221,0,00:00:00.000,2025-04-06 17:38:46.639
false,false,3913,3692,221,123,00:00:31.000,2025-04-06 17:41:16.693
false,false,3911,3690,221,60,00:00:30.000,2025-04-06 17:40:16.672
false,false,3910,3689,221,30,00:00:30.000,2025-04-06 17:39:46.662
false,true,4525,4269,256,0,00:00:00.000,2025-04-07 01:06:24.021
false,true,4525,4269,256,0,00:00:00.000,2025-04-07 01:06:54.026
false,true,4525,4269,256,0,00:00:00.000,2025-04-07 01:07:24.027
false,true,4525,4269,256,0,00:00:00.000,2025-04-07 01:08:24.038
false,true,4525,4269,256,0,00:00:00.000,2025-04-07 01:07:54.033
false,false,4526,4270,256,30,00:00:30.000,2025-04-07 01:08:54.045
false,false,4528,4272,256,94,00:00:31.000,2025-04-07 01:09:54.051
false,false,4527,4271,256,63,00:00:33.000,2025-04-07 01:09:24.046
false,false,4533,4277,256,254,00:00:32.000,2025-04-07 01:12:24.077
false,false,4530,4274,256,160,00:00:33.000,2025-04-07 01:10:54.064
false,false,4531,4275,256,192,00:00:32.000,2025-04-07 01:11:24.067
false,false,4532,4276,256,222,00:00:30.000,2025-04-07 01:11:54.071
false,false,4529,4273,256,127,00:00:33.000,2025-04-07 01:10:24.058
false,false,4534,4278,256,286,00:00:32.000,2025-04-07 01:12:54.082
false,false,4537,4281,256,379,00:00:31.000,2025-04-07 01:14:24.096
false,false,4538,4282,256,410,00:00:31.000,2025-04-07 01:14:54.101
false,false,4535,4279,256,317,00:00:31.000,2025-04-07 01:13:24.088
false,false,4536,4280,256,348,00:00:31.000,2025-04-07 01:13:54.092
false,false,4539,4283,256,442,00:00:32.000,2025-04-07 01:15:24.105
false,false,4540,4284,256,474,00:00:32.000,2025-04-07 01:15:54.110
false,false,4541,4285,256,507,00:00:33.000,2025-04-07 01:16:24.115
false,false,4543,4287,256,572,00:00:33.000,2025-04-07 01:17:24.126
false,false,4544,4288,256,604,00:00:32.000,2025-04-07 01:17:54.130
false,false,4542,4286,256,539,00:00:32.000,2025-04-07 01:16:54.120
false,false,4545,4289,256,635,00:00:31.000,2025-04-07 01:18:24.136
false,false,4546,4290,256,668,00:00:33.000,2025-04-07 01:18:54.139
false,false,4548,4292,256,730,00:00:32.000,2025-04-07 01:19:54.148
false,false,4547,4291,256,698,00:00:30.000,2025-04-07 01:19:24.143
false,false,4549,4293,256,760,00:00:30.000,2025-04-07 01:20:24.152
false,false,4552,4296,256,856,00:00:33.000,2025-04-07 01:21:54.164
false,false,4551,4295,256,823,00:00:33.000,2025-04-07 01:21:24.164
false,false,4553,4297,256,888,00:00:32.000,2025-04-07 01:22:24.169
false,false,4550,4294,256,790,00:00:30.000,2025-04-07 01:20:54.158
false,false,4554,4298,256,919,00:00:31.000,2025-04-07 01:22:54.175
false,false,4555,4299,256,952,00:00:33.000,2025-04-07 01:23:24.177
false,false,4556,4300,256,984,00:00:32.000,2025-04-07 01:23:54.182
false,false,4557,4301,256,1017,00:00:33.000,2025-04-07 01:24:24.187
false,false,4560,4304,256,1114,00:00:33.000,2025-04-07 01:25:54.193
false,false,4558,4302,256,1048,00:00:31.000,2025-04-07 01:24:54.190
false,false,4559,4303,256,1081,00:00:33.000,2025-04-07 01:25:24.190
false,false,4563,4306,257,1210,00:00:32.000,2025-04-07 01:27:24.201
false,false,4561,4304,257,1147,00:00:33.000,2025-04-07 01:26:24.195
false,false,4564,4307,257,1243,00:00:33.000,2025-04-07 01:27:54.204
false,false,4568,4311,257,1373,00:00:33.000,2025-04-07 01:29:54.224
false,false,4562,4305,257,1178,00:00:31.000,2025-04-07 01:26:54.199
false,false,4565,4308,257,1276,00:00:33.000,2025-04-07 01:28:24.209
false,false,4566,4309,257,1307,00:00:31.000,2025-04-07 01:28:54.214
false,false,4567,4310,257,1340,00:00:33.000,2025-04-07 01:29:24.219
false,false,4570,4313,257,1436,00:00:31.000,2025-04-07 01:30:54.230
false,false,4572,4315,257,1496,00:00:30.000,2025-04-07 01:31:54.235
false,false,4569,4312,257,1405,00:00:32.000,2025-04-07 01:30:24.228
false,false,4574,4317,257,1560,00:00:33.000,2025-04-07 01:32:54.240
false,false,4573,4316,257,1527,00:00:31.000,2025-04-07 01:32:24.238
false,false,4575,4318,257,1592,00:00:32.000,2025-04-07 01:33:24.246
false,false,4571,4314,257,1466,00:00:30.000,2025-04-07 01:31:24.233
false,false,4576,4319,257,1623,00:00:31.000,2025-04-07 01:33:54.249
false,false,4581,4324,257,1780,00:00:30.000,2025-04-07 01:36:24.272
false,false,4579,4322,257,1719,00:00:33.000,2025-04-07 01:35:24.265
false,false,4577,4320,257,1655,00:00:32.000,2025-04-07 01:34:24.254
false,false,4580,4323,257,1750,00:00:31.000,2025-04-07 01:35:54.269
false,false,4578,4321,257,1686,00:00:31.000,2025-04-07 01:34:54.260
false,false,4583,4326,257,1843,00:00:31.000,2025-04-07 01:37:24.279
false,false,4582,4325,257,1812,00:00:32.000,2025-04-07 01:36:54.276
false,false,4585,4328,257,1908,00:00:32.000,2025-04-07 01:38:24.290
false,false,4584,4327,257,1876,00:00:33.000,2025-04-07 01:37:54.284
false,false,4586,4329,257,1938,00:00:30.000,2025-04-07 01:38:54.291
false,false,4589,4332,257,2032,00:00:30.000,2025-04-07 01:40:24.300
false,false,4588,4331,257,2002,00:00:31.000,2025-04-07 01:39:54.297
false,false,4587,4330,257,1971,00:00:33.000,2025-04-07 01:39:24.294
false,false,4591,4333,258,2095,00:00:33.000,2025-04-07 01:41:24.310
false,false,4590,4332,258,2062,00:00:30.000,2025-04-07 01:40:54.305
false,false,4593,4335,258,2157,00:00:31.000,2025-04-07 01:42:24.318
false,false,4596,4338,258,2252,00:00:31.000,2025-04-07 01:43:54.328
false,false,4594,4336,258,2190,00:00:33.000,2025-04-07 01:42:54.320
false,false,4592,4334,258,2126,00:00:31.000,2025-04-07 01:41:54.315
false,false,4597,4339,258,2284,00:00:32.000,2025-04-07 01:44:24.331
false,false,4595,4337,258,2221,00:00:31.000,2025-04-07 01:43:24.324
false,true,4597,4339,258,0,00:00:00.000,2025-04-07 01:45:24.341
false,true,4597,4339,258,0,00:00:00.000,2025-04-07 01:46:24.347
false,true,4597,4339,258,0,00:00:00.000,2025-04-07 01:44:54.336
false,true,4597,4339,258,0,00:00:00.000,2025-04-07 01:46:54.351
false,true,4597,4339,258,0,00:00:00.000,2025-04-07 01:45:54.346
false,true,4597,4339,258,0,00:00:00.000,2025-04-07 01:47:24.353
false,true,4597,4339,258,0,00:00:00.000,2025-04-07 01:47:54.355
false,true,4597,4339,258,0,00:00:00.000,2025-04-07 01:48:54.363
false,true,4597,4339,258,0,00:00:00.000,2025-04-07 01:48:24.358
false,true,4597,4339,258,0,00:00:00.000,2025-04-07 01:49:54.371
false,true,4597,4339,258,0,00:00:00.000,2025-04-07 01:50:24.376
false,true,4597,4339,258,0,00:00:00.000,2025-04-07 01:49:24.367
false,false,4598,4340,258,33,00:00:33.000,2025-04-07 01:50:54.380
false,false,4600,4342,258,97,00:00:32.000,2025-04-07 01:51:54.386
false,false,4599,4341,258,65,00:00:32.000,2025-04-07 01:51:24.383
false,false,4601,4343,258,128,00:00:31.000,2025-04-07 01:52:24.391
false,false,4602,4344,258,158,00:00:30.000,2025-04-07 01:52:54.394
false,false,4604,4346,258,221,00:00:33.000,2025-04-07 01:53:54.400
false,false,4607,4348,259,318,00:00:33.000,2025-04-07 01:55:24.410
false,false,4608,4349,259,351,00:00:33.000,2025-04-07 01:55:54.415
false,false,4605,4347,258,253,00:00:32.000,2025-04-07 01:54:24.403
false,false,4603,4345,258,188,00:00:30.000,2025-04-07 01:53:24.397
false,false,4606,4348,258,285,00:00:32.000,2025-04-07 01:54:54.405
false,false,4609,4350,259,383,00:00:32.000,2025-04-07 01:56:24.418
false,false,4612,4353,259,479,00:00:31.000,2025-04-07 01:57:54.427
false,false,4613,4354,259,511,00:00:32.000,2025-04-07 01:58:24.427
false,false,4610,4351,259,416,00:00:33.000,2025-04-07 01:56:54.421
false,false,4611,4352,259,448,00:00:32.000,2025-04-07 01:57:24.425
false,false,4614,4354,260,541,00:00:30.000,2025-04-07 01:58:54.432
false,true,4615,4355,260,0,00:00:00.000,2025-04-07 02:00:24.442
false,false,4615,4355,260,571,00:00:30.000,2025-04-07 01:59:24.436
false,true,4615,4355,260,0,00:00:00.000,2025-04-07 01:59:54.438
false,true,4615,4355,260,0,00:00:00.000,2025-04-07 02:00:54.442
false,true,4615,4355,260,0,00:00:00.000,2025-04-07 02:02:24.451
false,true,4615,4355,260,0,00:00:00.000,2025-04-07 02:01:54.447
false,true,4615,4355,260,0,00:00:00.000,2025-04-07 02:01:24.446
false,false,4616,4356,260,33,00:00:33.000,2025-04-07 02:02:54.455
false,false,4619,4359,260,125,00:00:31.000,2025-04-07 02:04:24.468
false,false,4618,4358,260,94,00:00:30.000,2025-04-07 02:03:54.464
false,false,4617,4357,260,64,00:00:31.000,2025-04-07 02:03:24.460
false,true,4619,4359,260,0,00:00:00.000,2025-04-07 02:05:24.475
false,true,4619,4359,260,0,00:00:00.000,2025-04-07 02:06:54.483
false,true,4619,4359,260,0,00:00:00.000,2025-04-07 02:07:24.488
false,true,4619,4359,260,0,00:00:00.000,2025-04-07 02:06:24.481
false,true,4619,4359,260,0,00:00:00.000,2025-04-07 02:04:54.471
false,true,4619,4359,260,0,00:00:00.000,2025-04-07 02:05:54.478
false,false,4620,4360,260,31,00:00:31.000,2025-04-07 02:07:54.492
false,false,4621,4361,260,62,00:00:31.000,2025-04-07 02:08:24.496
false,true,2763,2606,157,0,00:00:00.000,2025-04-06 03:55:57.667
false,true,2763,2606,157,0,00:00:00.000,2025-04-06 03:56:27.682
false,true,2763,2606,157,0,00:00:00.000,2025-04-06 03:54:27.632
false,true,2763,2606,157,0,00:00:00.000,2025-04-06 03:54:57.645
false,true,2763,2606,157,0,00:00:00.000,2025-04-06 03:56:57.694
false,true,2763,2606,157,0,00:00:00.000,2025-04-06 03:55:27.656
false,false,2764,2607,157,31,00:00:31.000,2025-04-06 03:57:27.705
false,false,2767,2610,157,123,00:00:31.000,2025-04-06 03:58:57.740
false,false,2765,2608,157,61,00:00:30.000,2025-04-06 03:57:57.715
false,false,2769,2612,157,184,00:00:30.000,2025-04-06 03:59:57.758
false,false,2768,2611,157,154,00:00:31.000,2025-04-06 03:59:27.752
false,false,2766,2609,157,92,00:00:31.000,2025-04-06 03:58:27.729
false,false,2770,2613,157,216,00:00:32.000,2025-04-06 04:00:27.771
false,false,2773,2616,157,313,00:00:33.000,2025-04-06 04:01:57.807
false,false,2771,2614,157,247,00:00:31.000,2025-04-06 04:00:57.785
false,false,2772,2615,157,280,00:00:33.000,2025-04-06 04:01:27.796
false,false,2774,2617,157,345,00:00:32.000,2025-04-06 04:02:27.818
false,false,2776,2619,157,411,00:00:33.000,2025-04-06 04:03:27.838
false,false,2775,2618,157,378,00:00:33.000,2025-04-06 04:02:57.828
false,false,2778,2621,157,476,00:00:32.000,2025-04-06 04:04:27.859
false,false,2777,2620,157,444,00:00:33.000,2025-04-06 04:03:57.849
false,false,2779,2622,157,507,00:00:31.000,2025-04-06 04:04:57.870
false,true,2779,2622,157,0,00:00:00.000,2025-04-06 04:05:27.883
false,true,2779,2622,157,0,00:00:00.000,2025-04-06 04:06:57.916
false,true,2779,2622,157,0,00:00:00.000,2025-04-06 04:05:57.893
false,true,2779,2622,157,0,00:00:00.000,2025-04-06 04:07:27.931
false,true,2779,2622,157,0,00:00:00.000,2025-04-06 04:07:57.942
false,true,2779,2622,157,0,00:00:00.000,2025-04-06 04:06:27.904
false,false,2780,2623,157,31,00:00:31.000,2025-04-06 04:08:27.949
false,false,2782,2625,157,94,00:00:32.000,2025-04-06 04:09:27.980
false,false,2781,2624,157,62,00:00:31.000,2025-04-06 04:08:57.965
false,false,2784,2627,157,158,00:00:32.000,2025-04-06 04:10:28.003
false,false,2783,2626,157,126,00:00:32.000,2025-04-06 04:09:57.992
false,false,2786,2629,157,219,00:00:30.000,2025-04-06 04:11:28.031
false,false,2785,2628,157,189,00:00:31.000,2025-04-06 04:10:58.017
false,true,2787,2630,157,0,00:00:00.000,2025-04-06 04:12:28.050
false,false,2787,2630,157,249,00:00:30.000,2025-04-06 04:11:58.038
false,true,2787,2630,157,0,00:00:00.000,2025-04-06 04:12:58.061
false,true,2787,2630,157,0,00:00:00.000,2025-04-06 04:13:58.086
false,true,2787,2630,157,0,00:00:00.000,2025-04-06 04:13:28.073
false,true,2787,2630,157,0,00:00:00.000,2025-04-06 04:14:28.101
false,true,2787,2630,157,0,00:00:00.000,2025-04-06 04:14:58.115
false,false,2788,2631,157,31,00:00:31.000,2025-04-06 04:15:28.127
false,false,2790,2633,157,93,00:00:32.000,2025-04-06 04:16:28.151
false,false,2792,2635,157,157,00:00:33.000,2025-04-06 04:17:28.175
false,false,2789,2632,157,61,00:00:30.000,2025-04-06 04:15:58.139
false,false,2791,2634,157,124,00:00:31.000,2025-04-06 04:16:58.162
false,false,2793,2636,157,188,00:00:31.000,2025-04-06 04:17:58.184
false,false,2794,2637,157,219,00:00:31.000,2025-04-06 04:18:28.198
false,false,2795,2637,158,250,00:00:31.000,2025-04-06 04:18:58.213
false,false,2796,2638,158,281,00:00:31.000,2025-04-06 04:19:28.225
false,true,2796,2638,158,0,00:00:00.000,2025-04-06 04:19:58.238
false,true,2796,2638,158,0,00:00:00.000,2025-04-06 04:20:28.253
false,true,2796,2638,158,0,00:00:00.000,2025-04-06 04:20:58.267
false,true,2796,2638,158,0,00:00:00.000,2025-04-06 04:21:58.290
false,true,2796,2638,158,0,00:00:00.000,2025-04-06 04:21:28.279
false,false,2797,2639,158,31,00:00:31.000,2025-04-06 04:22:58.309
false,false,2798,2640,158,63,00:00:32.000,2025-04-06 04:23:28.320
false,true,2796,2638,158,0,00:00:00.000,2025-04-06 04:22:28.299
false,true,2799,2641,158,0,00:00:00.000,2025-04-06 04:24:28.339
false,false,2799,2641,158,93,00:00:30.000,2025-04-06 04:23:58.333
false,true,2799,2641,158,0,00:00:00.000,2025-04-06 04:24:58.353
false,true,2799,2641,158,0,00:00:00.000,2025-04-06 04:25:58.379
false,true,2799,2641,158,0,00:00:00.000,2025-04-06 04:25:28.364
false,true,2799,2641,158,0,00:00:00.000,2025-04-06 04:26:58.407
false,true,2799,2641,158,0,00:00:00.000,2025-04-06 04:26:28.393
false,false,2801,2642,159,62,00:00:31.000,2025-04-06 04:27:58.429
false,false,2800,2642,158,31,00:00:31.000,2025-04-06 04:27:28.414
false,false,2802,2643,159,93,00:00:31.000,2025-04-06 04:28:28.440
false,false,2803,2644,159,125,00:00:32.000,2025-04-06 04:28:58.442
false,false,2805,2646,159,188,00:00:31.000,2025-04-06 04:29:58.468
false,false,2804,2645,159,157,00:00:32.000,2025-04-06 04:29:28.455
false,true,2805,2646,159,0,00:00:00.000,2025-04-06 04:30:58.488
false,true,2805,2646,159,0,00:00:00.000,2025-04-06 04:30:28.482
false,true,2805,2646,159,0,00:00:00.000,2025-04-06 04:31:58.515
false,true,2805,2646,159,0,00:00:00.000,2025-04-06 04:31:28.501
false,true,2805,2646,159,0,00:00:00.000,2025-04-06 04:32:28.530
false,false,2806,2647,159,33,00:00:33.000,2025-04-06 04:33:28.550
false,false,2807,2647,160,65,00:00:32.000,2025-04-06 04:33:58.565
false,true,2808,2647,161,0,00:00:00.000,2025-04-06 04:34:58.585
false,true,2805,2646,159,0,00:00:00.000,2025-04-06 04:32:58.537
false,true,2808,2647,161,0,00:00:00.000,2025-04-06 04:35:28.594
false,false,2808,2647,161,96,00:00:31.000,2025-04-06 04:34:28.571
false,true,2808,2647,161,0,00:00:00.000,2025-04-06 04:36:28.616
false,true,2808,2647,161,0,00:00:00.000,2025-04-06 04:35:58.603
false,true,2808,2647,161,0,00:00:00.000,2025-04-06 04:36:58.627
false,true,2808,2647,161,0,00:00:00.000,2025-04-06 04:37:28.637
false,false,2809,2648,161,30,00:00:30.000,2025-04-06 04:37:58.649
false,false,2810,2649,161,60,00:00:30.000,2025-04-06 04:38:28.662
false,false,2812,2651,161,123,00:00:33.000,2025-04-06 04:39:28.683
false,false,2813,2652,161,153,00:00:30.000,2025-04-06 04:39:58.697
false,false,2814,2653,161,184,00:00:31.000,2025-04-06 04:40:28.712
false,false,2815,2654,161,217,00:00:33.000,2025-04-06 04:40:58.722
false,false,2811,2650,161,90,00:00:30.000,2025-04-06 04:38:58.673
false,false,2816,2655,161,247,00:00:30.000,2025-04-06 04:41:28.738
false,true,2816,2655,161,0,00:00:00.000,2025-04-06 04:42:58.778
false,true,2816,2655,161,0,00:00:00.000,2025-04-06 04:42:28.765
false,true,2816,2655,161,0,00:00:00.000,2025-04-06 04:43:58.806
false,false,2817,2656,161,33,00:00:33.000,2025-04-06 04:44:58.835
false,true,2816,2655,161,0,00:00:00.000,2025-04-06 04:44:28.821
false,false,2818,2657,161,64,00:00:31.000,2025-04-06 04:45:28.848
false,true,2816,2655,161,0,00:00:00.000,2025-04-06 04:41:58.750
false,true,2816,2655,161,0,00:00:00.000,2025-04-06 04:43:28.793
false,false,2821,2660,161,157,00:00:32.000,2025-04-06 04:46:58.880
false,false,2820,2659,161,125,00:00:31.000,2025-04-06 04:46:28.871
false,false,2819,2658,161,94,00:00:30.000,2025-04-06 04:45:58.861
false,true,2822,2661,161,0,00:00:00.000,2025-04-06 04:48:28.918
false,true,2822,2661,161,0,00:00:00.000,2025-04-06 04:47:58.904
false,false,2822,2661,161,188,00:00:31.000,2025-04-06 04:47:28.889
false,true,2822,2661,161,0,00:00:00.000,2025-04-06 04:49:28.942
false,true,2822,2661,161,0,00:00:00.000,2025-04-06 04:48:58.929
false,true,2822,2661,161,0,00:00:00.000,2025-04-06 04:49:58.957
false,true,2822,2661,161,0,00:00:00.000,2025-04-06 04:50:28.968
false,false,2823,2662,161,30,00:00:30.000,2025-04-06 04:50:58.974
false,false,2825,2664,161,93,00:00:30.000,2025-04-06 04:51:58.999
false,false,2824,2663,161,63,00:00:33.000,2025-04-06 04:51:28.985
false,false,2826,2665,161,125,00:00:32.000,2025-04-06 04:52:29.009
false,false,2829,2667,162,221,00:00:32.000,2025-04-06 04:53:59.051
false,false,2828,2666,162,189,00:00:32.000,2025-04-06 04:53:29.036
false,false,2827,2666,161,157,00:00:32.000,2025-04-06 04:52:59.021
false,false,2830,2668,162,251,00:00:30.000,2025-04-06 04:54:29.066
false,false,2833,2671,162,348,00:00:32.000,2025-04-06 04:55:59.093
false,false,2831,2669,162,283,00:00:32.000,2025-04-06 04:54:59.078
false,false,2834,2672,162,381,00:00:33.000,2025-04-06 04:56:29.105
false,false,2832,2670,162,316,00:00:33.000,2025-04-06 04:55:29.084
false,false,2836,2674,162,443,00:00:31.000,2025-04-06 04:57:29.131
false,false,2835,2673,162,412,00:00:31.000,2025-04-06 04:56:59.119
false,true,4430,4177,253,0,00:00:00.000,2025-04-07 00:01:53.388
false,true,4430,4177,253,0,00:00:00.000,2025-04-07 00:02:53.394
false,true,4430,4177,253,0,00:00:00.000,2025-04-07 00:02:23.393
false,false,4431,4178,253,33,00:00:33.000,2025-04-07 00:03:23.401
false,false,4432,4179,253,65,00:00:32.000,2025-04-07 00:03:53.409
false,false,4433,4180,253,97,00:00:32.000,2025-04-07 00:04:23.413
false,false,4434,4181,253,130,00:00:33.000,2025-04-07 00:04:53.420
false,true,4434,4181,253,0,00:00:00.000,2025-04-07 00:06:23.439
false,true,4434,4181,253,0,00:00:00.000,2025-04-07 00:05:53.434
false,true,4434,4181,253,0,00:00:00.000,2025-04-07 00:07:23.445
false,true,4434,4181,253,0,00:00:00.000,2025-04-07 00:06:53.444
false,true,4434,4181,253,0,00:00:00.000,2025-04-07 00:05:23.426
false,false,4439,4186,253,159,00:00:32.000,2025-04-07 00:10:23.481
false,false,4438,4185,253,127,00:00:32.000,2025-04-07 00:09:53.476
false,true,4434,4181,253,0,00:00:00.000,2025-04-07 00:07:53.454
false,false,4436,4183,253,62,00:00:31.000,2025-04-07 00:08:53.466
false,false,4435,4182,253,31,00:00:31.000,2025-04-07 00:08:23.459
false,false,4437,4184,253,95,00:00:33.000,2025-04-07 00:09:23.473
false,false,4442,4188,254,253,00:00:31.000,2025-04-07 00:11:53.501
false,false,4440,4187,253,190,00:00:31.000,2025-04-07 00:10:53.487
false,false,4445,4191,254,348,00:00:33.000,2025-04-07 00:13:23.514
false,false,4443,4189,254,285,00:00:32.000,2025-04-07 00:12:23.503
false,false,4444,4190,254,315,00:00:30.000,2025-04-07 00:12:53.507
false,false,4441,4188,253,222,00:00:32.000,2025-04-07 00:11:23.494
false,false,4446,4192,254,378,00:00:30.000,2025-04-07 00:13:53.520
false,true,4448,4194,254,0,00:00:00.000,2025-04-07 00:15:23.537
false,false,4448,4194,254,439,00:00:30.000,2025-04-07 00:14:53.533
false,true,4448,4194,254,0,00:00:00.000,2025-04-07 00:15:53.543
false,true,4448,4194,254,0,00:00:00.000,2025-04-07 00:16:23.549
false,false,4447,4193,254,409,00:00:31.000,2025-04-07 00:14:23.526
false,true,4448,4194,254,0,00:00:00.000,2025-04-07 00:16:53.554
false,true,4448,4194,254,0,00:00:00.000,2025-04-07 00:17:23.559
false,false,4449,4195,254,33,00:00:33.000,2025-04-07 00:18:23.573
false,true,4448,4194,254,0,00:00:00.000,2025-04-07 00:17:53.566
false,false,4452,4197,255,125,00:00:30.000,2025-04-07 00:19:53.580
false,false,4450,4196,254,65,00:00:32.000,2025-04-07 00:18:53.576
false,false,4451,4196,255,95,00:00:30.000,2025-04-07 00:19:23.580
false,false,4453,4198,255,157,00:00:32.000,2025-04-07 00:20:23.584
false,false,4454,4199,255,189,00:00:32.000,2025-04-07 00:20:53.587
false,false,4455,4200,255,219,00:00:30.000,2025-04-07 00:21:23.594
false,false,4459,4204,255,347,00:00:32.000,2025-04-07 00:23:23.623
false,false,4458,4203,255,315,00:00:32.000,2025-04-07 00:22:53.616
false,false,4457,4202,255,283,00:00:32.000,2025-04-07 00:22:23.608
false,false,4456,4201,255,251,00:00:32.000,2025-04-07 00:21:53.601
false,false,4460,4205,255,380,00:00:33.000,2025-04-07 00:23:53.627
false,false,4461,4205,256,413,00:00:33.000,2025-04-07 00:24:23.628
false,false,4465,4209,256,535,00:00:31.000,2025-04-07 00:26:23.649
false,false,4462,4206,256,444,00:00:31.000,2025-04-07 00:24:53.633
false,false,4463,4207,256,474,00:00:30.000,2025-04-07 00:25:23.639
false,false,4464,4208,256,504,00:00:30.000,2025-04-07 00:25:53.645
false,false,4467,4211,256,601,00:00:33.000,2025-04-07 00:27:23.659
false,false,4466,4210,256,568,00:00:33.000,2025-04-07 00:26:53.654
false,false,4468,4212,256,632,00:00:31.000,2025-04-07 00:27:53.665
false,false,4469,4213,256,665,00:00:33.000,2025-04-07 00:28:23.672
false,false,4470,4214,256,696,00:00:31.000,2025-04-07 00:28:53.679
false,false,4472,4216,256,760,00:00:33.000,2025-04-07 00:29:53.693
false,false,4473,4217,256,792,00:00:32.000,2025-04-07 00:30:23.700
false,false,4471,4215,256,727,00:00:31.000,2025-04-07 00:29:23.686
false,false,4475,4219,256,856,00:00:33.000,2025-04-07 00:31:23.709
false,false,4474,4218,256,823,00:00:31.000,2025-04-07 00:30:53.707
false,false,4476,4220,256,886,00:00:30.000,2025-04-07 00:31:53.715
false,true,4476,4220,256,0,00:00:00.000,2025-04-07 00:32:23.721
false,true,4476,4220,256,0,00:00:00.000,2025-04-07 00:33:23.732
false,true,4476,4220,256,0,00:00:00.000,2025-04-07 00:33:53.738
false,true,4476,4220,256,0,00:00:00.000,2025-04-07 00:32:53.727
false,true,4476,4220,256,0,00:00:00.000,2025-04-07 00:34:23.739
false,true,4476,4220,256,0,00:00:00.000,2025-04-07 00:34:53.744
false,false,4477,4221,256,32,00:00:32.000,2025-04-07 00:35:23.747
false,false,4478,4222,256,63,00:00:31.000,2025-04-07 00:35:53.752
false,false,4482,4226,256,190,00:00:30.000,2025-04-07 00:37:53.760
false,false,4479,4223,256,96,00:00:33.000,2025-04-07 00:36:23.757
false,false,4480,4224,256,127,00:00:31.000,2025-04-07 00:36:53.759
false,false,4481,4225,256,160,00:00:33.000,2025-04-07 00:37:23.759
false,false,4483,4227,256,222,00:00:32.000,2025-04-07 00:38:23.765
false,false,4484,4228,256,255,00:00:33.000,2025-04-07 00:38:53.767
false,false,4486,4230,256,320,00:00:33.000,2025-04-07 00:39:53.779
false,false,4487,4231,256,352,00:00:32.000,2025-04-07 00:40:23.783
false,false,4489,4233,256,412,00:00:30.000,2025-04-07 00:41:23.792
false,false,4488,4232,256,382,00:00:30.000,2025-04-07 00:40:53.786
false,false,4485,4229,256,287,00:00:32.000,2025-04-07 00:39:23.773
false,true,4490,4234,256,0,00:00:00.000,2025-04-07 00:42:53.811
false,true,4490,4234,256,0,00:00:00.000,2025-04-07 00:42:23.806
false,false,4490,4234,256,442,00:00:30.000,2025-04-07 00:41:53.798
false,true,4490,4234,256,0,00:00:00.000,2025-04-07 00:43:53.822
false,true,4490,4234,256,0,00:00:00.000,2025-04-07 00:43:23.817
false,true,4490,4234,256,0,00:00:00.000,2025-04-07 00:44:53.831
false,true,4491,4235,256,0,00:00:00.000,2025-04-07 00:45:53.842
false,true,4490,4234,256,0,00:00:00.000,2025-04-07 00:44:23.827
false,false,4491,4235,256,33,00:00:33.000,2025-04-07 00:45:23.837
false,true,4491,4235,256,0,00:00:00.000,2025-04-07 00:46:23.849
false,true,4491,4235,256,0,00:00:00.000,2025-04-07 00:47:23.860
false,true,4491,4235,256,0,00:00:00.000,2025-04-07 00:46:53.855
false,false,4492,4236,256,31,00:00:31.000,2025-04-07 00:48:53.872
false,true,4491,4235,256,0,00:00:00.000,2025-04-07 00:47:53.867
false,false,4493,4237,256,63,00:00:32.000,2025-04-07 00:49:23.878
false,true,4491,4235,256,0,00:00:00.000,2025-04-07 00:48:23.869
false,false,4497,4241,256,191,00:00:32.000,2025-04-07 00:51:23.891
false,false,4494,4238,256,96,00:00:33.000,2025-04-07 00:49:53.879
false,false,4496,4240,256,159,00:00:30.000,2025-04-07 00:50:53.890
false,false,4498,4242,256,222,00:00:31.000,2025-04-07 00:51:53.894
false,false,4495,4239,256,129,00:00:33.000,2025-04-07 00:50:23.885
false,false,4499,4243,256,252,00:00:30.000,2025-04-07 00:52:23.899
false,false,4504,4248,256,404,00:00:31.000,2025-04-07 00:54:53.915
false,false,4501,4245,256,313,00:00:30.000,2025-04-07 00:53:23.906
false,false,4502,4246,256,343,00:00:30.000,2025-04-07 00:53:53.908
false,false,4505,4249,256,437,00:00:33.000,2025-04-07 00:55:23.915
false,false,4503,4247,256,373,00:00:30.000,2025-04-07 00:54:23.909
false,false,4500,4244,256,283,00:00:31.000,2025-04-07 00:52:53.901
false,false,4507,4251,256,500,00:00:30.000,2025-04-07 00:56:23.925
false,false,4508,4252,256,531,00:00:31.000,2025-04-07 00:56:53.926
false,false,4510,4254,256,595,00:00:32.000,2025-04-07 00:57:53.934
false,false,4506,4250,256,470,00:00:33.000,2025-04-07 00:55:53.921
false,false,4509,4253,256,563,00:00:32.000,2025-04-07 00:57:23.930
false,false,4511,4255,256,626,00:00:31.000,2025-04-07 00:58:23.938
false,false,4512,4256,256,659,00:00:33.000,2025-04-07 00:58:53.944
false,false,4514,4258,256,721,00:00:31.000,2025-04-07 00:59:53.956
false,false,4515,4259,256,754,00:00:33.000,2025-04-07 01:00:23.962
false,false,4516,4260,256,784,00:00:30.000,2025-04-07 01:00:53.968
false,false,4513,4257,256,690,00:00:31.000,2025-04-07 00:59:23.950
false,false,4517,4261,256,817,00:00:33.000,2025-04-07 01:01:23.973
false,false,4518,4262,256,849,00:00:32.000,2025-04-07 01:01:53.976
false,false,4522,4266,256,976,00:00:31.000,2025-04-07 01:03:53.995
false,false,4520,4264,256,912,00:00:30.000,2025-04-07 01:02:53.985
false,false,4519,4263,256,882,00:00:33.000,2025-04-07 01:02:23.981
false,false,4521,4265,256,945,00:00:33.000,2025-04-07 01:03:23.990
false,false,4523,4267,256,1008,00:00:32.000,2025-04-07 01:04:23.999
false,false,4524,4268,256,1039,00:00:31.000,2025-04-07 01:04:54.004
false,false,4525,4269,256,1069,00:00:30.000,2025-04-07 01:05:24.010
false,true,4525,4269,256,0,00:00:00.000,2025-04-07 01:05:54.015
false,false,3639,3430,209,182,00:00:30.000,2025-04-06 14:27:12.475
false,false,3640,3431,209,214,00:00:32.000,2025-04-06 14:27:42.486
false,false,3638,3429,209,152,00:00:31.000,2025-04-06 14:26:42.461
false,false,3636,3427,209,91,00:00:31.000,2025-04-06 14:25:42.433
false,true,3640,3431,209,0,00:00:00.000,2025-04-06 14:28:12.496
false,false,3637,3428,209,121,00:00:30.000,2025-04-06 14:26:12.447
false,true,3640,3431,209,0,00:00:00.000,2025-04-06 14:28:42.511
false,true,3640,3431,209,0,00:00:00.000,2025-04-06 14:30:12.543
false,true,3640,3431,209,0,00:00:00.000,2025-04-06 14:29:42.537
false,true,3640,3431,209,0,00:00:00.000,2025-04-06 14:30:42.556
false,true,3640,3431,209,0,00:00:00.000,2025-04-06 14:29:12.523
false,false,3641,3432,209,31,00:00:31.000,2025-04-06 14:31:12.569
false,true,3641,3432,209,0,00:00:00.000,2025-04-06 14:32:12.586
false,true,3641,3432,209,0,00:00:00.000,2025-04-06 14:32:42.597
false,true,3641,3432,209,0,00:00:00.000,2025-04-06 14:31:42.573
false,true,3641,3432,209,0,00:00:00.000,2025-04-06 14:33:42.619
false,true,3641,3432,209,0,00:00:00.000,2025-04-06 14:34:12.631
false,true,3642,3433,209,0,00:00:00.000,2025-04-06 14:35:12.652
false,true,3641,3432,209,0,00:00:00.000,2025-04-06 14:33:12.605
false,false,3642,3433,209,31,00:00:31.000,2025-04-06 14:34:42.642
false,true,3642,3433,209,0,00:00:00.000,2025-04-06 14:36:12.673
false,true,3642,3433,209,0,00:00:00.000,2025-04-06 14:35:42.661
false,true,3642,3433,209,0,00:00:00.000,2025-04-06 14:37:12.694
false,false,3643,3434,209,30,00:00:30.000,2025-04-06 14:38:12.720
false,true,3642,3433,209,0,00:00:00.000,2025-04-06 14:36:42.683
false,false,3645,3436,209,93,00:00:32.000,2025-04-06 14:39:12.737
false,true,3642,3433,209,0,00:00:00.000,2025-04-06 14:37:42.706
false,false,3644,3435,209,61,00:00:31.000,2025-04-06 14:38:42.726
false,false,3647,3438,209,156,00:00:31.000,2025-04-06 14:40:12.743
false,false,3646,3437,209,125,00:00:32.000,2025-04-06 14:39:42.740
false,false,3648,3439,209,189,00:00:33.000,2025-04-06 14:40:42.750
false,false,3650,3441,209,254,00:00:33.000,2025-04-06 14:41:42.770
false,false,3651,3441,210,287,00:00:33.000,2025-04-06 14:42:12.783
false,false,3649,3440,209,221,00:00:32.000,2025-04-06 14:41:12.763
false,false,3652,3442,210,317,00:00:30.000,2025-04-06 14:42:42.794
false,true,3652,3442,210,0,00:00:00.000,2025-04-06 14:43:12.807
false,true,3652,3442,210,0,00:00:00.000,2025-04-06 14:43:42.817
false,true,3652,3442,210,0,00:00:00.000,2025-04-06 14:44:12.829
false,true,3652,3442,210,0,00:00:00.000,2025-04-06 14:44:42.840
false,true,3652,3442,210,0,00:00:00.000,2025-04-06 14:45:42.865
false,false,3654,3444,210,63,00:00:32.000,2025-04-06 14:46:42.887
false,false,3653,3443,210,31,00:00:31.000,2025-04-06 14:46:12.880
false,false,3655,3445,210,96,00:00:33.000,2025-04-06 14:47:12.899
false,true,3652,3442,210,0,00:00:00.000,2025-04-06 14:45:12.852
false,false,3657,3447,210,159,00:00:33.000,2025-04-06 14:48:12.918
false,false,3656,3446,210,126,00:00:30.000,2025-04-06 14:47:42.911
false,false,3658,3448,210,192,00:00:33.000,2025-04-06 14:48:42.929
false,false,3659,3448,211,225,00:00:33.000,2025-04-06 14:49:12.943
false,false,3660,3448,212,257,00:00:32.000,2025-04-06 14:49:42.955
false,false,3661,3448,213,288,00:00:31.000,2025-04-06 14:50:12.964
false,false,3663,3450,213,351,00:00:30.000,2025-04-06 14:51:12.982
false,false,3662,3449,213,321,00:00:33.000,2025-04-06 14:50:42.970
false,false,3664,3451,213,384,00:00:33.000,2025-04-06 14:51:42.996
false,false,3665,3452,213,415,00:00:31.000,2025-04-06 14:52:13.010
false,true,3665,3452,213,0,00:00:00.000,2025-04-06 14:53:43.045
false,true,3665,3452,213,0,00:00:00.000,2025-04-06 14:53:13.033
false,true,3665,3452,213,0,00:00:00.000,2025-04-06 14:52:43.022
false,true,3665,3452,213,0,00:00:00.000,2025-04-06 14:54:13.052
false,false,3666,3453,213,30,00:00:30.000,2025-04-06 14:55:43.093
false,true,3665,3452,213,0,00:00:00.000,2025-04-06 14:54:43.065
false,false,3667,3454,213,60,00:00:30.000,2025-04-06 14:56:13.106
false,false,3668,3454,214,90,00:00:30.000,2025-04-06 14:56:43.116
false,true,3665,3452,213,0,00:00:00.000,2025-04-06 14:55:13.079
false,false,3669,3455,214,121,00:00:31.000,2025-04-06 14:57:13.126
false,false,3670,3456,214,152,00:00:31.000,2025-04-06 14:57:43.140
false,false,3671,3457,214,183,00:00:31.000,2025-04-06 14:58:13.154
false,false,3675,3461,214,310,00:00:32.000,2025-04-06 15:00:13.200
false,false,3674,3460,214,278,00:00:32.000,2025-04-06 14:59:43.191
false,false,3672,3458,214,213,00:00:30.000,2025-04-06 14:58:43.166
false,false,3673,3459,214,246,00:00:33.000,2025-04-06 14:59:13.177
false,true,3675,3461,214,0,00:00:00.000,2025-04-06 15:00:43.210
false,true,3675,3461,214,0,00:00:00.000,2025-04-06 15:03:13.255
false,true,3675,3461,214,0,00:00:00.000,2025-04-06 15:02:43.248
false,true,3675,3461,214,0,00:00:00.000,2025-04-06 15:01:43.232
false,true,3675,3461,214,0,00:00:00.000,2025-04-06 15:01:13.224
false,true,3675,3461,214,0,00:00:00.000,2025-04-06 15:02:13.243
false,false,3676,3462,214,32,00:00:32.000,2025-04-06 15:03:43.266
false,true,3676,3462,214,0,00:00:00.000,2025-04-06 15:06:13.330
false,true,3676,3462,214,0,00:00:00.000,2025-04-06 15:04:43.292
false,true,3676,3462,214,0,00:00:00.000,2025-04-06 15:04:13.279
false,true,3676,3462,214,0,00:00:00.000,2025-04-06 15:05:13.304
false,true,3676,3462,214,0,00:00:00.000,2025-04-06 15:06:43.344
false,true,3676,3462,214,0,00:00:00.000,2025-04-06 15:05:43.317
false,false,3677,3463,214,31,00:00:31.000,2025-04-06 15:07:13.358
false,false,3678,3463,215,62,00:00:31.000,2025-04-06 15:07:43.367
false,false,3680,3465,215,123,00:00:30.000,2025-04-06 15:08:43.388
false,false,3679,3464,215,93,00:00:31.000,2025-04-06 15:08:13.379
false,false,3682,3467,215,185,00:00:32.000,2025-04-06 15:09:43.409
false,false,3681,3466,215,153,00:00:30.000,2025-04-06 15:09:13.401
false,false,3684,3469,215,246,00:00:31.000,2025-04-06 15:10:43.431
false,false,3683,3468,215,215,00:00:30.000,2025-04-06 15:10:13.420
false,false,3686,3471,215,308,00:00:31.000,2025-04-06 15:11:43.451
false,false,3685,3470,215,277,00:00:31.000,2025-04-06 15:11:13.444
false,false,3689,3474,215,402,00:00:31.000,2025-04-06 15:13:13.487
false,false,3688,3473,215,371,00:00:30.000,2025-04-06 15:12:43.478
false,false,3687,3472,215,341,00:00:33.000,2025-04-06 15:12:13.464
false,false,3691,3476,215,466,00:00:31.000,2025-04-06 15:14:13.512
false,false,3690,3475,215,435,00:00:33.000,2025-04-06 15:13:43.500
false,true,3691,3476,215,0,00:00:00.000,2025-04-06 15:15:13.537
false,true,3691,3476,215,0,00:00:00.000,2025-04-06 15:15:43.547
false,true,3691,3476,215,0,00:00:00.000,2025-04-06 15:16:13.554
false,true,3691,3476,215,0,00:00:00.000,2025-04-06 15:14:43.525
false,true,3691,3476,215,0,00:00:00.000,2025-04-06 15:17:13.576
false,true,3691,3476,215,0,00:00:00.000,2025-04-06 15:17:43.590
false,true,3691,3476,215,0,00:00:00.000,2025-04-06 15:18:13.600
false,true,3691,3476,215,0,00:00:00.000,2025-04-06 15:16:43.564
false,true,3691,3476,215,0,00:00:00.000,2025-04-06 15:19:13.617
false,true,3691,3476,215,0,00:00:00.000,2025-04-06 15:18:43.610
false,true,3691,3476,215,0,00:00:00.000,2025-04-06 15:20:13.641
false,true,3691,3476,215,0,00:00:00.000,2025-04-06 15:19:43.628
false,false,3692,3477,215,32,00:00:32.000,2025-04-06 15:20:43.651
false,false,3695,3480,215,128,00:00:33.000,2025-04-06 15:22:13.685
false,false,3694,3479,215,95,00:00:32.000,2025-04-06 15:21:43.675
false,false,3693,3478,215,63,00:00:31.000,2025-04-06 15:21:13.662
false,false,3696,3481,215,160,00:00:32.000,2025-04-06 15:22:43.699
false,false,3698,3483,215,225,00:00:33.000,2025-04-06 15:23:43.723
false,false,3697,3482,215,192,00:00:32.000,2025-04-06 15:23:13.709
false,false,3700,3485,215,285,00:00:30.000,2025-04-06 15:24:43.744
false,false,3699,3484,215,255,00:00:30.000,2025-04-06 15:24:13.734
false,false,3701,3486,215,318,00:00:33.000,2025-04-06 15:25:13.755
false,false,3704,3489,215,413,00:00:30.000,2025-04-06 15:26:43.789
false,false,3703,3488,215,383,00:00:33.000,2025-04-06 15:26:13.778
false,false,3702,3487,215,350,00:00:32.000,2025-04-06 15:25:43.764
false,false,3705,3490,215,445,00:00:32.000,2025-04-06 15:27:13.801
false,false,3706,3491,215,477,00:00:32.000,2025-04-06 15:27:43.812
false,false,3707,3492,215,510,00:00:33.000,2025-04-06 15:28:13.820
false,false,3708,3493,215,542,00:00:32.000,2025-04-06 15:28:43.829
false,false,3709,3494,215,572,00:00:30.000,2025-04-06 15:29:13.841
false,false,3710,3495,215,605,00:00:33.000,2025-04-06 15:29:43.849
false,false,1433,1352,81,750,00:00:31.000,2025-04-05 13:03:37.115
false,false,1432,1351,81,719,00:00:30.000,2025-04-05 13:03:07.101
false,false,1430,1349,81,659,00:00:30.000,2025-04-05 13:02:07.074
false,false,1434,1352,82,782,00:00:32.000,2025-04-05 13:04:07.128
false,false,1435,1353,82,813,00:00:31.000,2025-04-05 13:04:37.140
false,false,1431,1350,81,689,00:00:30.000,2025-04-05 13:02:37.086
false,false,1436,1354,82,845,00:00:32.000,2025-04-05 13:05:07.151
false,false,1439,1357,82,941,00:00:33.000,2025-04-05 13:06:37.186
false,false,1437,1355,82,877,00:00:32.000,2025-04-05 13:05:37.162
false,false,1440,1358,82,974,00:00:33.000,2025-04-05 13:07:07.196
false,false,1438,1356,82,908,00:00:31.000,2025-04-05 13:06:07.173
false,false,1441,1359,82,1005,00:00:31.000,2025-04-05 13:07:37.210
false,false,1442,1360,82,1035,00:00:30.000,2025-04-05 13:08:07.221
false,true,1442,1360,82,0,00:00:00.000,2025-04-05 13:08:37.232
false,true,1442,1360,82,0,00:00:00.000,2025-04-05 13:10:07.275
false,true,1442,1360,82,0,00:00:00.000,2025-04-05 13:10:37.282
false,true,1442,1360,82,0,00:00:00.000,2025-04-05 13:09:07.245
false,true,1442,1360,82,0,00:00:00.000,2025-04-05 13:11:07.283
false,true,1442,1360,82,0,00:00:00.000,2025-04-05 13:09:37.261
false,false,1443,1361,82,31,00:00:31.000,2025-04-05 13:11:37.295
false,false,1444,1362,82,61,00:00:30.000,2025-04-05 13:12:07.307
false,false,1447,1365,82,154,00:00:33.000,2025-04-05 13:13:37.335
false,false,1445,1363,82,91,00:00:30.000,2025-04-05 13:12:37.315
false,false,1446,1364,82,121,00:00:30.000,2025-04-05 13:13:07.324
false,false,1448,1366,82,186,00:00:32.000,2025-04-05 13:14:07.341
false,false,1449,1367,82,216,00:00:30.000,2025-04-05 13:14:37.355
false,false,1451,1369,82,277,00:00:31.000,2025-04-05 13:15:37.382
false,false,1450,1368,82,246,00:00:30.000,2025-04-05 13:15:07.370
false,false,1452,1370,82,309,00:00:32.000,2025-04-05 13:16:07.394
false,false,1453,1371,82,340,00:00:31.000,2025-04-05 13:16:37.406
false,false,1456,1373,83,435,00:00:31.000,2025-04-05 13:18:07.436
false,false,1455,1373,82,404,00:00:32.000,2025-04-05 13:17:37.429
false,false,1454,1372,82,372,00:00:32.000,2025-04-05 13:17:07.415
false,false,1457,1374,83,467,00:00:32.000,2025-04-05 13:18:37.447
false,false,1459,1376,83,529,00:00:32.000,2025-04-05 13:19:37.465
false,false,1458,1375,83,497,00:00:30.000,2025-04-05 13:19:07.462
false,false,1460,1377,83,562,00:00:33.000,2025-04-05 13:20:07.476
false,false,1462,1379,83,625,00:00:32.000,2025-04-05 13:21:07.498
false,false,1461,1378,83,593,00:00:31.000,2025-04-05 13:20:37.483
false,false,1463,1380,83,658,00:00:33.000,2025-04-05 13:21:37.513
false,false,1465,1381,84,720,00:00:30.000,2025-04-05 13:22:37.536
false,false,1464,1380,84,690,00:00:32.000,2025-04-05 13:22:07.522
false,false,1466,1381,85,750,00:00:30.000,2025-04-05 13:23:07.546
false,false,1470,1385,85,881,00:00:33.000,2025-04-05 13:25:07.595
false,false,1469,1384,85,848,00:00:32.000,2025-04-05 13:24:37.580
false,false,1468,1383,85,816,00:00:33.000,2025-04-05 13:24:07.569
false,false,1467,1382,85,783,00:00:33.000,2025-04-05 13:23:37.555
false,false,1471,1386,85,914,00:00:33.000,2025-04-05 13:25:37.605
false,false,1473,1387,86,976,00:00:32.000,2025-04-05 13:26:37.629
false,false,1472,1387,85,944,00:00:30.000,2025-04-05 13:26:07.615
false,true,1473,1387,86,0,00:00:00.000,2025-04-05 13:27:37.658
false,true,1473,1387,86,0,00:00:00.000,2025-04-05 13:28:07.667
false,true,1473,1387,86,0,00:00:00.000,2025-04-05 13:27:07.645
false,true,1473,1387,86,0,00:00:00.000,2025-04-05 13:28:37.682
false,true,1473,1387,86,0,00:00:00.000,2025-04-05 13:29:07.684
false,false,1475,1389,86,62,00:00:32.000,2025-04-05 13:30:37.711
false,true,1473,1387,86,0,00:00:00.000,2025-04-05 13:29:37.696
false,false,1476,1390,86,94,00:00:32.000,2025-04-05 13:31:07.724
false,false,1474,1388,86,30,00:00:30.000,2025-04-05 13:30:07.697
false,false,1477,1391,86,124,00:00:30.000,2025-04-05 13:31:37.736
false,false,1479,1393,86,188,00:00:32.000,2025-04-05 13:32:37.754
false,false,1478,1392,86,156,00:00:32.000,2025-04-05 13:32:07.748
false,true,1479,1393,86,0,00:00:00.000,2025-04-05 13:33:07.755
false,true,1479,1393,86,0,00:00:00.000,2025-04-05 13:34:37.789
false,true,1479,1393,86,0,00:00:00.000,2025-04-05 13:34:07.781
false,true,1479,1393,86,0,00:00:00.000,2025-04-05 13:35:07.803
false,true,1479,1393,86,0,00:00:00.000,2025-04-05 13:35:37.817
false,false,1481,1395,86,62,00:00:31.000,2025-04-05 13:36:37.841
false,false,1480,1394,86,31,00:00:31.000,2025-04-05 13:36:07.831
false,false,1483,1397,86,128,00:00:33.000,2025-04-05 13:37:37.863
false,true,1479,1393,86,0,00:00:00.000,2025-04-05 13:33:37.766
false,false,1482,1396,86,95,00:00:33.000,2025-04-05 13:37:07.855
false,false,1484,1398,86,159,00:00:31.000,2025-04-05 13:38:07.874
false,false,1486,1400,86,225,00:00:33.000,2025-04-05 13:39:07.899
false,false,1488,1402,86,289,00:00:31.000,2025-04-05 13:40:07.922
false,false,1485,1399,86,192,00:00:33.000,2025-04-05 13:38:37.884
false,false,1489,1403,86,322,00:00:33.000,2025-04-05 13:40:37.930
false,false,1487,1401,86,258,00:00:33.000,2025-04-05 13:39:37.908
false,false,1490,1404,86,355,00:00:33.000,2025-04-05 13:41:07.945
false,false,1491,1405,86,388,00:00:33.000,2025-04-05 13:41:37.956
false,false,1492,1406,86,420,00:00:32.000,2025-04-05 13:42:07.971
false,false,1495,1409,86,512,00:00:32.000,2025-04-05 13:43:38.012
false,false,1493,1407,86,450,00:00:30.000,2025-04-05 13:42:37.985
false,false,1496,1410,86,542,00:00:30.000,2025-04-05 13:44:08.023
false,false,1494,1408,86,480,00:00:30.000,2025-04-05 13:43:07.998
false,true,1498,1412,86,0,00:00:00.000,2025-04-05 13:46:08.070
false,false,1498,1412,86,602,00:00:30.000,2025-04-05 13:45:08.046
false,true,1498,1412,86,0,00:00:00.000,2025-04-05 13:45:38.060
false,false,1497,1411,86,572,00:00:30.000,2025-04-05 13:44:38.035
false,true,1498,1412,86,0,00:00:00.000,2025-04-05 13:46:38.084
false,true,1498,1412,86,0,00:00:00.000,2025-04-05 13:47:08.099
false,true,1498,1412,86,0,00:00:00.000,2025-04-05 13:47:38.109
false,true,1498,1412,86,0,00:00:00.000,2025-04-05 13:48:08.119
false,false,1500,1414,86,60,00:00:30.000,2025-04-05 13:49:08.139
false,false,1499,1413,86,30,00:00:30.000,2025-04-05 13:48:38.126
false,false,1502,1416,86,122,00:00:31.000,2025-04-05 13:50:08.159
false,false,1501,1415,86,91,00:00:31.000,2025-04-05 13:49:38.146
false,false,1504,1418,86,188,00:00:33.000,2025-04-05 13:51:08.177
false,false,1503,1417,86,155,00:00:33.000,2025-04-05 13:50:38.166
false,false,1507,1421,86,282,00:00:33.000,2025-04-05 13:52:38.219
false,false,1508,1422,86,312,00:00:30.000,2025-04-05 13:53:08.229
false,false,1506,1420,86,249,00:00:31.000,2025-04-05 13:52:08.205
false,false,1505,1419,86,218,00:00:30.000,2025-04-05 13:51:38.193
false,false,1510,1424,86,374,00:00:31.000,2025-04-05 13:54:08.254
false,false,1509,1423,86,343,00:00:31.000,2025-04-05 13:53:38.243
false,false,1511,1424,87,407,00:00:33.000,2025-04-05 13:54:38.264
false,false,1512,1425,87,438,00:00:31.000,2025-04-05 13:55:08.278
false,true,1512,1425,87,0,00:00:00.000,2025-04-05 13:55:38.288
false,true,1512,1425,87,0,00:00:00.000,2025-04-05 13:56:38.316
false,true,1512,1425,87,0,00:00:00.000,2025-04-05 13:56:08.300
false,true,1512,1425,87,0,00:00:00.000,2025-04-05 13:57:08.329
false,true,1512,1425,87,0,00:00:00.000,2025-04-05 13:58:38.366
false,true,1512,1425,87,0,00:00:00.000,2025-04-05 13:57:38.341
false,true,1512,1425,87,0,00:00:00.000,2025-04-05 13:58:08.352
false,true,1512,1425,87,0,00:00:00.000,2025-04-05 13:59:08.380
false,true,1512,1425,87,0,00:00:00.000,2025-04-05 13:59:38.394
false,true,1512,1425,87,0,00:00:00.000,2025-04-05 14:00:38.419
false,true,1512,1425,87,0,00:00:00.000,2025-04-05 14:01:08.432
false,true,1512,1425,87,0,00:00:00.000,2025-04-05 14:01:38.441
false,true,1512,1425,87,0,00:00:00.000,2025-04-05 14:02:08.454
false,true,1512,1425,87,0,00:00:00.000,2025-04-05 14:02:38.462
false,true,1512,1425,87,0,00:00:00.000,2025-04-05 14:00:08.409
false,true,1512,1425,87,0,00:00:00.000,2025-04-05 14:03:08.474
false,true,1512,1425,87,0,00:00:00.000,2025-04-05 14:03:38.483
false,true,1512,1425,87,0,00:00:00.000,2025-04-05 14:04:08.497
false,false,1513,1426,87,32,00:00:32.000,2025-04-05 14:04:38.510
false,false,1514,1427,87,65,00:00:33.000,2025-04-05 14:05:08.519
false,false,1515,1428,87,98,00:00:33.000,2025-04-05 14:05:38.530
false,false,1516,1429,87,128,00:00:30.000,2025-04-05 14:06:08.543
false,false,1519,1432,87,222,00:00:31.000,2025-04-05 14:07:38.568
false,false,1518,1431,87,191,00:00:31.000,2025-04-05 14:07:08.561
false,false,1517,1430,87,160,00:00:32.000,2025-04-05 14:06:38.557
false,false,1520,1433,87,252,00:00:30.000,2025-04-05 14:08:08.580
false,false,1522,1435,87,313,00:00:31.000,2025-04-05 14:09:08.603
false,false,1521,1434,87,282,00:00:30.000,2025-04-05 14:08:38.593
false,false,1523,1436,87,345,00:00:32.000,2025-04-05 14:09:38.615
false,true,1604,1512,92,0,00:00:00.000,2025-04-05 15:12:40.029
false,false,1603,1511,92,767,00:00:32.000,2025-04-05 15:10:39.983
false,true,1604,1512,92,0,00:00:00.000,2025-04-05 15:12:10.019
false,true,1604,1512,92,0,00:00:00.000,2025-04-05 15:13:10.038
false,false,1604,1512,92,800,00:00:33.000,2025-04-05 15:11:09.992
false,true,1604,1512,92,0,00:00:00.000,2025-04-05 15:11:40.005
false,false,1607,1515,92,94,00:00:30.000,2025-04-05 15:15:40.098
false,false,1608,1516,92,126,00:00:32.000,2025-04-05 15:16:10.112
false,true,1604,1512,92,0,00:00:00.000,2025-04-05 15:14:10.061
false,false,1605,1513,92,32,00:00:32.000,2025-04-05 15:14:40.071
false,false,1606,1514,92,64,00:00:32.000,2025-04-05 15:15:10.082
false,true,1604,1512,92,0,00:00:00.000,2025-04-05 15:13:40.049
false,false,1610,1518,92,189,00:00:30.000,2025-04-05 15:17:10.135
false,false,1609,1517,92,159,00:00:33.000,2025-04-05 15:16:40.125
false,false,1612,1520,92,251,00:00:30.000,2025-04-05 15:18:10.157
false,false,1611,1519,92,221,00:00:32.000,2025-04-05 15:17:40.148
false,false,1615,1523,92,348,00:00:33.000,2025-04-05 15:19:40.187
false,false,1614,1522,92,315,00:00:33.000,2025-04-05 15:19:10.174
false,false,1616,1524,92,380,00:00:32.000,2025-04-05 15:20:10.196
false,false,1617,1525,92,413,00:00:33.000,2025-04-05 15:20:40.205
false,false,1618,1526,92,446,00:00:33.000,2025-04-05 15:21:10.218
false,false,1613,1521,92,282,00:00:31.000,2025-04-05 15:18:40.165
false,false,1620,1528,92,508,00:00:31.000,2025-04-05 15:22:10.241
false,false,1619,1527,92,477,00:00:31.000,2025-04-05 15:21:40.230
false,false,1622,1529,93,571,00:00:30.000,2025-04-05 15:23:10.270
false,false,1623,1530,93,604,00:00:33.000,2025-04-05 15:23:40.284
false,false,1621,1529,92,541,00:00:33.000,2025-04-05 15:22:40.255
false,false,1624,1531,93,635,00:00:31.000,2025-04-05 15:24:10.298
false,false,1626,1532,94,697,00:00:30.000,2025-04-05 15:25:10.319
false,false,1625,1531,94,667,00:00:32.000,2025-04-05 15:24:40.313
false,false,1628,1534,94,762,00:00:32.000,2025-04-05 15:26:10.339
false,false,1627,1533,94,730,00:00:33.000,2025-04-05 15:25:40.326
false,false,1629,1535,94,795,00:00:33.000,2025-04-05 15:26:40.353
false,false,1630,1536,94,826,00:00:31.000,2025-04-05 15:27:10.366
false,false,1631,1537,94,858,00:00:32.000,2025-04-05 15:27:40.381
false,false,1632,1538,94,888,00:00:30.000,2025-04-05 15:28:10.396
false,false,1633,1539,94,920,00:00:32.000,2025-04-05 15:28:40.404
false,false,1635,1541,94,983,00:00:30.000,2025-04-05 15:29:40.422
false,false,1634,1540,94,953,00:00:33.000,2025-04-05 15:29:10.418
false,false,1636,1542,94,1014,00:00:31.000,2025-04-05 15:30:10.436
false,false,1639,1545,94,1107,00:00:30.000,2025-04-05 15:31:40.469
false,false,1638,1544,94,1077,00:00:31.000,2025-04-05 15:31:10.459
false,false,1637,1543,94,1046,00:00:32.000,2025-04-05 15:30:40.450
false,false,1642,1548,94,1206,00:00:33.000,2025-04-05 15:33:10.505
false,false,1641,1547,94,1173,00:00:33.000,2025-04-05 15:32:40.494
false,false,1640,1546,94,1140,00:00:33.000,2025-04-05 15:32:10.480
false,false,1643,1549,94,1239,00:00:33.000,2025-04-05 15:33:40.518
false,false,1644,1550,94,1269,00:00:30.000,2025-04-05 15:34:10.529
false,false,1645,1551,94,1301,00:00:32.000,2025-04-05 15:34:40.538
false,false,1646,1552,94,1332,00:00:31.000,2025-04-05 15:35:10.553
false,false,1648,1554,94,1395,00:00:32.000,2025-04-05 15:36:10.582
false,false,1649,1555,94,1426,00:00:31.000,2025-04-05 15:36:40.596
false,false,1647,1553,94,1363,00:00:31.000,2025-04-05 15:35:40.566
false,false,1650,1556,94,1458,00:00:32.000,2025-04-05 15:37:10.612
false,false,1651,1557,94,1489,00:00:31.000,2025-04-05 15:37:40.626
false,false,1652,1558,94,1521,00:00:32.000,2025-04-05 15:38:10.636
false,false,1653,1559,94,1552,00:00:31.000,2025-04-05 15:38:40.647
false,false,1657,1563,94,1675,00:00:31.000,2025-04-05 15:40:40.688
false,false,1656,1562,94,1644,00:00:30.000,2025-04-05 15:40:10.672
false,false,1654,1560,94,1582,00:00:30.000,2025-04-05 15:39:10.655
false,false,1658,1564,94,1705,00:00:30.000,2025-04-05 15:41:10.692
false,true,1658,1564,94,0,00:00:00.000,2025-04-05 15:41:40.708
false,false,1655,1561,94,1614,00:00:32.000,2025-04-05 15:39:40.657
false,true,1658,1564,94,0,00:00:00.000,2025-04-05 15:42:40.736
false,true,1658,1564,94,0,00:00:00.000,2025-04-05 15:42:10.722
false,true,1658,1564,94,0,00:00:00.000,2025-04-05 15:44:10.780
false,true,1658,1564,94,0,00:00:00.000,2025-04-05 15:43:40.765
false,true,1658,1564,94,0,00:00:00.000,2025-04-05 15:43:10.750
false,false,1661,1566,95,94,00:00:30.000,2025-04-05 15:45:40.817
false,false,1660,1565,95,64,00:00:31.000,2025-04-05 15:45:10.805
false,false,1664,1569,95,189,00:00:32.000,2025-04-05 15:47:10.852
false,false,1662,1567,95,125,00:00:31.000,2025-04-05 15:46:10.831
false,false,1659,1565,94,33,00:00:33.000,2025-04-05 15:44:40.793
false,false,1663,1568,95,157,00:00:32.000,2025-04-05 15:46:40.841
false,false,1665,1570,95,220,00:00:31.000,2025-04-05 15:47:40.867
false,false,1666,1571,95,252,00:00:32.000,2025-04-05 15:48:10.882
false,false,1669,1574,95,349,00:00:32.000,2025-04-05 15:49:40.907
false,false,1668,1573,95,317,00:00:33.000,2025-04-05 15:49:10.898
false,false,1670,1575,95,381,00:00:32.000,2025-04-05 15:50:10.911
false,false,1667,1572,95,284,00:00:32.000,2025-04-05 15:48:40.890
false,false,1671,1576,95,411,00:00:30.000,2025-04-05 15:50:40.924
false,false,1673,1577,96,476,00:00:33.000,2025-04-05 15:51:40.942
false,false,1672,1577,95,443,00:00:32.000,2025-04-05 15:51:10.938
false,true,1675,1579,96,0,00:00:00.000,2025-04-05 15:53:40.980
false,false,1675,1579,96,541,00:00:32.000,2025-04-05 15:52:40.965
false,false,1674,1578,96,509,00:00:33.000,2025-04-05 15:52:10.955
false,true,1675,1579,96,0,00:00:00.000,2025-04-05 15:53:10.968
false,true,1675,1579,96,0,00:00:00.000,2025-04-05 15:54:41.002
false,true,1675,1579,96,0,00:00:00.000,2025-04-05 15:54:10.993
false,true,1675,1579,96,0,00:00:00.000,2025-04-05 15:55:11.015
false,false,1676,1580,96,33,00:00:33.000,2025-04-05 15:56:11.034
false,true,1675,1579,96,0,00:00:00.000,2025-04-05 15:55:41.019
false,false,1677,1581,96,65,00:00:32.000,2025-04-05 15:56:41.045
false,false,1678,1582,96,96,00:00:31.000,2025-04-05 15:57:11.057
false,false,1679,1583,96,127,00:00:31.000,2025-04-05 15:57:41.072
false,false,1680,1584,96,160,00:00:33.000,2025-04-05 15:58:11.085
false,true,1680,1584,96,0,00:00:00.000,2025-04-05 15:58:41.090
false,true,1680,1584,96,0,00:00:00.000,2025-04-05 15:59:11.102
false,true,1680,1584,96,0,00:00:00.000,2025-04-05 15:59:41.115
false,true,1680,1584,96,0,00:00:00.000,2025-04-05 16:00:11.126
false,true,1680,1584,96,0,00:00:00.000,2025-04-05 16:01:11.148
false,false,1681,1585,96,33,00:00:33.000,2025-04-05 16:01:41.159
false,true,1681,1585,96,0,00:00:00.000,2025-04-05 16:03:11.194
false,true,1681,1585,96,0,00:00:00.000,2025-04-05 16:02:11.172
false,true,1681,1585,96,0,00:00:00.000,2025-04-05 16:02:41.185
false,true,1680,1584,96,0,00:00:00.000,2025-04-05 16:00:41.138
false,true,1681,1585,96,0,00:00:00.000,2025-04-05 16:03:41.207
false,true,1681,1585,96,0,00:00:00.000,2025-04-05 16:04:11.217
false,true,1681,1585,96,0,00:00:00.000,2025-04-05 16:04:41.228
false,false,1683,1587,96,63,00:00:33.000,2025-04-05 16:05:41.248
false,false,1684,1588,96,95,00:00:32.000,2025-04-05 16:06:11.262
false,false,1682,1586,96,30,00:00:30.000,2025-04-05 16:05:11.237
false,false,1685,1589,96,125,00:00:30.000,2025-04-05 16:06:41.271
false,true,1685,1589,96,0,00:00:00.000,2025-04-05 16:07:11.282
false,true,1685,1589,96,0,00:00:00.000,2025-04-05 16:08:11.302
false,true,1685,1589,96,0,00:00:00.000,2025-04-05 16:07:41.290
false,true,1685,1589,96,0,00:00:00.000,2025-04-05 16:09:41.337
false,true,1685,1589,96,0,00:00:00.000,2025-04-05 16:09:11.322
false,true,1685,1589,96,0,00:00:00.000,2025-04-05 16:08:41.317
false,false,1686,1590,96,33,00:00:33.000,2025-04-05 16:10:11.347
false,false,1687,1591,96,65,00:00:32.000,2025-04-05 16:10:41.361
false,false,1688,1592,96,97,00:00:32.000,2025-04-05 16:11:11.369
false,false,1689,1592,97,128,00:00:31.000,2025-04-05 16:11:41.380
false,false,1690,1593,97,160,00:00:32.000,2025-04-05 16:12:11.380
false,false,1693,1596,97,255,00:00:32.000,2025-04-05 16:13:41.415
false,false,1692,1595,97,223,00:00:30.000,2025-04-05 16:13:11.409
false,false,1695,1598,97,319,00:00:31.000,2025-04-05 16:14:41.438
false,false,1694,1597,97,288,00:00:33.000,2025-04-05 16:14:11.424
false,false,1691,1594,97,193,00:00:33.000,2025-04-05 16:12:41.394
false,false,1696,1599,97,350,00:00:31.000,2025-04-05 16:15:11.443
false,false,1698,1601,97,411,00:00:31.000,2025-04-05 16:16:11.470
false,false,1697,1600,97,380,00:00:30.000,2025-04-05 16:15:41.457
false,false,1700,1603,97,475,00:00:32.000,2025-04-05 16:17:11.492
false,false,1699,1602,97,443,00:00:32.000,2025-04-05 16:16:41.485
false,true,1026,966,60,0,00:00:00.000,2025-04-05 08:48:01.326
false,true,1026,966,60,0,00:00:00.000,2025-04-05 08:48:31.340
false,false,1026,966,60,223,00:00:33.000,2025-04-05 08:46:01.278
false,true,1026,966,60,0,00:00:00.000,2025-04-05 08:47:31.317
false,true,1026,966,60,0,00:00:00.000,2025-04-05 08:46:31.290
false,true,1026,966,60,0,00:00:00.000,2025-04-05 08:47:01.306
false,false,1027,967,60,30,00:00:30.000,2025-04-05 08:49:31.359
false,false,1028,968,60,61,00:00:31.000,2025-04-05 08:50:01.371
false,false,1029,969,60,92,00:00:31.000,2025-04-05 08:50:31.384
false,true,1026,966,60,0,00:00:00.000,2025-04-05 08:49:01.350
false,false,1033,973,60,215,00:00:30.000,2025-04-05 08:52:31.427
false,false,1030,970,60,122,00:00:30.000,2025-04-05 08:51:01.394
false,false,1032,972,60,185,00:00:33.000,2025-04-05 08:52:01.416
false,false,1031,971,60,152,00:00:30.000,2025-04-05 08:51:31.407
false,false,1034,974,60,246,00:00:31.000,2025-04-05 08:53:01.442
false,false,1039,979,60,408,00:00:32.000,2025-04-05 08:55:31.499
false,false,1035,975,60,279,00:00:33.000,2025-04-05 08:53:31.450
false,false,1036,976,60,312,00:00:33.000,2025-04-05 08:54:01.461
false,false,1040,980,60,439,00:00:31.000,2025-04-05 08:56:01.504
false,false,1037,977,60,345,00:00:33.000,2025-04-05 08:54:31.473
false,false,1038,978,60,376,00:00:31.000,2025-04-05 08:55:01.487
false,false,1041,980,61,472,00:00:33.000,2025-04-05 08:56:31.516
false,false,1044,983,61,566,00:00:32.000,2025-04-05 08:58:01.553
false,false,1042,981,61,503,00:00:31.000,2025-04-05 08:57:01.529
false,false,1043,982,61,534,00:00:31.000,2025-04-05 08:57:31.539
false,false,1045,984,61,599,00:00:33.000,2025-04-05 08:58:31.566
false,true,1046,985,61,0,00:00:00.000,2025-04-05 09:00:01.602
false,true,1046,985,61,0,00:00:00.000,2025-04-05 08:59:31.593
false,false,1046,985,61,631,00:00:32.000,2025-04-05 08:59:01.578
false,true,1046,985,61,0,00:00:00.000,2025-04-05 09:01:31.641
false,true,1046,985,61,0,00:00:00.000,2025-04-05 09:00:31.616
false,true,1046,985,61,0,00:00:00.000,2025-04-05 09:01:01.630
false,false,1047,986,61,33,00:00:33.000,2025-04-05 09:02:31.657
false,true,1046,985,61,0,00:00:00.000,2025-04-05 09:02:01.646
false,false,1050,989,61,128,00:00:33.000,2025-04-05 09:04:01.692
false,false,1049,988,61,95,00:00:32.000,2025-04-05 09:03:31.679
false,false,1051,990,61,160,00:00:32.000,2025-04-05 09:04:31.707
false,false,1048,987,61,63,00:00:30.000,2025-04-05 09:03:01.671
false,false,1053,992,61,225,00:00:32.000,2025-04-05 09:05:31.726
false,false,1052,991,61,193,00:00:33.000,2025-04-05 09:05:01.712
false,false,1054,993,61,258,00:00:33.000,2025-04-05 09:06:01.740
false,false,1055,994,61,291,00:00:33.000,2025-04-05 09:06:31.752
false,false,1056,995,61,321,00:00:30.000,2025-04-05 09:07:01.762
false,false,1058,997,61,385,00:00:33.000,2025-04-05 09:08:01.785
false,false,1057,996,61,352,00:00:31.000,2025-04-05 09:07:31.776
false,true,1058,997,61,0,00:00:00.000,2025-04-05 09:08:31.792
false,true,1058,997,61,0,00:00:00.000,2025-04-05 09:09:01.798
false,true,1058,997,61,0,00:00:00.000,2025-04-05 09:11:01.851
false,true,1058,997,61,0,00:00:00.000,2025-04-05 09:10:31.837
false,true,1058,997,61,0,00:00:00.000,2025-04-05 09:10:01.825
false,true,1058,997,61,0,00:00:00.000,2025-04-05 09:09:31.812
false,false,1059,998,61,32,00:00:32.000,2025-04-05 09:11:31.863
false,false,1061,1000,61,92,00:00:30.000,2025-04-05 09:12:31.888
false,false,1062,1001,61,123,00:00:31.000,2025-04-05 09:13:01.901
false,false,1063,1002,61,154,00:00:31.000,2025-04-05 09:13:31.916
false,false,1060,999,61,62,00:00:30.000,2025-04-05 09:12:01.878
false,false,1064,1003,61,187,00:00:33.000,2025-04-05 09:14:01.928
false,false,1065,1004,61,218,00:00:31.000,2025-04-05 09:14:31.938
false,false,1067,1006,61,280,00:00:31.000,2025-04-05 09:15:31.951
false,false,1068,1007,61,313,00:00:33.000,2025-04-05 09:16:01.966
false,false,1070,1009,61,375,00:00:31.000,2025-04-05 09:17:01.987
false,false,1066,1005,61,249,00:00:31.000,2025-04-05 09:15:01.948
false,false,1069,1008,61,344,00:00:31.000,2025-04-05 09:16:31.973
false,false,1071,1010,61,407,00:00:32.000,2025-04-05 09:17:32.000
false,false,1072,1011,61,438,00:00:31.000,2025-04-05 09:18:02.010
false,false,1074,1013,61,502,00:00:31.000,2025-04-05 09:19:02.029
false,false,1073,1012,61,471,00:00:33.000,2025-04-05 09:18:32.019
false,false,1075,1014,61,532,00:00:30.000,2025-04-05 09:19:32.041
false,false,1076,1015,61,562,00:00:30.000,2025-04-05 09:20:02.053
false,false,1077,1016,61,593,00:00:31.000,2025-04-05 09:20:32.059
false,false,1078,1017,61,625,00:00:32.000,2025-04-05 09:21:02.071
false,false,1080,1019,61,690,00:00:32.000,2025-04-05 09:22:02.100
false,false,1079,1018,61,658,00:00:33.000,2025-04-05 09:21:32.085
false,false,1081,1020,61,723,00:00:33.000,2025-04-05 09:22:32.112
false,false,1085,1024,61,848,00:00:32.000,2025-04-05 09:24:32.162
false,false,1084,1023,61,816,00:00:30.000,2025-04-05 09:24:02.149
false,false,1083,1022,61,786,00:00:32.000,2025-04-05 09:23:32.137
false,false,1082,1021,61,754,00:00:31.000,2025-04-05 09:23:02.123
false,false,1086,1025,61,880,00:00:32.000,2025-04-05 09:25:02.174
false,false,1089,1028,61,974,00:00:30.000,2025-04-05 09:26:32.213
false,false,1091,1030,61,1034,00:00:30.000,2025-04-05 09:27:32.238
false,false,1088,1027,61,944,00:00:33.000,2025-04-05 09:26:02.199
false,false,1090,1029,61,1004,00:00:30.000,2025-04-05 09:27:02.224
false,false,1087,1026,61,911,00:00:31.000,2025-04-05 09:25:32.189
false,false,1092,1031,61,1065,00:00:31.000,2025-04-05 09:28:02.254
false,false,1094,1033,61,1126,00:00:30.000,2025-04-05 09:29:02.277
false,false,1093,1032,61,1096,00:00:31.000,2025-04-05 09:28:32.265
false,false,1097,1036,61,1224,00:00:32.000,2025-04-05 09:30:32.315
false,false,1096,1035,61,1192,00:00:33.000,2025-04-05 09:30:02.300
false,false,1095,1034,61,1159,00:00:33.000,2025-04-05 09:29:32.288
false,false,1098,1037,61,1257,00:00:33.000,2025-04-05 09:31:02.324
false,false,1099,1038,61,1290,00:00:33.000,2025-04-05 09:31:32.337
false,false,1102,1041,61,1383,00:00:30.000,2025-04-05 09:33:02.366
false,false,1100,1039,61,1322,00:00:32.000,2025-04-05 09:32:02.341
false,false,1101,1040,61,1353,00:00:31.000,2025-04-05 09:32:32.352
false,false,1104,1043,61,1446,00:00:30.000,2025-04-05 09:34:02.395
false,false,1103,1042,61,1416,00:00:33.000,2025-04-05 09:33:32.379
false,false,1105,1044,61,1478,00:00:32.000,2025-04-05 09:34:32.410
false,false,1106,1045,61,1508,00:00:30.000,2025-04-05 09:35:02.421
false,false,1109,1048,61,1602,00:00:30.000,2025-04-05 09:36:32.449
false,false,1107,1046,61,1540,00:00:32.000,2025-04-05 09:35:32.431
false,false,1108,1047,61,1572,00:00:32.000,2025-04-05 09:36:02.435
false,false,1112,1051,61,1696,00:00:31.000,2025-04-05 09:38:02.467
false,false,1110,1049,61,1635,00:00:33.000,2025-04-05 09:37:02.452
false,false,1111,1050,61,1665,00:00:30.000,2025-04-05 09:37:32.464
false,false,1113,1052,61,1729,00:00:33.000,2025-04-05 09:38:32.475
false,false,1115,1054,61,1793,00:00:32.000,2025-04-05 09:39:32.502
false,false,1114,1053,61,1761,00:00:32.000,2025-04-05 09:39:02.487
false,false,1118,1057,61,1888,00:00:32.000,2025-04-05 09:41:02.533
false,false,1117,1056,61,1856,00:00:33.000,2025-04-05 09:40:32.519
false,false,1116,1055,61,1823,00:00:30.000,2025-04-05 09:40:02.514
false,false,1120,1059,61,1953,00:00:33.000,2025-04-05 09:42:02.560
false,false,1121,1060,61,1985,00:00:32.000,2025-04-05 09:42:32.571
false,false,1119,1058,61,1920,00:00:32.000,2025-04-05 09:41:32.548
false,false,1124,1063,61,2079,00:00:32.000,2025-04-05 09:44:02.606
false,false,1122,1061,61,2016,00:00:31.000,2025-04-05 09:43:02.585
false,false,1123,1062,61,2047,00:00:31.000,2025-04-05 09:43:32.591
false,false,1127,1066,61,2176,00:00:33.000,2025-04-05 09:45:32.644
false,false,1125,1064,61,2110,00:00:31.000,2025-04-05 09:44:32.618
false,false,1126,1065,61,2143,00:00:33.000,2025-04-05 09:45:02.629
false,false,1128,1066,62,2209,00:00:33.000,2025-04-05 09:46:02.659
false,false,1129,1067,62,2242,00:00:33.000,2025-04-05 09:46:32.670
false,false,1130,1068,62,2275,00:00:33.000,2025-04-05 09:47:02.683
false,false,1132,1070,62,2340,00:00:32.000,2025-04-05 09:48:02.713
false,true,1132,1070,62,0,00:00:00.000,2025-04-05 09:48:32.729
false,true,1132,1070,62,0,00:00:00.000,2025-04-05 09:49:32.752
false,false,1131,1069,62,2308,00:00:33.000,2025-04-05 09:47:32.699
false,true,1132,1070,62,0,00:00:00.000,2025-04-05 09:49:02.741
false,false,4278,4029,249,530,00:00:30.000,2025-04-06 21:55:51.623
false,false,4276,4028,248,469,00:00:31.000,2025-04-06 21:54:51.608
false,false,4277,4028,249,500,00:00:31.000,2025-04-06 21:55:21.617
false,false,4279,4030,249,561,00:00:31.000,2025-04-06 21:56:21.628
false,false,4275,4028,247,438,00:00:30.000,2025-04-06 21:54:21.597
false,false,4274,4027,247,408,00:00:31.000,2025-04-06 21:53:51.587
false,false,4281,4032,249,624,00:00:30.000,2025-04-06 21:57:21.644
false,false,4280,4031,249,594,00:00:33.000,2025-04-06 21:56:51.635
false,false,4282,4033,249,657,00:00:33.000,2025-04-06 21:57:51.652
false,true,4282,4033,249,0,00:00:00.000,2025-04-06 21:58:21.656
false,true,4282,4033,249,0,00:00:00.000,2025-04-06 21:58:51.661
false,true,4282,4033,249,0,00:00:00.000,2025-04-06 21:59:51.678
false,true,4282,4033,249,0,00:00:00.000,2025-04-06 21:59:21.668
false,true,4282,4033,249,0,00:00:00.000,2025-04-06 22:00:21.689
false,true,4282,4033,249,0,00:00:00.000,2025-04-06 22:00:51.695
false,true,4282,4033,249,0,00:00:00.000,2025-04-06 22:01:51.713
false,true,4282,4033,249,0,00:00:00.000,2025-04-06 22:02:21.720
false,true,4282,4033,249,0,00:00:00.000,2025-04-06 22:01:21.704
false,true,4282,4033,249,0,00:00:00.000,2025-04-06 22:03:21.740
false,true,4282,4033,249,0,00:00:00.000,2025-04-06 22:02:51.730
false,true,4282,4033,249,0,00:00:00.000,2025-04-06 22:03:51.743
false,false,4284,4035,249,61,00:00:30.000,2025-04-06 22:04:51.762
false,false,4285,4036,249,91,00:00:30.000,2025-04-06 22:05:21.769
false,false,4287,4038,249,155,00:00:33.000,2025-04-06 22:06:21.787
false,false,4288,4039,249,185,00:00:30.000,2025-04-06 22:06:51.793
false,false,4286,4037,249,122,00:00:31.000,2025-04-06 22:05:51.777
false,false,4283,4034,249,31,00:00:31.000,2025-04-06 22:04:21.751
false,false,4290,4041,249,250,00:00:32.000,2025-04-06 22:07:51.814
false,false,4292,4043,249,310,00:00:30.000,2025-04-06 22:08:51.829
false,false,4291,4042,249,280,00:00:30.000,2025-04-06 22:08:21.822
false,false,4294,4045,249,376,00:00:33.000,2025-04-06 22:09:51.848
false,false,4289,4040,249,218,00:00:33.000,2025-04-06 22:07:21.803
false,false,4293,4044,249,343,00:00:33.000,2025-04-06 22:09:21.838
false,false,4295,4046,249,409,00:00:33.000,2025-04-06 22:10:21.857
false,false,4296,4047,249,441,00:00:32.000,2025-04-06 22:10:51.866
false,false,4298,4049,249,505,00:00:32.000,2025-04-06 22:11:51.879
false,false,4297,4048,249,473,00:00:32.000,2025-04-06 22:11:21.873
false,false,4300,4051,249,567,00:00:30.000,2025-04-06 22:12:51.896
false,false,4299,4050,249,537,00:00:32.000,2025-04-06 22:12:21.887
false,false,4302,4053,249,628,00:00:30.000,2025-04-06 22:13:51.911
false,false,4301,4052,249,598,00:00:31.000,2025-04-06 22:13:21.902
false,false,4304,4055,249,693,00:00:32.000,2025-04-06 22:14:51.925
false,false,4303,4054,249,661,00:00:33.000,2025-04-06 22:14:21.917
false,false,4306,4057,249,756,00:00:32.000,2025-04-06 22:15:51.943
false,false,4305,4056,249,724,00:00:31.000,2025-04-06 22:15:21.935
false,false,4308,4059,249,819,00:00:33.000,2025-04-06 22:16:51.959
false,false,4309,4060,249,849,00:00:30.000,2025-04-06 22:17:21.968
false,false,4307,4058,249,786,00:00:30.000,2025-04-06 22:16:21.950
false,false,4311,4062,249,913,00:00:33.000,2025-04-06 22:18:21.983
false,false,4310,4061,249,880,00:00:31.000,2025-04-06 22:17:51.977
false,false,4313,4063,250,976,00:00:33.000,2025-04-06 22:19:22.002
false,false,4312,4063,249,943,00:00:30.000,2025-04-06 22:18:51.993
false,false,4314,4064,250,1008,00:00:32.000,2025-04-06 22:19:52.012
false,false,4317,4067,250,1105,00:00:33.000,2025-04-06 22:21:22.035
false,false,4315,4065,250,1040,00:00:32.000,2025-04-06 22:20:22.019
false,false,4316,4066,250,1072,00:00:32.000,2025-04-06 22:20:52.026
false,false,4318,4068,250,1136,00:00:31.000,2025-04-06 22:21:52.046
false,false,4319,4069,250,1166,00:00:30.000,2025-04-06 22:22:22.050
false,false,4320,4070,250,1199,00:00:33.000,2025-04-06 22:22:52.060
false,false,4321,4071,250,1232,00:00:33.000,2025-04-06 22:23:22.065
false,false,4322,4072,250,1262,00:00:30.000,2025-04-06 22:23:52.074
false,false,4323,4073,250,1295,00:00:33.000,2025-04-06 22:24:22.076
false,true,4323,4073,250,0,00:00:00.000,2025-04-06 22:24:52.086
false,true,4323,4073,250,0,00:00:00.000,2025-04-06 22:25:22.093
false,true,4323,4073,250,0,00:00:00.000,2025-04-06 22:26:22.108
false,true,4323,4073,250,0,00:00:00.000,2025-04-06 22:25:52.101
false,false,4324,4073,251,30,00:00:30.000,2025-04-06 22:27:52.131
false,false,4325,4074,251,63,00:00:33.000,2025-04-06 22:28:22.140
false,true,4323,4073,250,0,00:00:00.000,2025-04-06 22:26:52.115
false,true,4323,4073,250,0,00:00:00.000,2025-04-06 22:27:22.121
false,false,4326,4075,251,95,00:00:32.000,2025-04-06 22:28:52.146
false,true,4326,4075,251,0,00:00:00.000,2025-04-06 22:29:52.160
false,true,4326,4075,251,0,00:00:00.000,2025-04-06 22:30:22.168
false,true,4326,4075,251,0,00:00:00.000,2025-04-06 22:29:22.156
false,true,4326,4075,251,0,00:00:00.000,2025-04-06 22:31:22.180
false,true,4326,4075,251,0,00:00:00.000,2025-04-06 22:30:52.175
false,true,4326,4075,251,0,00:00:00.000,2025-04-06 22:31:52.190
false,false,4327,4076,251,32,00:00:32.000,2025-04-06 22:32:22.200
false,false,4329,4078,251,93,00:00:30.000,2025-04-06 22:33:22.209
false,false,4330,4079,251,124,00:00:31.000,2025-04-06 22:33:52.216
false,false,4328,4077,251,63,00:00:31.000,2025-04-06 22:32:52.203
false,false,4333,4082,251,215,00:00:31.000,2025-04-06 22:35:22.234
false,false,4331,4080,251,154,00:00:30.000,2025-04-06 22:34:22.223
false,false,4332,4081,251,184,00:00:30.000,2025-04-06 22:34:52.228
false,false,4336,4085,251,311,00:00:31.000,2025-04-06 22:36:52.258
false,false,4335,4084,251,280,00:00:32.000,2025-04-06 22:36:22.250
false,false,4334,4083,251,248,00:00:33.000,2025-04-06 22:35:52.243
false,false,4338,4087,251,373,00:00:31.000,2025-04-06 22:37:52.272
false,false,4337,4086,251,342,00:00:31.000,2025-04-06 22:37:22.267
false,true,4340,4089,251,0,00:00:00.000,2025-04-06 22:39:22.296
false,false,4339,4088,251,404,00:00:31.000,2025-04-06 22:38:22.282
false,false,4340,4089,251,435,00:00:31.000,2025-04-06 22:38:52.287
false,true,4340,4089,251,0,00:00:00.000,2025-04-06 22:39:52.300
false,true,4340,4089,251,0,00:00:00.000,2025-04-06 22:40:22.310
false,true,4340,4089,251,0,00:00:00.000,2025-04-06 22:41:22.320
false,true,4340,4089,251,0,00:00:00.000,2025-04-06 22:40:52.311
false,true,4340,4089,251,0,00:00:00.000,2025-04-06 22:41:52.330
false,false,4341,4090,251,31,00:00:31.000,2025-04-06 22:42:22.337
false,false,4344,4093,251,130,00:00:33.000,2025-04-06 22:43:52.365
false,false,4342,4091,251,64,00:00:33.000,2025-04-06 22:42:52.346
false,false,4345,4094,251,163,00:00:33.000,2025-04-06 22:44:22.373
false,false,4343,4092,251,97,00:00:33.000,2025-04-06 22:43:22.355
false,true,4345,4094,251,0,00:00:00.000,2025-04-06 22:45:22.385
false,true,4345,4094,251,0,00:00:00.000,2025-04-06 22:44:52.380
false,true,4345,4094,251,0,00:00:00.000,2025-04-06 22:47:22.407
false,true,4345,4094,251,0,00:00:00.000,2025-04-06 22:46:22.391
false,false,4347,4096,251,61,00:00:30.000,2025-04-06 22:48:22.422
false,false,4346,4095,251,31,00:00:31.000,2025-04-06 22:47:52.413
false,true,4345,4094,251,0,00:00:00.000,2025-04-06 22:45:52.386
false,true,4345,4094,251,0,00:00:00.000,2025-04-06 22:46:52.398
false,false,4348,4097,251,93,00:00:32.000,2025-04-06 22:48:52.430
false,false,4349,4098,251,126,00:00:33.000,2025-04-06 22:49:22.437
false,false,4350,4099,251,159,00:00:33.000,2025-04-06 22:49:52.445
false,false,4352,4101,251,224,00:00:32.000,2025-04-06 22:50:52.464
false,false,4351,4100,251,192,00:00:33.000,2025-04-06 22:50:22.454
false,false,4354,4103,251,288,00:00:33.000,2025-04-06 22:51:52.470
false,false,4355,4104,251,321,00:00:33.000,2025-04-06 22:52:22.478
false,false,4353,4102,251,255,00:00:31.000,2025-04-06 22:51:22.466
false,false,4357,4106,251,384,00:00:33.000,2025-04-06 22:53:22.493
false,false,4356,4105,251,351,00:00:30.000,2025-04-06 22:52:52.484
false,false,4358,4107,251,414,00:00:30.000,2025-04-06 22:53:52.499
false,false,4359,4108,251,445,00:00:31.000,2025-04-06 22:54:22.507
false,false,4363,4112,251,567,00:00:30.000,2025-04-06 22:56:22.539
false,false,4362,4111,251,537,00:00:31.000,2025-04-06 22:55:52.529
false,false,4360,4109,251,476,00:00:31.000,2025-04-06 22:54:52.515
false,false,4361,4110,251,506,00:00:30.000,2025-04-06 22:55:22.521
false,false,4364,4113,251,599,00:00:32.000,2025-04-06 22:56:52.542
false,false,4365,4114,251,630,00:00:31.000,2025-04-06 22:57:22.547
false,false,1235,1163,72,284,00:00:33.000,2025-04-05 10:54:34.170
false,false,1238,1166,72,379,00:00:33.000,2025-04-05 10:56:04.205
false,false,1234,1162,72,251,00:00:30.000,2025-04-05 10:54:04.159
false,false,1237,1165,72,346,00:00:31.000,2025-04-05 10:55:34.193
false,false,1236,1164,72,315,00:00:31.000,2025-04-05 10:55:04.182
false,false,1239,1167,72,411,00:00:32.000,2025-04-05 10:56:34.217
false,false,1241,1169,72,474,00:00:31.000,2025-04-05 10:57:34.232
false,false,1240,1168,72,443,00:00:32.000,2025-04-05 10:57:04.226
false,false,1243,1171,72,536,00:00:32.000,2025-04-05 10:58:34.260
false,false,1244,1172,72,566,00:00:30.000,2025-04-05 10:59:04.275
false,false,1242,1170,72,504,00:00:30.000,2025-04-05 10:58:04.247
false,false,1245,1173,72,597,00:00:31.000,2025-04-05 10:59:34.288
false,false,1248,1176,72,690,00:00:30.000,2025-04-05 11:01:04.316
false,false,1246,1174,72,627,00:00:30.000,2025-04-05 11:00:04.291
false,false,1247,1175,72,660,00:00:33.000,2025-04-05 11:00:34.302
false,false,1250,1177,73,755,00:00:32.000,2025-04-05 11:02:04.336
false,false,1249,1177,72,723,00:00:33.000,2025-04-05 11:01:34.325
false,false,1252,1179,73,817,00:00:32.000,2025-04-05 11:03:04.366
false,false,1251,1178,73,785,00:00:30.000,2025-04-05 11:02:34.351
false,false,1255,1181,74,915,00:00:33.000,2025-04-05 11:04:34.401
false,false,1256,1182,74,945,00:00:30.000,2025-04-05 11:05:04.410
false,false,1254,1181,73,882,00:00:32.000,2025-04-05 11:04:04.391
false,false,1257,1183,74,977,00:00:32.000,2025-04-05 11:05:34.422
false,false,1259,1185,74,1040,00:00:30.000,2025-04-05 11:06:34.442
false,false,1253,1180,73,850,00:00:33.000,2025-04-05 11:03:34.377
false,false,1258,1184,74,1010,00:00:33.000,2025-04-05 11:06:04.434
false,false,1260,1186,74,1070,00:00:30.000,2025-04-05 11:07:04.455
false,false,1261,1187,74,1103,00:00:33.000,2025-04-05 11:07:34.467
false,false,1263,1189,74,1163,00:00:30.000,2025-04-05 11:08:34.490
false,false,1265,1190,75,1228,00:00:32.000,2025-04-05 11:09:34.503
false,false,1262,1188,74,1133,00:00:30.000,2025-04-05 11:08:04.481
false,false,1264,1190,74,1196,00:00:33.000,2025-04-05 11:09:04.491
false,false,1266,1191,75,1258,00:00:30.000,2025-04-05 11:10:04.514
false,false,1267,1192,75,1291,00:00:33.000,2025-04-05 11:10:34.527
false,false,1269,1194,75,1355,00:00:31.000,2025-04-05 11:11:34.544
false,false,1271,1196,75,1420,00:00:33.000,2025-04-05 11:12:34.567
false,false,1268,1193,75,1324,00:00:33.000,2025-04-05 11:11:04.540
false,false,1270,1195,75,1387,00:00:32.000,2025-04-05 11:12:04.554
false,false,1273,1198,75,1482,00:00:32.000,2025-04-05 11:13:34.592
false,false,1275,1200,75,1544,00:00:30.000,2025-04-05 11:14:34.615
false,false,1272,1197,75,1450,00:00:30.000,2025-04-05 11:13:04.578
false,false,1274,1199,75,1514,00:00:32.000,2025-04-05 11:14:04.606
false,false,1277,1202,75,1606,00:00:32.000,2025-04-05 11:15:34.643
false,false,1276,1201,75,1574,00:00:30.000,2025-04-05 11:15:04.629
false,false,1278,1203,75,1636,00:00:30.000,2025-04-05 11:16:04.656
false,false,1279,1204,75,1666,00:00:30.000,2025-04-05 11:16:34.669
false,false,1280,1205,75,1698,00:00:32.000,2025-04-05 11:17:04.679
false,false,1281,1206,75,1729,00:00:31.000,2025-04-05 11:17:34.691
false,false,1282,1207,75,1760,00:00:31.000,2025-04-05 11:18:04.705
false,false,1283,1208,75,1791,00:00:31.000,2025-04-05 11:18:34.714
false,true,1283,1208,75,0,00:00:00.000,2025-04-05 11:19:04.727
false,true,1283,1208,75,0,00:00:00.000,2025-04-05 11:19:34.741
false,true,1283,1208,75,0,00:00:00.000,2025-04-05 11:20:04.756
false,false,1284,1209,75,30,00:00:30.000,2025-04-05 11:22:04.806
false,true,1283,1208,75,0,00:00:00.000,2025-04-05 11:21:34.797
false,true,1283,1208,75,0,00:00:00.000,2025-04-05 11:21:04.782
false,true,1283,1208,75,0,00:00:00.000,2025-04-05 11:20:34.770
false,false,1285,1210,75,63,00:00:33.000,2025-04-05 11:22:34.815
false,false,1287,1212,75,125,00:00:31.000,2025-04-05 11:23:34.843
false,false,1289,1213,76,188,00:00:32.000,2025-04-05 11:24:34.871
false,false,1286,1211,75,94,00:00:31.000,2025-04-05 11:23:04.831
false,false,1288,1213,75,156,00:00:31.000,2025-04-05 11:24:04.858
false,true,1290,1214,76,0,00:00:00.000,2025-04-05 11:26:04.882
false,false,1290,1214,76,218,00:00:30.000,2025-04-05 11:25:04.876
false,true,1290,1214,76,0,00:00:00.000,2025-04-05 11:25:34.877
false,true,1290,1214,76,0,00:00:00.000,2025-04-05 11:26:34.893
false,true,1290,1214,76,0,00:00:00.000,2025-04-05 11:27:04.898
false,true,1290,1214,76,0,00:00:00.000,2025-04-05 11:27:34.907
false,true,1290,1214,76,0,00:00:00.000,2025-04-05 11:28:04.915
false,false,1292,1216,76,62,00:00:32.000,2025-04-05 11:29:04.943
false,false,1291,1215,76,30,00:00:30.000,2025-04-05 11:28:34.929
false,false,1293,1217,76,92,00:00:30.000,2025-04-05 11:29:34.955
false,false,1294,1218,76,124,00:00:32.000,2025-04-05 11:30:04.969
false,false,1295,1219,76,155,00:00:31.000,2025-04-05 11:30:34.984
false,false,1297,1221,76,217,00:00:30.000,2025-04-05 11:31:35.006
false,false,1296,1220,76,187,00:00:32.000,2025-04-05 11:31:04.998
false,false,1298,1222,76,250,00:00:33.000,2025-04-05 11:32:05.020
false,false,1299,1223,76,281,00:00:31.000,2025-04-05 11:32:35.023
false,false,1301,1225,76,342,00:00:30.000,2025-04-05 11:33:35.045
false,false,1300,1224,76,312,00:00:31.000,2025-04-05 11:33:05.036
false,false,1302,1226,76,374,00:00:32.000,2025-04-05 11:34:05.056
false,true,1302,1226,76,0,00:00:00.000,2025-04-05 11:34:35.067
false,true,1302,1226,76,0,00:00:00.000,2025-04-05 11:35:05.079
false,true,1302,1226,76,0,00:00:00.000,2025-04-05 11:36:05.100
false,true,1302,1226,76,0,00:00:00.000,2025-04-05 11:35:35.094
false,true,1302,1226,76,0,00:00:00.000,2025-04-05 11:37:05.126
false,true,1302,1226,76,0,00:00:00.000,2025-04-05 11:36:35.115
false,false,1304,1228,76,63,00:00:30.000,2025-04-05 11:38:05.145
false,false,1303,1227,76,33,00:00:33.000,2025-04-05 11:37:35.132
false,false,1306,1230,76,125,00:00:32.000,2025-04-05 11:39:05.174
false,false,1308,1231,77,190,00:00:32.000,2025-04-05 11:40:05.193
false,false,1307,1230,77,158,00:00:33.000,2025-04-05 11:39:35.186
false,false,1305,1229,76,93,00:00:30.000,2025-04-05 11:38:35.160
false,false,1310,1233,77,254,00:00:33.000,2025-04-05 11:41:05.219
false,false,1309,1232,77,221,00:00:31.000,2025-04-05 11:40:35.207
false,false,1311,1234,77,284,00:00:30.000,2025-04-05 11:41:35.232
false,false,1312,1235,77,314,00:00:30.000,2025-04-05 11:42:05.247
false,false,1315,1237,78,408,00:00:32.000,2025-04-05 11:43:35.280
false,false,1316,1238,78,440,00:00:32.000,2025-04-05 11:44:05.292
false,false,1313,1235,78,345,00:00:31.000,2025-04-05 11:42:35.260
false,false,1314,1236,78,376,00:00:31.000,2025-04-05 11:43:05.271
false,false,1317,1239,78,473,00:00:33.000,2025-04-05 11:44:35.305
false,false,1320,1242,78,566,00:00:31.000,2025-04-05 11:46:05.337
false,false,1319,1241,78,535,00:00:32.000,2025-04-05 11:45:35.327
false,false,1318,1240,78,503,00:00:30.000,2025-04-05 11:45:05.315
false,false,1321,1243,78,596,00:00:30.000,2025-04-05 11:46:35.350
false,false,1322,1244,78,626,00:00:30.000,2025-04-05 11:47:05.365
false,false,1324,1246,78,691,00:00:33.000,2025-04-05 11:48:05.387
false,true,1324,1246,78,0,00:00:00.000,2025-04-05 11:48:35.389
false,false,1323,1245,78,658,00:00:32.000,2025-04-05 11:47:35.371
false,true,1324,1246,78,0,00:00:00.000,2025-04-05 11:49:05.403
false,true,1324,1246,78,0,00:00:00.000,2025-04-05 11:49:35.418
false,true,1324,1246,78,0,00:00:00.000,2025-04-05 11:50:05.427
false,true,1324,1246,78,0,00:00:00.000,2025-04-05 11:50:35.442
false,false,1326,1248,78,63,00:00:30.000,2025-04-05 11:52:05.472
false,true,1324,1246,78,0,00:00:00.000,2025-04-05 11:51:05.457
false,false,1325,1247,78,33,00:00:33.000,2025-04-05 11:51:35.460
false,false,1327,1249,78,93,00:00:30.000,2025-04-05 11:52:35.483
false,false,1330,1252,78,183,00:00:30.000,2025-04-05 11:54:05.521
false,false,1329,1251,78,153,00:00:30.000,2025-04-05 11:53:35.511
false,false,1331,1253,78,213,00:00:30.000,2025-04-05 11:54:35.532
false,false,1328,1250,78,123,00:00:30.000,2025-04-05 11:53:05.495
false,false,1332,1254,78,246,00:00:33.000,2025-04-05 11:55:05.538
false,false,1333,1255,78,277,00:00:31.000,2025-04-05 11:55:35.549
false,false,1334,1256,78,309,00:00:32.000,2025-04-05 11:56:05.563
false,true,1334,1256,78,0,00:00:00.000,2025-04-05 11:56:35.577
false,true,1334,1256,78,0,00:00:00.000,2025-04-05 11:57:05.583
false,true,1334,1256,78,0,00:00:00.000,2025-04-05 11:58:05.602
false,true,1334,1256,78,0,00:00:00.000,2025-04-05 11:57:35.588
false,true,1334,1256,78,0,00:00:00.000,2025-04-05 11:58:35.617
false,true,1334,1256,78,0,00:00:00.000,2025-04-05 11:59:05.631
false,false,1336,1258,78,66,00:00:33.000,2025-04-05 12:00:05.656
false,false,1335,1257,78,33,00:00:33.000,2025-04-05 11:59:35.642
false,false,1337,1258,79,97,00:00:31.000,2025-04-05 12:00:35.670
false,false,1338,1259,79,129,00:00:32.000,2025-04-05 12:01:05.675
false,false,1339,1260,79,160,00:00:31.000,2025-04-05 12:01:35.681
false,false,3019,2848,171,160,00:00:32.000,2025-04-06 07:08:02.317
false,false,3015,2844,171,33,00:00:33.000,2025-04-06 07:06:02.258
false,false,3017,2846,171,95,00:00:31.000,2025-04-06 07:07:02.286
false,false,3018,2847,171,128,00:00:33.000,2025-04-06 07:07:32.301
false,false,3016,2845,171,64,00:00:31.000,2025-04-06 07:06:32.271
false,false,3020,2848,172,193,00:00:33.000,2025-04-06 07:08:32.330
false,false,3023,2850,173,286,00:00:30.000,2025-04-06 07:10:02.364
false,false,3022,2850,172,256,00:00:33.000,2025-04-06 07:09:32.352
false,false,3025,2852,173,348,00:00:32.000,2025-04-06 07:11:02.394
false,false,3021,2849,172,223,00:00:30.000,2025-04-06 07:09:02.341
false,false,3024,2851,173,316,00:00:30.000,2025-04-06 07:10:32.379
false,false,3026,2853,173,381,00:00:33.000,2025-04-06 07:11:32.406
false,false,3028,2855,173,443,00:00:32.000,2025-04-06 07:12:32.432
false,false,3027,2854,173,411,00:00:30.000,2025-04-06 07:12:02.418
false,false,3029,2856,173,475,00:00:32.000,2025-04-06 07:13:02.447
false,false,3030,2857,173,507,00:00:32.000,2025-04-06 07:13:32.452
false,false,3032,2859,173,572,00:00:33.000,2025-04-06 07:14:32.474
false,false,3031,2858,173,539,00:00:32.000,2025-04-06 07:14:02.462
false,false,3033,2860,173,603,00:00:31.000,2025-04-06 07:15:02.486
false,false,3034,2861,173,634,00:00:31.000,2025-04-06 07:15:32.498
false,false,3036,2863,173,698,00:00:32.000,2025-04-06 07:16:32.522
false,false,3035,2862,173,666,00:00:32.000,2025-04-06 07:16:02.511
false,false,3038,2865,173,761,00:00:30.000,2025-04-06 07:17:32.553
false,false,3037,2864,173,731,00:00:33.000,2025-04-06 07:17:02.537
false,false,3040,2867,173,824,00:00:30.000,2025-04-06 07:18:32.565
false,false,3039,2866,173,794,00:00:33.000,2025-04-06 07:18:02.559
false,false,3041,2868,173,854,00:00:30.000,2025-04-06 07:19:02.577
false,false,3042,2869,173,886,00:00:32.000,2025-04-06 07:19:32.585
false,false,3047,2874,173,1045,00:00:30.000,2025-04-06 07:22:02.647
false,false,3044,2871,173,951,00:00:33.000,2025-04-06 07:20:32.606
false,false,3045,2872,173,983,00:00:32.000,2025-04-06 07:21:02.618
false,false,3048,2874,174,1078,00:00:33.000,2025-04-06 07:22:32.658
false,false,3043,2870,173,918,00:00:32.000,2025-04-06 07:20:02.596
false,false,3046,2873,173,1015,00:00:32.000,2025-04-06 07:21:32.633
false,false,3052,2878,174,1206,00:00:33.000,2025-04-06 07:24:32.702
false,false,3051,2877,174,1173,00:00:32.000,2025-04-06 07:24:02.690
false,false,3049,2875,174,1108,00:00:30.000,2025-04-06 07:23:02.672
false,true,3053,2879,174,0,00:00:00.000,2025-04-06 07:25:32.726
false,false,3050,2876,174,1141,00:00:33.000,2025-04-06 07:23:32.685
false,true,3053,2879,174,0,00:00:00.000,2025-04-06 07:26:32.751
false,true,3053,2879,174,0,00:00:00.000,2025-04-06 07:26:02.736
false,false,3053,2879,174,1239,00:00:33.000,2025-04-06 07:25:02.715
false,true,3053,2879,174,0,00:00:00.000,2025-04-06 07:28:02.780
false,true,3053,2879,174,0,00:00:00.000,2025-04-06 07:27:02.757
false,true,3053,2879,174,0,00:00:00.000,2025-04-06 07:27:32.772
false,false,3056,2882,174,95,00:00:33.000,2025-04-06 07:29:32.813
false,false,3055,2881,174,62,00:00:31.000,2025-04-06 07:29:02.805
false,false,3054,2880,174,31,00:00:31.000,2025-04-06 07:28:32.794
false,false,3057,2883,174,125,00:00:30.000,2025-04-06 07:30:02.826
false,false,3061,2887,174,251,00:00:33.000,2025-04-06 07:32:02.869
false,false,3060,2886,174,218,00:00:30.000,2025-04-06 07:31:32.858
false,false,3062,2888,174,282,00:00:31.000,2025-04-06 07:32:32.883
false,false,3059,2885,174,188,00:00:31.000,2025-04-06 07:31:02.846
false,false,3058,2884,174,157,00:00:32.000,2025-04-06 07:30:32.836
false,false,3063,2888,175,313,00:00:31.000,2025-04-06 07:33:02.889
false,false,3067,2892,175,440,00:00:31.000,2025-04-06 07:35:02.939
false,false,3064,2889,175,346,00:00:33.000,2025-04-06 07:33:32.902
false,false,3066,2891,175,409,00:00:31.000,2025-04-06 07:34:32.925
false,false,3068,2893,175,472,00:00:32.000,2025-04-06 07:35:32.946
false,false,3065,2890,175,378,00:00:32.000,2025-04-06 07:34:02.915
false,true,3069,2894,175,0,00:00:00.000,2025-04-06 07:37:32.994
false,true,3069,2894,175,0,00:00:00.000,2025-04-06 07:37:02.981
false,false,3069,2894,175,504,00:00:32.000,2025-04-06 07:36:02.957
false,true,3069,2894,175,0,00:00:00.000,2025-04-06 07:38:03.009
false,true,3069,2894,175,0,00:00:00.000,2025-04-06 07:36:32.967
false,true,3069,2894,175,0,00:00:00.000,2025-04-06 07:38:33.022
false,false,3070,2895,175,33,00:00:33.000,2025-04-06 07:39:33.049
false,false,3071,2896,175,66,00:00:33.000,2025-04-06 07:40:03.064
false,true,3069,2894,175,0,00:00:00.000,2025-04-06 07:39:03.034
false,false,3073,2898,175,131,00:00:33.000,2025-04-06 07:41:03.088
false,false,3074,2899,175,161,00:00:30.000,2025-04-06 07:41:33.101
false,false,3072,2897,175,98,00:00:32.000,2025-04-06 07:40:33.079
false,false,3076,2901,175,225,00:00:31.000,2025-04-06 07:42:33.127
false,false,3075,2900,175,194,00:00:33.000,2025-04-06 07:42:03.115
false,false,3077,2902,175,255,00:00:30.000,2025-04-06 07:43:03.136
false,false,3081,2906,175,384,00:00:33.000,2025-04-06 07:45:03.185
false,false,3078,2903,175,288,00:00:33.000,2025-04-06 07:43:33.147
false,false,3079,2904,175,318,00:00:30.000,2025-04-06 07:44:03.160
false,false,3080,2905,175,351,00:00:33.000,2025-04-06 07:44:33.175
false,false,3082,2907,175,415,00:00:31.000,2025-04-06 07:45:33.196
false,false,3084,2909,175,478,00:00:30.000,2025-04-06 07:46:33.221
false,false,3083,2908,175,448,00:00:33.000,2025-04-06 07:46:03.207
false,false,3085,2910,175,511,00:00:33.000,2025-04-06 07:47:03.226
false,true,3085,2910,175,0,00:00:00.000,2025-04-06 07:48:03.252
false,true,3085,2910,175,0,00:00:00.000,2025-04-06 07:48:33.257
false,true,3085,2910,175,0,00:00:00.000,2025-04-06 07:47:33.241
false,true,3085,2910,175,0,00:00:00.000,2025-04-06 07:49:03.271
false,true,3085,2910,175,0,00:00:00.000,2025-04-06 07:50:03.286
false,true,3085,2910,175,0,00:00:00.000,2025-04-06 07:49:33.281
false,true,3085,2910,175,0,00:00:00.000,2025-04-06 07:50:33.300
false,true,3085,2910,175,0,00:00:00.000,2025-04-06 07:51:33.327
false,true,3085,2910,175,0,00:00:00.000,2025-04-06 07:51:03.315
false,true,3085,2910,175,0,00:00:00.000,2025-04-06 07:52:33.355
false,true,3085,2910,175,0,00:00:00.000,2025-04-06 07:52:03.342
false,false,3086,2911,175,32,00:00:32.000,2025-04-06 07:53:33.378
false,true,3086,2911,175,0,00:00:00.000,2025-04-06 07:54:33.387
false,true,3085,2910,175,0,00:00:00.000,2025-04-06 07:53:03.364
false,true,3086,2911,175,0,00:00:00.000,2025-04-06 07:55:33.407
false,true,3086,2911,175,0,00:00:00.000,2025-04-06 07:55:03.392
false,true,3086,2911,175,0,00:00:00.000,2025-04-06 07:54:03.380
false,true,3086,2911,175,0,00:00:00.000,2025-04-06 07:56:03.422
false,false,3089,2914,175,96,00:00:33.000,2025-04-06 07:58:03.477
false,true,3086,2911,175,0,00:00:00.000,2025-04-06 07:56:33.436
false,false,3087,2912,175,30,00:00:30.000,2025-04-06 07:57:03.450
false,false,3088,2913,175,63,00:00:33.000,2025-04-06 07:57:33.465
false,false,3091,2916,175,160,00:00:31.000,2025-04-06 07:59:03.502
false,false,3090,2915,175,129,00:00:33.000,2025-04-06 07:58:33.490
false,false,3095,2920,175,284,00:00:30.000,2025-04-06 08:01:03.536
false,false,3094,2919,175,254,00:00:31.000,2025-04-06 08:00:33.522
false,false,3093,2918,175,223,00:00:30.000,2025-04-06 08:00:03.514
false,false,3092,2917,175,193,00:00:33.000,2025-04-06 07:59:33.510
false,false,3096,2921,175,315,00:00:31.000,2025-04-06 08:01:33.551
false,false,3099,2924,175,408,00:00:31.000,2025-04-06 08:03:03.578
false,false,3101,2924,177,472,00:00:32.000,2025-04-06 08:04:03.602
false,false,3097,2922,175,345,00:00:30.000,2025-04-06 08:02:03.559
false,false,3100,2924,176,440,00:00:32.000,2025-04-06 08:03:33.589
false,false,3098,2923,175,377,00:00:32.000,2025-04-06 08:02:33.564
false,false,3103,2926,177,536,00:00:33.000,2025-04-06 08:05:03.613
false,false,3102,2925,177,503,00:00:31.000,2025-04-06 08:04:33.613
false,false,3105,2928,177,597,00:00:31.000,2025-04-06 08:06:03.637
false,false,3106,2929,177,628,00:00:31.000,2025-04-06 08:06:33.648
false,false,3104,2927,177,566,00:00:30.000,2025-04-06 08:05:33.623
false,false,693,657,36,1189,00:00:30.000,2025-04-05 04:32:25.634
false,false,691,655,36,1129,00:00:31.000,2025-04-05 04:31:25.621
false,false,689,653,36,1068,00:00:32.000,2025-04-05 04:30:25.605
false,false,688,653,35,1036,00:00:32.000,2025-04-05 04:29:55.601
false,false,692,656,36,1159,00:00:30.000,2025-04-05 04:31:55.622
false,false,690,654,36,1098,00:00:30.000,2025-04-05 04:30:55.614
false,false,694,658,36,1220,00:00:31.000,2025-04-05 04:32:55.636
false,false,695,659,36,1252,00:00:32.000,2025-04-05 04:33:25.651
false,false,696,660,36,1284,00:00:32.000,2025-04-05 04:33:55.665
false,false,697,661,36,1316,00:00:32.000,2025-04-05 04:34:25.673
false,false,700,664,36,1408,00:00:31.000,2025-04-05 04:35:55.705
false,false,698,662,36,1346,00:00:30.000,2025-04-05 04:34:55.679
false,false,701,665,36,1440,00:00:32.000,2025-04-05 04:36:25.717
false,false,699,663,36,1377,00:00:31.000,2025-04-05 04:35:25.691
false,false,702,666,36,1471,00:00:31.000,2025-04-05 04:36:55.731
false,true,702,666,36,0,00:00:00.000,2025-04-05 04:37:55.753
false,true,702,666,36,0,00:00:00.000,2025-04-05 04:37:25.739
false,true,702,666,36,0,00:00:00.000,2025-04-05 04:38:25.762
false,true,702,666,36,0,00:00:00.000,2025-04-05 04:38:55.775
false,true,702,666,36,0,00:00:00.000,2025-04-05 04:39:25.786
false,true,702,666,36,0,00:00:00.000,2025-04-05 04:40:55.819
false,true,702,666,36,0,00:00:00.000,2025-04-05 04:39:55.800
false,true,702,666,36,0,00:00:00.000,2025-04-05 04:41:25.829
false,true,702,666,36,0,00:00:00.000,2025-04-05 04:42:25.850
false,true,702,666,36,0,00:00:00.000,2025-04-05 04:41:55.840
false,true,702,666,36,0,00:00:00.000,2025-04-05 04:40:25.807
false,false,703,667,36,33,00:00:33.000,2025-04-05 04:43:25.874
false,false,704,668,36,64,00:00:31.000,2025-04-05 04:43:55.885
false,false,705,669,36,97,00:00:33.000,2025-04-05 04:44:25.892
false,true,702,666,36,0,00:00:00.000,2025-04-05 04:42:55.862
false,false,706,670,36,127,00:00:30.000,2025-04-05 04:44:55.906
false,true,707,671,36,0,00:00:00.000,2025-04-05 04:46:25.941
false,true,707,671,36,0,00:00:00.000,2025-04-05 04:45:55.929
false,false,707,671,36,159,00:00:32.000,2025-04-05 04:45:25.917
false,true,707,671,36,0,00:00:00.000,2025-04-05 04:47:55.970
false,true,707,671,36,0,00:00:00.000,2025-04-05 04:46:55.952
false,true,707,671,36,0,00:00:00.000,2025-04-05 04:47:25.967
false,false,708,672,36,30,00:00:30.000,2025-04-05 04:48:55.996
false,false,709,673,36,62,00:00:32.000,2025-04-05 04:49:26.006
false,false,711,675,36,125,00:00:33.000,2025-04-05 04:50:26.029
false,false,710,674,36,92,00:00:30.000,2025-04-05 04:49:56.017
false,true,707,671,36,0,00:00:00.000,2025-04-05 04:48:25.985
false,false,712,676,36,156,00:00:31.000,2025-04-05 04:50:56.041
false,false,714,678,36,217,00:00:30.000,2025-04-05 04:51:56.062
false,true,716,680,36,0,00:00:00.000,2025-04-05 04:53:26.100
false,false,713,677,36,187,00:00:31.000,2025-04-05 04:51:26.054
false,false,715,679,36,249,00:00:32.000,2025-04-05 04:52:26.077
false,false,716,680,36,282,00:00:33.000,2025-04-05 04:52:56.088
false,true,716,680,36,0,00:00:00.000,2025-04-05 04:53:56.115
false,true,716,680,36,0,00:00:00.000,2025-04-05 04:54:26.120
false,true,716,680,36,0,00:00:00.000,2025-04-05 04:55:26.144
false,true,716,680,36,0,00:00:00.000,2025-04-05 04:55:56.151
false,true,716,680,36,0,00:00:00.000,2025-04-05 04:54:56.134
false,false,717,680,37,32,00:00:32.000,2025-04-05 04:56:26.162
false,false,719,682,37,96,00:00:33.000,2025-04-05 04:57:26.183
false,false,718,681,37,63,00:00:31.000,2025-04-05 04:56:56.173
false,true,721,684,37,0,00:00:00.000,2025-04-05 04:58:56.211
false,false,720,683,37,129,00:00:33.000,2025-04-05 04:57:56.187
false,true,721,684,37,0,00:00:00.000,2025-04-05 04:59:26.225
false,true,721,684,37,0,00:00:00.000,2025-04-05 05:00:26.254
false,true,721,684,37,0,00:00:00.000,2025-04-05 04:59:56.240
false,false,721,684,37,160,00:00:31.000,2025-04-05 04:58:26.201
false,true,721,684,37,0,00:00:00.000,2025-04-05 05:01:26.277
false,true,721,684,37,0,00:00:00.000,2025-04-05 05:00:56.264
false,false,723,686,37,60,00:00:30.000,2025-04-05 05:02:26.301
false,false,722,685,37,30,00:00:30.000,2025-04-05 05:01:56.288
false,false,724,687,37,93,00:00:33.000,2025-04-05 05:02:56.315
false,false,725,687,38,125,00:00:32.000,2025-04-05 05:03:26.330
false,false,727,689,38,190,00:00:32.000,2025-04-05 05:04:26.352
false,false,726,688,38,158,00:00:33.000,2025-04-05 05:03:56.342
false,false,728,690,38,223,00:00:33.000,2025-04-05 05:04:56.366
false,false,731,693,38,318,00:00:33.000,2025-04-05 05:06:26.407
false,false,729,691,38,253,00:00:30.000,2025-04-05 05:05:26.381
false,false,732,694,38,351,00:00:33.000,2025-04-05 05:06:56.418
false,false,730,692,38,285,00:00:32.000,2025-04-05 05:05:56.395
false,false,733,695,38,383,00:00:32.000,2025-04-05 05:07:26.429
false,false,734,696,38,413,00:00:30.000,2025-04-05 05:07:56.438
false,false,737,699,38,506,00:00:32.000,2025-04-05 05:09:26.473
false,false,735,697,38,444,00:00:31.000,2025-04-05 05:08:26.452
false,false,738,700,38,537,00:00:31.000,2025-04-05 05:09:56.486
false,false,736,698,38,474,00:00:30.000,2025-04-05 05:08:56.460
false,false,739,700,39,568,00:00:31.000,2025-04-05 05:10:26.501
false,false,741,702,39,633,00:00:33.000,2025-04-05 05:11:26.531
false,false,740,701,39,600,00:00:32.000,2025-04-05 05:10:56.516
false,false,742,703,39,663,00:00:30.000,2025-04-05 05:11:56.539
false,true,742,703,39,0,00:00:00.000,2025-04-05 05:12:56.560
false,true,742,703,39,0,00:00:00.000,2025-04-05 05:14:26.578
false,true,742,703,39,0,00:00:00.000,2025-04-05 05:13:26.565
false,true,742,703,39,0,00:00:00.000,2025-04-05 05:12:26.550
false,true,742,703,39,0,00:00:00.000,2025-04-05 05:14:56.591
false,true,742,703,39,0,00:00:00.000,2025-04-05 05:13:56.567
false,false,747,707,40,159,00:00:31.000,2025-04-05 05:17:26.647
false,false,744,704,40,64,00:00:31.000,2025-04-05 05:15:56.614
false,false,743,703,40,33,00:00:33.000,2025-04-05 05:15:26.600
false,false,746,706,40,128,00:00:31.000,2025-04-05 05:16:56.642
false,false,745,705,40,97,00:00:33.000,2025-04-05 05:16:26.628
false,false,748,707,41,191,00:00:32.000,2025-04-05 05:17:56.659
false,false,750,709,41,252,00:00:30.000,2025-04-05 05:18:56.681
false,false,749,708,41,222,00:00:31.000,2025-04-05 05:18:26.669
false,false,753,712,41,346,00:00:30.000,2025-04-05 05:20:26.712
false,false,751,710,41,285,00:00:33.000,2025-04-05 05:19:26.690
false,false,756,715,41,443,00:00:32.000,2025-04-05 05:21:56.749
false,false,754,713,41,379,00:00:33.000,2025-04-05 05:20:56.723
false,false,757,716,41,474,00:00:31.000,2025-04-05 05:22:26.754
false,false,752,711,41,316,00:00:31.000,2025-04-05 05:19:56.701
false,false,755,714,41,411,00:00:32.000,2025-04-05 05:21:26.733
false,false,758,717,41,504,00:00:30.000,2025-04-05 05:22:56.767
false,false,761,720,41,601,00:00:32.000,2025-04-05 05:24:26.804
false,false,762,721,41,633,00:00:32.000,2025-04-05 05:24:56.820
false,false,759,718,41,537,00:00:33.000,2025-04-05 05:23:26.780
false,false,760,719,41,569,00:00:32.000,2025-04-05 05:23:56.794
false,false,764,723,41,696,00:00:30.000,2025-04-05 05:25:56.836
false,false,765,724,41,728,00:00:32.000,2025-04-05 05:26:26.840
false,false,763,722,41,666,00:00:33.000,2025-04-05 05:25:26.831
false,false,768,727,41,823,00:00:33.000,2025-04-05 05:27:56.861
false,false,767,726,41,790,00:00:30.000,2025-04-05 05:27:26.860
false,false,766,725,41,760,00:00:32.000,2025-04-05 05:26:56.847
false,false,769,728,41,853,00:00:30.000,2025-04-05 05:28:26.873
false,false,770,729,41,885,00:00:32.000,2025-04-05 05:28:56.888
false,false,771,729,42,916,00:00:31.000,2025-04-05 05:29:26.895
false,false,773,731,42,979,00:00:32.000,2025-04-05 05:30:26.916
false,false,772,730,42,947,00:00:31.000,2025-04-05 05:29:56.908
false,false,775,733,42,1041,00:00:30.000,2025-04-05 05:31:26.931
false,false,776,734,42,1072,00:00:31.000,2025-04-05 05:31:56.946
false,false,777,735,42,1105,00:00:33.000,2025-04-05 05:32:26.960
false,false,778,736,42,1136,00:00:31.000,2025-04-05 05:32:56.975
false,false,774,732,42,1011,00:00:32.000,2025-04-05 05:30:56.917
false,false,779,737,42,1166,00:00:30.000,2025-04-05 05:33:26.989
false,false,780,738,42,1196,00:00:30.000,2025-04-05 05:33:57.003
false,false,782,740,42,1257,00:00:30.000,2025-04-05 05:34:57.022
false,false,781,739,42,1227,00:00:31.000,2025-04-05 05:34:27.010
false,false,783,741,42,1287,00:00:30.000,2025-04-05 05:35:27.036
false,false,785,743,42,1351,00:00:31.000,2025-04-05 05:36:27.061
false,false,786,744,42,1382,00:00:31.000,2025-04-05 05:36:57.070
false,false,784,742,42,1320,00:00:33.000,2025-04-05 05:35:57.049
false,false,2208,2085,123,1293,00:00:30.000,2025-04-05 21:40:18.928
false,false,2206,2083,123,1231,00:00:32.000,2025-04-05 21:39:18.908
false,false,2207,2084,123,1263,00:00:32.000,2025-04-05 21:39:48.919
false,false,2204,2081,123,1169,00:00:32.000,2025-04-05 21:38:18.883
false,false,2203,2080,123,1137,00:00:33.000,2025-04-05 21:37:48.871
false,false,2205,2082,123,1199,00:00:30.000,2025-04-05 21:38:48.895
false,false,2211,2088,123,1386,00:00:31.000,2025-04-05 21:41:48.970
false,false,2209,2086,123,1323,00:00:30.000,2025-04-05 21:40:48.940
false,true,2211,2088,123,0,00:00:00.000,2025-04-05 21:42:49.000
false,true,2211,2088,123,0,00:00:00.000,2025-04-05 21:43:19.015
false,false,2210,2087,123,1355,00:00:32.000,2025-04-05 21:41:18.955
false,true,2211,2088,123,0,00:00:00.000,2025-04-05 21:42:18.985
false,true,2211,2088,123,0,00:00:00.000,2025-04-05 21:43:49.023
false,true,2211,2088,123,0,00:00:00.000,2025-04-05 21:44:49.041
false,true,2211,2088,123,0,00:00:00.000,2025-04-05 21:44:19.037
false,false,2212,2089,123,32,00:00:32.000,2025-04-05 21:45:19.053
false,false,2213,2090,123,65,00:00:33.000,2025-04-05 21:45:49.066
false,false,2214,2091,123,95,00:00:30.000,2025-04-05 21:46:19.079
false,false,2215,2092,123,125,00:00:30.000,2025-04-05 21:46:49.092
false,false,2216,2093,123,156,00:00:31.000,2025-04-05 21:47:19.106
false,false,2217,2094,123,189,00:00:33.000,2025-04-05 21:47:49.121
false,false,2220,2097,123,285,00:00:30.000,2025-04-05 21:49:19.157
false,false,2218,2095,123,222,00:00:33.000,2025-04-05 21:48:19.134
false,false,2219,2096,123,255,00:00:33.000,2025-04-05 21:48:49.149
false,false,2222,2099,123,350,00:00:32.000,2025-04-05 21:50:19.181
false,false,2225,2102,123,443,00:00:31.000,2025-04-05 21:51:49.215
false,false,2221,2098,123,318,00:00:33.000,2025-04-05 21:49:49.170
false,false,2223,2100,123,380,00:00:30.000,2025-04-05 21:50:49.191
false,false,2226,2103,123,474,00:00:31.000,2025-04-05 21:52:19.229
false,false,2224,2101,123,412,00:00:32.000,2025-04-05 21:51:19.202
false,false,2227,2104,123,506,00:00:32.000,2025-04-05 21:52:49.244
false,false,2228,2105,123,537,00:00:31.000,2025-04-05 21:53:19.255
false,false,2229,2106,123,570,00:00:33.000,2025-04-05 21:53:49.261
false,false,2232,2109,123,663,00:00:30.000,2025-04-05 21:55:19.296
false,false,2230,2107,123,602,00:00:32.000,2025-04-05 21:54:19.271
false,false,2233,2110,123,695,00:00:32.000,2025-04-05 21:55:49.307
false,false,2231,2108,123,633,00:00:31.000,2025-04-05 21:54:49.284
false,false,2235,2112,123,761,00:00:33.000,2025-04-05 21:56:49.330
false,false,2234,2111,123,728,00:00:33.000,2025-04-05 21:56:19.319
false,false,2238,2115,123,853,00:00:30.000,2025-04-05 21:58:19.362
false,false,2236,2113,123,792,00:00:31.000,2025-04-05 21:57:19.345
false,false,2237,2114,123,823,00:00:31.000,2025-04-05 21:57:49.350
false,false,2239,2116,123,885,00:00:32.000,2025-04-05 21:58:49.374
false,false,2241,2118,123,947,00:00:30.000,2025-04-05 21:59:49.389
false,true,2241,2118,123,0,00:00:00.000,2025-04-05 22:01:19.429
false,true,2241,2118,123,0,00:00:00.000,2025-04-05 22:00:49.415
false,true,2241,2118,123,0,00:00:00.000,2025-04-05 22:00:19.402
false,true,2241,2118,123,0,00:00:00.000,2025-04-05 22:01:49.440
false,true,2241,2118,123,0,00:00:00.000,2025-04-05 22:02:19.451
false,false,2240,2117,123,917,00:00:32.000,2025-04-05 21:59:19.380
false,false,2242,2119,123,30,00:00:30.000,2025-04-05 22:03:19.472
false,false,2243,2120,123,61,00:00:31.000,2025-04-05 22:03:49.485
false,true,2241,2118,123,0,00:00:00.000,2025-04-05 22:02:49.460
false,false,2246,2123,123,157,00:00:33.000,2025-04-05 22:05:19.522
false,false,2245,2122,123,124,00:00:30.000,2025-04-05 22:04:49.512
false,false,2248,2125,123,219,00:00:32.000,2025-04-05 22:06:19.538
false,false,2247,2124,123,187,00:00:30.000,2025-04-05 22:05:49.528
false,false,2244,2121,123,94,00:00:33.000,2025-04-05 22:04:19.497
false,false,2250,2126,124,285,00:00:33.000,2025-04-05 22:07:19.560
false,false,2251,2127,124,315,00:00:30.000,2025-04-05 22:07:49.575
false,false,2249,2125,124,252,00:00:33.000,2025-04-05 22:06:49.551
false,false,2252,2128,124,347,00:00:32.000,2025-04-05 22:08:19.590
false,false,2255,2131,124,445,00:00:32.000,2025-04-05 22:09:49.619
false,false,2254,2130,124,413,00:00:33.000,2025-04-05 22:09:19.607
false,false,2253,2129,124,380,00:00:33.000,2025-04-05 22:08:49.596
false,false,2256,2131,125,476,00:00:31.000,2025-04-05 22:10:19.624
false,false,2258,2133,125,540,00:00:31.000,2025-04-05 22:11:19.643
false,false,2260,2135,125,606,00:00:33.000,2025-04-05 22:12:19.668
false,false,2257,2132,125,509,00:00:33.000,2025-04-05 22:10:49.639
false,false,2259,2134,125,573,00:00:33.000,2025-04-05 22:11:49.655
false,false,2262,2137,125,672,00:00:33.000,2025-04-05 22:13:19.679
false,false,2261,2136,125,639,00:00:33.000,2025-04-05 22:12:49.668
false,false,2263,2138,125,705,00:00:33.000,2025-04-05 22:13:49.681
false,false,2265,2140,125,769,00:00:32.000,2025-04-05 22:14:49.705
false,false,2264,2139,125,737,00:00:32.000,2025-04-05 22:14:19.694
false,true,2265,2140,125,0,00:00:00.000,2025-04-05 22:15:19.719
false,true,2265,2140,125,0,00:00:00.000,2025-04-05 22:16:19.736
false,true,2265,2140,125,0,00:00:00.000,2025-04-05 22:15:49.725
false,true,2265,2140,125,0,00:00:00.000,2025-04-05 22:16:49.751
false,true,2265,2140,125,0,00:00:00.000,2025-04-05 22:17:49.778
false,true,2265,2140,125,0,00:00:00.000,2025-04-05 22:17:19.765
false,false,2268,2143,125,98,00:00:33.000,2025-04-05 22:19:19.818
false,false,2267,2142,125,65,00:00:33.000,2025-04-05 22:18:49.805
false,false,2266,2141,125,32,00:00:32.000,2025-04-05 22:18:19.789
false,false,2269,2144,125,128,00:00:30.000,2025-04-05 22:19:49.829
false,false,2270,2145,125,158,00:00:30.000,2025-04-05 22:20:19.843
false,true,2271,2146,125,0,00:00:00.000,2025-04-05 22:22:19.886
false,true,2271,2146,125,0,00:00:00.000,2025-04-05 22:21:19.867
false,true,2271,2146,125,0,00:00:00.000,2025-04-05 22:21:49.877
false,true,2271,2146,125,0,00:00:00.000,2025-04-05 22:22:49.898
false,true,2271,2146,125,0,00:00:00.000,2025-04-05 22:23:49.923
false,false,2271,2146,125,189,00:00:31.000,2025-04-05 22:20:49.856
false,true,2271,2146,125,0,00:00:00.000,2025-04-05 22:23:19.911
false,false,2273,2148,125,64,00:00:31.000,2025-04-05 22:24:49.939
false,false,2272,2147,125,33,00:00:33.000,2025-04-05 22:24:19.935
false,false,2276,2151,125,157,00:00:30.000,2025-04-05 22:26:19.977
false,false,2274,2149,125,94,00:00:30.000,2025-04-05 22:25:19.950
false,false,2277,2152,125,187,00:00:30.000,2025-04-05 22:26:49.983
false,false,2275,2150,125,127,00:00:33.000,2025-04-05 22:25:49.964
false,false,2278,2153,125,220,00:00:33.000,2025-04-05 22:27:19.995
false,false,2283,2158,125,374,00:00:30.000,2025-04-05 22:29:50.055
false,false,2281,2156,125,313,00:00:32.000,2025-04-05 22:28:50.032
false,false,2280,2155,125,281,00:00:30.000,2025-04-05 22:28:20.020
false,false,2279,2154,125,251,00:00:31.000,2025-04-05 22:27:50.006
false,false,2282,2157,125,344,00:00:31.000,2025-04-05 22:29:20.041
false,false,2284,2159,125,404,00:00:30.000,2025-04-05 22:30:20.069
false,false,2286,2160,126,468,00:00:31.000,2025-04-05 22:31:20.095
false,false,2285,2159,126,437,00:00:33.000,2025-04-05 22:30:50.081
false,false,2288,2162,126,533,00:00:33.000,2025-04-05 22:32:20.123
false,false,2289,2162,127,566,00:00:33.000,2025-04-05 22:32:50.138
false,false,2287,2161,126,500,00:00:32.000,2025-04-05 22:31:50.109
false,false,2290,2163,127,597,00:00:31.000,2025-04-05 22:33:20.153
false,false,2291,2164,127,629,00:00:32.000,2025-04-05 22:33:50.167
false,false,2293,2166,127,693,00:00:31.000,2025-04-05 22:34:50.195
false,false,2292,2165,127,662,00:00:33.000,2025-04-05 22:34:20.182
false,false,2294,2167,127,725,00:00:32.000,2025-04-05 22:35:20.210
false,false,2296,2169,127,788,00:00:32.000,2025-04-05 22:36:20.237
false,false,2298,2171,127,850,00:00:30.000,2025-04-05 22:37:20.261
false,false,2299,2172,127,882,00:00:32.000,2025-04-05 22:37:50.275
false,false,2295,2168,127,756,00:00:31.000,2025-04-05 22:35:50.224
false,false,2297,2170,127,820,00:00:32.000,2025-04-05 22:36:50.253
false,false,2300,2173,127,915,00:00:33.000,2025-04-05 22:38:20.287
false,false,2931,2764,167,190,00:00:33.000,2025-04-06 06:03:00.754
false,false,2932,2765,167,220,00:00:30.000,2025-04-06 06:03:30.766
false,false,2929,2762,167,127,00:00:33.000,2025-04-06 06:02:00.735
false,false,2933,2766,167,251,00:00:31.000,2025-04-06 06:04:00.777
false,false,2930,2763,167,157,00:00:30.000,2025-04-06 06:02:30.747
false,true,2933,2766,167,0,00:00:00.000,2025-04-06 06:04:30.787
false,true,2933,2766,167,0,00:00:00.000,2025-04-06 06:05:00.801
false,true,2933,2766,167,0,00:00:00.000,2025-04-06 06:05:30.816
false,true,2933,2766,167,0,00:00:00.000,2025-04-06 06:06:00.827
false,false,2934,2767,167,30,00:00:30.000,2025-04-06 06:07:30.865
false,true,2933,2766,167,0,00:00:00.000,2025-04-06 06:07:00.852
false,false,2935,2768,167,63,00:00:33.000,2025-04-06 06:08:00.878
false,true,2933,2766,167,0,00:00:00.000,2025-04-06 06:06:30.841
false,false,2936,2769,167,96,00:00:33.000,2025-04-06 06:08:30.889
false,false,2937,2770,167,129,00:00:33.000,2025-04-06 06:09:00.903
false,false,2941,2774,167,254,00:00:32.000,2025-04-06 06:11:00.950
false,false,2938,2771,167,161,00:00:32.000,2025-04-06 06:09:30.912
false,false,2945,2778,167,379,00:00:33.000,2025-04-06 06:13:00.998
false,false,2940,2773,167,222,00:00:31.000,2025-04-06 06:10:30.939
false,false,2942,2775,167,286,00:00:32.000,2025-04-06 06:11:30.957
false,false,2944,2777,167,346,00:00:30.000,2025-04-06 06:12:30.984
false,false,2943,2776,167,316,00:00:30.000,2025-04-06 06:12:00.972
false,false,2939,2772,167,191,00:00:30.000,2025-04-06 06:10:00.925
false,false,2947,2780,167,440,00:00:31.000,2025-04-06 06:14:01.022
false,false,2946,2779,167,409,00:00:30.000,2025-04-06 06:13:31.011
false,false,2949,2782,167,503,00:00:33.000,2025-04-06 06:15:01.050
false,false,2948,2781,167,470,00:00:30.000,2025-04-06 06:14:31.037
false,false,2950,2783,167,535,00:00:32.000,2025-04-06 06:15:31.065
false,false,2953,2786,167,631,00:00:33.000,2025-04-06 06:17:01.105
false,false,2952,2785,167,598,00:00:30.000,2025-04-06 06:16:31.092
false,false,2954,2787,167,663,00:00:32.000,2025-04-06 06:17:31.115
false,false,2955,2788,167,693,00:00:30.000,2025-04-06 06:18:01.129
false,false,2951,2784,167,568,00:00:33.000,2025-04-06 06:16:01.080
false,false,2956,2789,167,726,00:00:33.000,2025-04-06 06:18:31.141
false,true,2957,2790,167,0,00:00:00.000,2025-04-06 06:19:31.170
false,true,2957,2790,167,0,00:00:00.000,2025-04-06 06:20:01.184
false,false,2957,2790,167,756,00:00:30.000,2025-04-06 06:19:01.156
false,true,2957,2790,167,0,00:00:00.000,2025-04-06 06:21:01.212
false,true,2957,2790,167,0,00:00:00.000,2025-04-06 06:21:31.228
false,false,2959,2792,167,64,00:00:31.000,2025-04-06 06:23:01.273
false,false,2958,2791,167,33,00:00:33.000,2025-04-06 06:22:31.257
false,true,2957,2790,167,0,00:00:00.000,2025-04-06 06:20:31.197
false,true,2957,2790,167,0,00:00:00.000,2025-04-06 06:22:01.243
false,false,2964,2797,167,223,00:00:33.000,2025-04-06 06:25:31.331
false,false,2962,2795,167,158,00:00:32.000,2025-04-06 06:24:31.307
false,false,2961,2794,167,126,00:00:30.000,2025-04-06 06:24:01.295
false,false,2963,2796,167,190,00:00:32.000,2025-04-06 06:25:01.319
false,false,2965,2798,167,255,00:00:32.000,2025-04-06 06:26:01.340
false,false,2960,2793,167,96,00:00:32.000,2025-04-06 06:23:31.283
false,false,2967,2800,167,315,00:00:30.000,2025-04-06 06:27:01.366
false,false,2966,2799,167,285,00:00:30.000,2025-04-06 06:26:31.353
false,false,2968,2801,167,347,00:00:32.000,2025-04-06 06:27:31.368
false,false,2970,2803,167,409,00:00:32.000,2025-04-06 06:28:31.387
false,false,2971,2804,167,442,00:00:33.000,2025-04-06 06:29:01.400
false,false,2973,2806,167,504,00:00:30.000,2025-04-06 06:30:01.419
false,false,2972,2805,167,474,00:00:32.000,2025-04-06 06:29:31.411
false,false,2969,2802,167,377,00:00:30.000,2025-04-06 06:28:01.373
false,false,2974,2807,167,536,00:00:32.000,2025-04-06 06:30:31.433
false,false,2976,2809,167,596,00:00:30.000,2025-04-06 06:31:31.458
false,false,2975,2808,167,566,00:00:30.000,2025-04-06 06:31:01.447
false,false,2977,2810,167,626,00:00:30.000,2025-04-06 06:32:01.472
false,false,2979,2812,167,688,00:00:32.000,2025-04-06 06:33:01.497
false,false,2980,2813,167,721,00:00:33.000,2025-04-06 06:33:31.510
false,false,2978,2811,167,656,00:00:30.000,2025-04-06 06:32:31.483
false,false,2981,2814,167,754,00:00:33.000,2025-04-06 06:34:01.521
false,false,2982,2815,167,787,00:00:33.000,2025-04-06 06:34:31.532
false,false,2983,2816,167,820,00:00:33.000,2025-04-06 06:35:01.539
false,false,2984,2817,167,851,00:00:31.000,2025-04-06 06:35:31.551
false,false,2986,2818,168,914,00:00:30.000,2025-04-06 06:36:31.571
false,false,2985,2817,168,884,00:00:33.000,2025-04-06 06:36:01.561
false,false,2989,2821,168,1005,00:00:30.000,2025-04-06 06:38:01.605
false,false,2988,2820,168,975,00:00:30.000,2025-04-06 06:37:31.594
false,false,2987,2819,168,945,00:00:31.000,2025-04-06 06:37:01.581
false,false,2990,2822,168,1038,00:00:33.000,2025-04-06 06:38:31.620
false,false,2995,2826,169,1199,00:00:33.000,2025-04-06 06:41:01.674
false,false,2992,2824,168,1102,00:00:31.000,2025-04-06 06:39:31.635
false,false,2994,2825,169,1166,00:00:32.000,2025-04-06 06:40:31.663
false,false,2991,2823,168,1071,00:00:33.000,2025-04-06 06:39:01.634
false,false,2993,2824,169,1134,00:00:32.000,2025-04-06 06:40:01.649
false,false,2996,2827,169,1230,00:00:31.000,2025-04-06 06:41:31.688
false,true,2996,2827,169,0,00:00:00.000,2025-04-06 06:42:01.698
false,true,2996,2827,169,0,00:00:00.000,2025-04-06 06:42:31.712
false,true,2996,2827,169,0,00:00:00.000,2025-04-06 06:43:01.726
false,true,2996,2827,169,0,00:00:00.000,2025-04-06 06:44:01.751
false,true,2996,2827,169,0,00:00:00.000,2025-04-06 06:43:31.736
false,true,2996,2827,169,0,00:00:00.000,2025-04-06 06:44:31.764
false,false,2999,2829,170,95,00:00:33.000,2025-04-06 06:46:01.801
false,false,2997,2828,169,30,00:00:30.000,2025-04-06 06:45:01.777
false,false,2998,2829,169,62,00:00:32.000,2025-04-06 06:45:31.791
false,true,2999,2829,170,0,00:00:00.000,2025-04-06 06:47:31.839
false,true,2999,2829,170,0,00:00:00.000,2025-04-06 06:47:01.824
false,true,2999,2829,170,0,00:00:00.000,2025-04-06 06:46:31.810
false,true,2999,2829,170,0,00:00:00.000,2025-04-06 06:48:01.854
false,true,2999,2829,170,0,00:00:00.000,2025-04-06 06:49:01.877
false,true,2999,2829,170,0,00:00:00.000,2025-04-06 06:48:31.869
false,false,3000,2830,170,31,00:00:31.000,2025-04-06 06:49:31.885
false,false,3001,2831,170,62,00:00:31.000,2025-04-06 06:50:01.896
false,false,3002,2832,170,92,00:00:30.000,2025-04-06 06:50:31.909
false,false,3003,2833,170,125,00:00:33.000,2025-04-06 06:51:01.916
false,false,3004,2834,170,157,00:00:32.000,2025-04-06 06:51:31.929
false,false,3009,2839,170,314,00:00:32.000,2025-04-06 06:54:01.981
false,false,3005,2835,170,189,00:00:32.000,2025-04-06 06:52:01.944
false,false,3007,2837,170,251,00:00:30.000,2025-04-06 06:53:01.964
false,false,3006,2836,170,221,00:00:32.000,2025-04-06 06:52:31.951
false,false,3008,2838,170,282,00:00:31.000,2025-04-06 06:53:31.967
false,true,3009,2839,170,0,00:00:00.000,2025-04-06 06:55:02.005
false,true,3009,2839,170,0,00:00:00.000,2025-04-06 06:56:02.033
false,true,3009,2839,170,0,00:00:00.000,2025-04-06 06:56:32.042
false,true,3009,2839,170,0,00:00:00.000,2025-04-06 06:55:32.017
false,true,3009,2839,170,0,00:00:00.000,2025-04-06 06:54:31.995
false,true,3009,2839,170,0,00:00:00.000,2025-04-06 06:57:02.048
false,false,3010,2840,170,30,00:00:30.000,2025-04-06 06:57:32.062
false,false,3011,2841,170,63,00:00:33.000,2025-04-06 06:58:02.073
false,false,3014,2843,171,153,00:00:30.000,2025-04-06 06:59:32.110
false,false,3013,2843,170,123,00:00:30.000,2025-04-06 06:59:02.097
false,false,3012,2842,170,93,00:00:30.000,2025-04-06 06:58:32.083
false,true,3014,2843,171,0,00:00:00.000,2025-04-06 07:00:02.121
false,true,3014,2843,171,0,00:00:00.000,2025-04-06 07:00:32.131
false,true,3014,2843,171,0,00:00:00.000,2025-04-06 07:01:32.156
false,true,3014,2843,171,0,00:00:00.000,2025-04-06 07:02:32.168
false,true,3014,2843,171,0,00:00:00.000,2025-04-06 07:03:02.180
false,true,3014,2843,171,0,00:00:00.000,2025-04-06 07:02:02.157
false,true,3014,2843,171,0,00:00:00.000,2025-04-06 07:01:02.144
false,true,3014,2843,171,0,00:00:00.000,2025-04-06 07:03:32.193
false,true,3014,2843,171,0,00:00:00.000,2025-04-06 07:04:02.204
false,true,3014,2843,171,0,00:00:00.000,2025-04-06 07:04:32.219
false,true,3014,2843,171,0,00:00:00.000,2025-04-06 07:05:02.233
false,true,3014,2843,171,0,00:00:00.000,2025-04-06 07:05:32.247
false,true,3106,2929,177,0,00:00:00.000,2025-04-06 08:08:33.678
false,true,3106,2929,177,0,00:00:00.000,2025-04-06 08:09:03.688
false,true,3106,2929,177,0,00:00:00.000,2025-04-06 08:07:33.666
false,true,3106,2929,177,0,00:00:00.000,2025-04-06 08:09:33.700
false,true,3106,2929,177,0,00:00:00.000,2025-04-06 08:07:03.661
false,true,3106,2929,177,0,00:00:00.000,2025-04-06 08:08:03.672
false,false,3108,2931,177,63,00:00:33.000,2025-04-06 08:10:33.720
false,false,3107,2930,177,30,00:00:30.000,2025-04-06 08:10:03.711
false,false,3109,2932,177,95,00:00:32.000,2025-04-06 08:11:03.732
false,false,3113,2936,177,222,00:00:32.000,2025-04-06 08:13:03.779
false,false,3110,2933,177,126,00:00:31.000,2025-04-06 08:11:33.744
false,false,3112,2935,177,190,00:00:32.000,2025-04-06 08:12:33.765
false,false,3114,2937,177,252,00:00:30.000,2025-04-06 08:13:33.793
false,false,3111,2934,177,158,00:00:32.000,2025-04-06 08:12:03.758
false,false,3115,2938,177,285,00:00:33.000,2025-04-06 08:14:03.807
false,false,3117,2940,177,347,00:00:32.000,2025-04-06 08:15:03.830
false,false,3120,2943,177,442,00:00:32.000,2025-04-06 08:16:33.869
false,false,3116,2939,177,315,00:00:30.000,2025-04-06 08:14:33.820
false,false,3119,2942,177,410,00:00:32.000,2025-04-06 08:16:03.854
false,false,3118,2941,177,378,00:00:31.000,2025-04-06 08:15:33.841
false,false,3122,2945,177,507,00:00:33.000,2025-04-06 08:17:33.897
false,false,3121,2944,177,474,00:00:32.000,2025-04-06 08:17:03.882
false,true,3122,2945,177,0,00:00:00.000,2025-04-06 08:18:33.922
false,true,3122,2945,177,0,00:00:00.000,2025-04-06 08:18:03.910
false,true,3122,2945,177,0,00:00:00.000,2025-04-06 08:19:03.932
false,true,3122,2945,177,0,00:00:00.000,2025-04-06 08:19:33.943
false,true,3122,2945,177,0,00:00:00.000,2025-04-06 08:20:33.971
false,true,3123,2946,177,0,00:00:00.000,2025-04-06 08:22:04.006
false,true,3122,2945,177,0,00:00:00.000,2025-04-06 08:20:03.957
false,false,3123,2946,177,30,00:00:30.000,2025-04-06 08:21:03.984
false,true,3123,2946,177,0,00:00:00.000,2025-04-06 08:21:33.998
false,true,3123,2946,177,0,00:00:00.000,2025-04-06 08:22:34.017
false,true,3123,2946,177,0,00:00:00.000,2025-04-06 08:23:04.020
false,false,3125,2948,177,63,00:00:31.000,2025-04-06 08:25:04.069
false,true,3123,2946,177,0,00:00:00.000,2025-04-06 08:24:04.045
false,false,3126,2949,177,94,00:00:31.000,2025-04-06 08:25:34.080
false,false,3124,2947,177,32,00:00:32.000,2025-04-06 08:24:34.060
false,false,3127,2950,177,124,00:00:30.000,2025-04-06 08:26:04.093
false,true,3123,2946,177,0,00:00:00.000,2025-04-06 08:23:34.034
false,false,3129,2952,177,190,00:00:33.000,2025-04-06 08:27:04.121
false,false,3128,2951,177,157,00:00:33.000,2025-04-06 08:26:34.107
false,false,3130,2953,177,221,00:00:31.000,2025-04-06 08:27:34.129
false,false,3131,2954,177,252,00:00:31.000,2025-04-06 08:28:04.138
false,false,3132,2955,177,285,00:00:33.000,2025-04-06 08:28:34.150
false,false,3133,2955,178,315,00:00:30.000,2025-04-06 08:29:04.161
false,false,3134,2955,179,347,00:00:32.000,2025-04-06 08:29:34.173
false,false,3135,2956,179,380,00:00:33.000,2025-04-06 08:30:04.186
false,false,3136,2957,179,411,00:00:31.000,2025-04-06 08:30:34.196
false,false,3138,2959,179,475,00:00:31.000,2025-04-06 08:31:34.223
false,false,3137,2958,179,444,00:00:33.000,2025-04-06 08:31:04.209
false,false,3139,2960,179,507,00:00:32.000,2025-04-06 08:32:04.236
false,true,3140,2961,179,0,00:00:00.000,2025-04-06 08:33:04.254
false,false,3140,2961,179,537,00:00:30.000,2025-04-06 08:32:34.245
false,true,3140,2961,179,0,00:00:00.000,2025-04-06 08:34:04.278
false,true,3140,2961,179,0,00:00:00.000,2025-04-06 08:33:34.269
false,true,3140,2961,179,0,00:00:00.000,2025-04-06 08:34:34.289
false,true,3140,2961,179,0,00:00:00.000,2025-04-06 08:35:34.318
false,false,3141,2962,179,32,00:00:32.000,2025-04-06 08:36:04.325
false,true,3140,2961,179,0,00:00:00.000,2025-04-06 08:35:04.303
false,false,3143,2964,179,95,00:00:31.000,2025-04-06 08:37:04.347
false,false,3142,2963,179,64,00:00:32.000,2025-04-06 08:36:34.335
false,false,3144,2965,179,125,00:00:30.000,2025-04-06 08:37:34.356
false,false,3146,2967,179,187,00:00:32.000,2025-04-06 08:38:34.380
false,false,3145,2966,179,155,00:00:30.000,2025-04-06 08:38:04.368
false,false,3148,2969,179,248,00:00:30.000,2025-04-06 08:39:34.400
false,false,3149,2970,179,278,00:00:30.000,2025-04-06 08:40:04.414
false,false,3151,2972,179,342,00:00:32.000,2025-04-06 08:41:04.437
false,false,3147,2968,179,218,00:00:31.000,2025-04-06 08:39:04.389
false,false,3150,2971,179,310,00:00:32.000,2025-04-06 08:40:34.426
false,false,3153,2974,179,403,00:00:31.000,2025-04-06 08:42:04.461
false,false,3154,2974,180,436,00:00:33.000,2025-04-06 08:42:34.473
false,true,3154,2974,180,0,00:00:00.000,2025-04-06 08:43:04.484
false,true,3154,2974,180,0,00:00:00.000,2025-04-06 08:44:04.500
false,false,3152,2973,179,372,00:00:30.000,2025-04-06 08:41:34.450
false,true,3154,2974,180,0,00:00:00.000,2025-04-06 08:44:34.509
false,true,3154,2974,180,0,00:00:00.000,2025-04-06 08:43:34.492
false,true,3154,2974,180,0,00:00:00.000,2025-04-06 08:45:04.524
false,false,3155,2975,180,30,00:00:30.000,2025-04-06 08:46:04.548
false,true,3154,2974,180,0,00:00:00.000,2025-04-06 08:45:34.538
false,false,3156,2975,181,60,00:00:30.000,2025-04-06 08:46:34.559
false,false,3158,2977,181,124,00:00:32.000,2025-04-06 08:47:34.580
false,false,3159,2978,181,157,00:00:33.000,2025-04-06 08:48:04.590
false,false,3162,2981,181,255,00:00:33.000,2025-04-06 08:49:34.621
false,false,3160,2979,181,189,00:00:32.000,2025-04-06 08:48:34.601
false,false,3161,2980,181,222,00:00:33.000,2025-04-06 08:49:04.610
false,false,3163,2982,181,288,00:00:33.000,2025-04-06 08:50:04.633
false,false,3157,2976,181,92,00:00:32.000,2025-04-06 08:47:04.573
false,false,3167,2986,181,416,00:00:30.000,2025-04-06 08:52:04.679
false,false,3164,2983,181,320,00:00:32.000,2025-04-06 08:50:34.645
false,false,3166,2985,181,386,00:00:33.000,2025-04-06 08:51:34.665
false,false,3169,2988,181,481,00:00:32.000,2025-04-06 08:53:04.698
false,false,3168,2987,181,449,00:00:33.000,2025-04-06 08:52:34.686
false,false,3165,2984,181,353,00:00:33.000,2025-04-06 08:51:04.654
false,false,3170,2989,181,513,00:00:32.000,2025-04-06 08:53:34.708
false,true,3170,2989,181,0,00:00:00.000,2025-04-06 08:55:34.756
false,true,3170,2989,181,0,00:00:00.000,2025-04-06 08:54:34.735
false,true,3170,2989,181,0,00:00:00.000,2025-04-06 08:55:04.743
false,true,3170,2989,181,0,00:00:00.000,2025-04-06 08:54:04.721
false,true,3170,2989,181,0,00:00:00.000,2025-04-06 08:56:04.767
false,true,3170,2989,181,0,00:00:00.000,2025-04-06 08:56:34.779
false,false,3172,2991,181,65,00:00:33.000,2025-04-06 08:57:34.806
false,false,3174,2993,181,129,00:00:32.000,2025-04-06 08:58:34.832
false,false,3171,2990,181,32,00:00:32.000,2025-04-06 08:57:04.791
false,false,3173,2992,181,97,00:00:32.000,2025-04-06 08:58:04.821
false,false,3175,2994,181,161,00:00:32.000,2025-04-06 08:59:04.847
false,false,3176,2994,182,192,00:00:31.000,2025-04-06 08:59:34.858
false,false,3177,2995,182,224,00:00:32.000,2025-04-06 09:00:04.871
false,true,3178,2996,182,0,00:00:00.000,2025-04-06 09:01:04.893
false,true,3178,2996,182,0,00:00:00.000,2025-04-06 09:02:04.922
false,false,3178,2996,182,255,00:00:31.000,2025-04-06 09:00:34.884
false,true,3178,2996,182,0,00:00:00.000,2025-04-06 09:01:34.908
false,true,3178,2996,182,0,00:00:00.000,2025-04-06 09:03:04.949
false,true,3178,2996,182,0,00:00:00.000,2025-04-06 09:03:34.962
false,false,3179,2997,182,31,00:00:31.000,2025-04-06 09:04:04.973
false,false,3181,2999,182,94,00:00:30.000,2025-04-06 09:05:04.991
false,false,3182,3000,182,125,00:00:31.000,2025-04-06 09:05:35.004
false,true,3178,2996,182,0,00:00:00.000,2025-04-06 09:02:34.935
false,false,3180,2998,182,64,00:00:33.000,2025-04-06 09:04:34.984
false,true,3183,3001,182,0,00:00:00.000,2025-04-06 09:06:35.026
false,false,3183,3001,182,157,00:00:32.000,2025-04-06 09:06:05.015
false,true,3183,3001,182,0,00:00:00.000,2025-04-06 09:07:05.038
false,true,3183,3001,182,0,00:00:00.000,2025-04-06 09:07:35.048
false,true,3183,3001,182,0,00:00:00.000,2025-04-06 09:08:35.068
false,true,3183,3001,182,0,00:00:00.000,2025-04-06 09:08:05.062
false,false,3185,3003,182,64,00:00:31.000,2025-04-06 09:10:05.101
false,false,3184,3002,182,33,00:00:33.000,2025-04-06 09:09:35.092
false,true,3183,3001,182,0,00:00:00.000,2025-04-06 09:09:05.082
false,false,1876,1772,104,32,00:00:32.000,2025-04-05 18:24:14.355
false,true,1875,1771,104,0,00:00:00.000,2025-04-05 18:22:44.316
false,true,1875,1771,104,0,00:00:00.000,2025-04-05 18:23:44.342
false,true,1875,1771,104,0,00:00:00.000,2025-04-05 18:22:14.306
false,false,1877,1772,105,62,00:00:30.000,2025-04-05 18:24:44.358
false,true,1875,1771,104,0,00:00:00.000,2025-04-05 18:23:14.328
false,false,1878,1773,105,93,00:00:31.000,2025-04-05 18:25:14.367
false,false,1879,1774,105,125,00:00:32.000,2025-04-05 18:25:44.380
false,false,1881,1776,105,191,00:00:33.000,2025-04-05 18:26:44.408
false,false,1882,1777,105,224,00:00:33.000,2025-04-05 18:27:14.419
false,false,1884,1779,105,287,00:00:33.000,2025-04-05 18:28:14.437
false,false,1883,1778,105,254,00:00:30.000,2025-04-05 18:27:44.426
false,false,1880,1775,105,158,00:00:33.000,2025-04-05 18:26:14.393
false,false,1885,1780,105,319,00:00:32.000,2025-04-05 18:28:44.452
false,false,1887,1782,105,380,00:00:30.000,2025-04-05 18:29:44.477
false,false,1886,1781,105,350,00:00:31.000,2025-04-05 18:29:14.463
false,false,1888,1783,105,411,00:00:31.000,2025-04-05 18:30:14.491
false,false,1890,1785,105,474,00:00:32.000,2025-04-05 18:31:14.514
false,false,1889,1784,105,442,00:00:31.000,2025-04-05 18:30:44.503
false,false,1891,1786,105,506,00:00:32.000,2025-04-05 18:31:44.529
false,false,1892,1787,105,536,00:00:30.000,2025-04-05 18:32:14.539
false,false,1893,1788,105,566,00:00:30.000,2025-04-05 18:32:44.548
false,false,1895,1790,105,632,00:00:33.000,2025-04-05 18:33:44.570
false,false,1896,1791,105,664,00:00:32.000,2025-04-05 18:34:14.584
false,false,1894,1789,105,599,00:00:33.000,2025-04-05 18:33:14.556
false,false,1898,1793,105,725,00:00:30.000,2025-04-05 18:35:14.613
false,false,1897,1792,105,695,00:00:31.000,2025-04-05 18:34:44.598
false,false,1899,1794,105,758,00:00:33.000,2025-04-05 18:35:44.625
false,false,1900,1795,105,790,00:00:32.000,2025-04-05 18:36:14.636
false,false,1901,1796,105,820,00:00:30.000,2025-04-05 18:36:44.645
false,false,1904,1799,105,915,00:00:31.000,2025-04-05 18:38:14.676
false,false,1903,1798,105,884,00:00:32.000,2025-04-05 18:37:44.662
false,false,1902,1797,105,852,00:00:32.000,2025-04-05 18:37:14.649
false,true,1904,1799,105,0,00:00:00.000,2025-04-05 18:39:14.693
false,true,1904,1799,105,0,00:00:00.000,2025-04-05 18:39:44.696
false,true,1904,1799,105,0,00:00:00.000,2025-04-05 18:38:44.681
false,false,1905,1800,105,32,00:00:32.000,2025-04-05 18:41:44.748
false,false,1906,1801,105,65,00:00:33.000,2025-04-05 18:42:14.762
false,true,1904,1799,105,0,00:00:00.000,2025-04-05 18:40:44.721
false,true,1904,1799,105,0,00:00:00.000,2025-04-05 18:41:14.736
false,true,1904,1799,105,0,00:00:00.000,2025-04-05 18:40:14.708
false,false,1909,1804,105,163,00:00:33.000,2025-04-05 18:43:44.797
false,false,1908,1803,105,130,00:00:32.000,2025-04-05 18:43:14.789
false,false,1907,1802,105,98,00:00:33.000,2025-04-05 18:42:44.777
false,false,1912,1807,105,260,00:00:32.000,2025-04-05 18:45:14.832
false,false,1911,1806,105,228,00:00:32.000,2025-04-05 18:44:44.818
false,false,1914,1809,105,320,00:00:30.000,2025-04-05 18:46:14.856
false,false,1910,1805,105,196,00:00:33.000,2025-04-05 18:44:14.809
false,false,1915,1810,105,351,00:00:31.000,2025-04-05 18:46:44.863
false,false,1916,1811,105,384,00:00:33.000,2025-04-05 18:47:14.876
false,false,1913,1808,105,290,00:00:30.000,2025-04-05 18:45:44.847
false,false,1917,1812,105,415,00:00:31.000,2025-04-05 18:47:44.888
false,false,1918,1813,105,445,00:00:30.000,2025-04-05 18:48:14.898
false,true,1920,1815,105,0,00:00:00.000,2025-04-05 18:49:44.934
false,false,1919,1814,105,476,00:00:31.000,2025-04-05 18:48:44.912
false,false,1920,1815,105,506,00:00:30.000,2025-04-05 18:49:14.924
false,true,1920,1815,105,0,00:00:00.000,2025-04-05 18:50:14.945
false,true,1920,1815,105,0,00:00:00.000,2025-04-05 18:50:44.957
false,true,1920,1815,105,0,00:00:00.000,2025-04-05 18:51:14.969
false,false,1921,1816,105,30,00:00:30.000,2025-04-05 18:52:45.009
false,true,1920,1815,105,0,00:00:00.000,2025-04-05 18:52:14.997
false,true,1920,1815,105,0,00:00:00.000,2025-04-05 18:51:44.985
false,true,1921,1816,105,0,00:00:00.000,2025-04-05 18:53:15.018
false,true,1921,1816,105,0,00:00:00.000,2025-04-05 18:54:15.041
false,true,1921,1816,105,0,00:00:00.000,2025-04-05 18:54:45.054
false,true,1921,1816,105,0,00:00:00.000,2025-04-05 18:55:15.060
false,true,1921,1816,105,0,00:00:00.000,2025-04-05 18:55:45.076
false,true,1921,1816,105,0,00:00:00.000,2025-04-05 18:53:45.029
false,false,1922,1817,105,33,00:00:33.000,2025-04-05 18:56:15.079
false,false,1925,1819,106,124,00:00:30.000,2025-04-05 18:57:45.118
false,false,1923,1818,105,64,00:00:31.000,2025-04-05 18:56:45.093
false,false,1924,1818,106,94,00:00:30.000,2025-04-05 18:57:15.104
false,false,1926,1820,106,154,00:00:30.000,2025-04-05 18:58:15.129
false,false,1927,1821,106,185,00:00:31.000,2025-04-05 18:58:45.142
false,false,1929,1823,106,249,00:00:31.000,2025-04-05 18:59:45.151
false,false,1928,1822,106,218,00:00:33.000,2025-04-05 18:59:15.150
false,false,1930,1824,106,282,00:00:33.000,2025-04-05 19:00:15.165
false,false,1932,1826,106,345,00:00:33.000,2025-04-05 19:01:15.186
false,false,1931,1825,106,312,00:00:30.000,2025-04-05 19:00:45.177
false,false,1934,1828,106,407,00:00:32.000,2025-04-05 19:02:15.212
false,false,1933,1827,106,375,00:00:30.000,2025-04-05 19:01:45.197
false,false,1935,1829,106,437,00:00:30.000,2025-04-05 19:02:45.222
false,false,1936,1830,106,469,00:00:32.000,2025-04-05 19:03:15.236
false,false,1938,1832,106,532,00:00:32.000,2025-04-05 19:04:15.263
false,false,1939,1833,106,562,00:00:30.000,2025-04-05 19:04:45.277
false,false,1937,1831,106,500,00:00:31.000,2025-04-05 19:03:45.249
false,false,1941,1835,106,624,00:00:30.000,2025-04-05 19:05:45.300
false,false,1940,1834,106,594,00:00:32.000,2025-04-05 19:05:15.289
false,false,1942,1836,106,654,00:00:30.000,2025-04-05 19:06:15.315
false,false,1943,1837,106,686,00:00:32.000,2025-04-05 19:06:45.330
false,false,1944,1838,106,717,00:00:31.000,2025-04-05 19:07:15.343
false,false,1945,1838,107,748,00:00:31.000,2025-04-05 19:07:45.357
false,false,1946,1839,107,781,00:00:33.000,2025-04-05 19:08:15.371
false,false,1948,1841,107,842,00:00:31.000,2025-04-05 19:09:15.390
false,false,1947,1840,107,811,00:00:30.000,2025-04-05 19:08:45.378
false,false,1949,1842,107,873,00:00:31.000,2025-04-05 19:09:45.401
false,false,1951,1843,108,934,00:00:30.000,2025-04-05 19:10:45.431
false,false,1950,1842,108,904,00:00:31.000,2025-04-05 19:10:15.416
false,true,1952,1844,108,0,00:00:00.000,2025-04-05 19:12:15.459
false,true,1952,1844,108,0,00:00:00.000,2025-04-05 19:11:45.451
false,false,1952,1844,108,965,00:00:31.000,2025-04-05 19:11:15.436
false,true,1952,1844,108,0,00:00:00.000,2025-04-05 19:12:45.473
false,true,1952,1844,108,0,00:00:00.000,2025-04-05 19:13:45.496
false,true,1952,1844,108,0,00:00:00.000,2025-04-05 19:13:15.480
false,false,1953,1845,108,33,00:00:33.000,2025-04-05 19:14:45.516
false,false,1954,1846,108,64,00:00:31.000,2025-04-05 19:15:15.530
false,false,1955,1847,108,94,00:00:30.000,2025-04-05 19:15:45.540
false,false,1956,1848,108,125,00:00:31.000,2025-04-05 19:16:15.549
false,false,1957,1849,108,157,00:00:32.000,2025-04-05 19:16:45.563
false,true,1952,1844,108,0,00:00:00.000,2025-04-05 19:14:15.505
false,false,1958,1850,108,189,00:00:32.000,2025-04-05 19:17:15.577
false,false,1959,1851,108,221,00:00:32.000,2025-04-05 19:17:45.588
false,false,1960,1852,108,251,00:00:30.000,2025-04-05 19:18:15.603
false,false,1961,1853,108,281,00:00:30.000,2025-04-05 19:18:45.615
false,false,1962,1854,108,311,00:00:30.000,2025-04-05 19:19:15.627
false,false,1965,1857,108,404,00:00:31.000,2025-04-05 19:20:45.654
false,false,1963,1855,108,343,00:00:32.000,2025-04-05 19:19:45.635
false,false,1964,1856,108,373,00:00:30.000,2025-04-05 19:20:15.643
false,false,1966,1858,108,435,00:00:31.000,2025-04-05 19:21:15.666
false,true,1967,1858,109,0,00:00:00.000,2025-04-05 19:22:15.688
false,false,1967,1858,109,466,00:00:31.000,2025-04-05 19:21:45.676
false,true,1967,1858,109,0,00:00:00.000,2025-04-05 19:22:45.702
false,true,1967,1858,109,0,00:00:00.000,2025-04-05 19:23:45.729
false,true,1967,1858,109,0,00:00:00.000,2025-04-05 19:24:15.743
false,true,1967,1858,109,0,00:00:00.000,2025-04-05 19:23:15.716
false,true,1967,1858,109,0,00:00:00.000,2025-04-05 19:24:45.756
false,false,1968,1859,109,33,00:00:33.000,2025-04-05 19:25:15.767
false,false,1969,1860,109,64,00:00:31.000,2025-04-05 19:25:45.780
false,false,1971,1862,109,127,00:00:31.000,2025-04-05 19:26:45.797
false,false,1970,1861,109,96,00:00:32.000,2025-04-05 19:26:15.785
false,false,1973,1864,109,187,00:00:30.000,2025-04-05 19:27:45.820
false,false,1972,1863,109,157,00:00:30.000,2025-04-05 19:27:15.805
false,false,1974,1865,109,218,00:00:31.000,2025-04-05 19:28:15.836
false,false,1975,1866,109,250,00:00:32.000,2025-04-05 19:28:45.844
false,false,1976,1867,109,280,00:00:30.000,2025-04-05 19:29:15.857
false,false,1524,1437,87,378,00:00:33.000,2025-04-05 14:10:08.629
false,true,1526,1439,87,0,00:00:00.000,2025-04-05 14:12:08.673
false,true,1526,1439,87,0,00:00:00.000,2025-04-05 14:12:38.686
false,false,1526,1439,87,440,00:00:32.000,2025-04-05 14:11:08.652
false,false,1525,1438,87,408,00:00:30.000,2025-04-05 14:10:38.639
false,true,1526,1439,87,0,00:00:00.000,2025-04-05 14:11:38.662
false,true,1526,1439,87,0,00:00:00.000,2025-04-05 14:13:08.700
false,false,1527,1440,87,30,00:00:30.000,2025-04-05 14:14:38.732
false,false,1529,1442,87,91,00:00:30.000,2025-04-05 14:15:38.761
false,true,1526,1439,87,0,00:00:00.000,2025-04-05 14:14:08.727
false,false,1528,1441,87,61,00:00:31.000,2025-04-05 14:15:08.745
false,false,1533,1446,87,216,00:00:30.000,2025-04-05 14:17:38.808
false,false,1530,1443,87,123,00:00:32.000,2025-04-05 14:16:08.772
false,false,1531,1444,87,154,00:00:31.000,2025-04-05 14:16:38.787
false,false,1532,1445,87,186,00:00:32.000,2025-04-05 14:17:08.803
false,true,1526,1439,87,0,00:00:00.000,2025-04-05 14:13:38.712
false,false,1534,1447,87,247,00:00:31.000,2025-04-05 14:18:08.816
false,false,1536,1448,88,307,00:00:30.000,2025-04-05 14:19:08.834
false,false,1537,1448,89,338,00:00:31.000,2025-04-05 14:19:38.842
false,false,1538,1449,89,368,00:00:30.000,2025-04-05 14:20:08.853
false,false,1535,1448,87,277,00:00:30.000,2025-04-05 14:18:38.823
false,true,1538,1449,89,0,00:00:00.000,2025-04-05 14:21:08.878
false,true,1538,1449,89,0,00:00:00.000,2025-04-05 14:22:08.891
false,true,1538,1449,89,0,00:00:00.000,2025-04-05 14:20:38.865
false,true,1538,1449,89,0,00:00:00.000,2025-04-05 14:22:38.896
false,true,1538,1449,89,0,00:00:00.000,2025-04-05 14:23:08.910
false,true,1538,1449,89,0,00:00:00.000,2025-04-05 14:23:38.923
false,true,1538,1449,89,0,00:00:00.000,2025-04-05 14:24:08.936
false,true,1538,1449,89,0,00:00:00.000,2025-04-05 14:21:38.888
false,true,1538,1449,89,0,00:00:00.000,2025-04-05 14:25:08.955
false,true,1538,1449,89,0,00:00:00.000,2025-04-05 14:24:38.948
false,false,1540,1451,89,61,00:00:31.000,2025-04-05 14:27:08.998
false,true,1538,1449,89,0,00:00:00.000,2025-04-05 14:25:38.970
false,false,1539,1450,89,30,00:00:30.000,2025-04-05 14:26:38.988
false,false,1541,1452,89,94,00:00:33.000,2025-04-05 14:27:39.009
false,true,1538,1449,89,0,00:00:00.000,2025-04-05 14:26:08.980
false,false,1542,1453,89,126,00:00:32.000,2025-04-05 14:28:09.017
false,false,1544,1455,89,189,00:00:31.000,2025-04-05 14:29:09.038
false,false,1543,1454,89,158,00:00:32.000,2025-04-05 14:28:39.027
false,false,1545,1456,89,221,00:00:32.000,2025-04-05 14:29:39.048
false,false,1547,1458,89,282,00:00:31.000,2025-04-05 14:30:39.069
false,false,1548,1459,89,312,00:00:30.000,2025-04-05 14:31:09.082
false,false,1549,1460,89,342,00:00:30.000,2025-04-05 14:31:39.093
false,false,1550,1461,89,373,00:00:31.000,2025-04-05 14:32:09.105
false,false,1546,1457,89,251,00:00:30.000,2025-04-05 14:30:09.055
false,false,1551,1462,89,403,00:00:30.000,2025-04-05 14:32:39.108
false,false,1553,1464,89,465,00:00:30.000,2025-04-05 14:33:39.128
false,false,1552,1463,89,435,00:00:32.000,2025-04-05 14:33:09.114
false,true,1553,1464,89,0,00:00:00.000,2025-04-05 14:34:09.141
false,true,1553,1464,89,0,00:00:00.000,2025-04-05 14:36:09.186
false,true,1553,1464,89,0,00:00:00.000,2025-04-05 14:34:39.150
false,true,1553,1464,89,0,00:00:00.000,2025-04-05 14:35:09.162
false,true,1553,1464,89,0,00:00:00.000,2025-04-05 14:35:39.171
false,true,1553,1464,89,0,00:00:00.000,2025-04-05 14:36:39.190
false,false,1554,1465,89,30,00:00:30.000,2025-04-05 14:37:09.202
false,true,1554,1465,89,0,00:00:00.000,2025-04-05 14:37:39.213
false,true,1554,1465,89,0,00:00:00.000,2025-04-05 14:38:39.238
false,true,1554,1465,89,0,00:00:00.000,2025-04-05 14:39:39.262
false,true,1554,1465,89,0,00:00:00.000,2025-04-05 14:39:09.251
false,true,1554,1465,89,0,00:00:00.000,2025-04-05 14:38:09.226
false,true,1554,1465,89,0,00:00:00.000,2025-04-05 14:40:09.273
false,false,1555,1465,90,32,00:00:32.000,2025-04-05 14:40:39.285
false,false,1556,1466,90,63,00:00:31.000,2025-04-05 14:41:09.286
false,false,1558,1468,90,127,00:00:31.000,2025-04-05 14:42:09.315
false,true,1558,1468,90,0,00:00:00.000,2025-04-05 14:42:39.322
false,true,1558,1468,90,0,00:00:00.000,2025-04-05 14:43:09.336
false,true,1558,1468,90,0,00:00:00.000,2025-04-05 14:44:09.355
false,true,1558,1468,90,0,00:00:00.000,2025-04-05 14:44:39.366
false,false,1557,1467,90,96,00:00:33.000,2025-04-05 14:41:39.299
false,true,1558,1468,90,0,00:00:00.000,2025-04-05 14:43:39.349
false,true,1558,1468,90,0,00:00:00.000,2025-04-05 14:45:09.379
false,false,1560,1470,90,65,00:00:32.000,2025-04-05 14:46:09.405
false,false,1562,1472,90,130,00:00:32.000,2025-04-05 14:47:09.434
false,false,1561,1471,90,98,00:00:33.000,2025-04-05 14:46:39.421
false,false,1559,1469,90,33,00:00:33.000,2025-04-05 14:45:39.391
false,false,1563,1473,90,161,00:00:31.000,2025-04-05 14:47:39.442
false,false,1564,1474,90,191,00:00:30.000,2025-04-05 14:48:09.452
false,false,1566,1476,90,251,00:00:30.000,2025-04-05 14:49:09.478
false,false,1568,1478,90,313,00:00:31.000,2025-04-05 14:50:09.499
false,false,1565,1475,90,221,00:00:30.000,2025-04-05 14:48:39.462
false,false,1567,1477,90,282,00:00:31.000,2025-04-05 14:49:39.490
false,false,1569,1479,90,345,00:00:32.000,2025-04-05 14:50:39.510
false,false,1570,1480,90,375,00:00:30.000,2025-04-05 14:51:09.515
false,false,1571,1481,90,408,00:00:33.000,2025-04-05 14:51:39.529
false,false,1573,1483,90,470,00:00:32.000,2025-04-05 14:52:39.552
false,false,1575,1485,90,534,00:00:31.000,2025-04-05 14:53:39.578
false,false,1574,1484,90,503,00:00:33.000,2025-04-05 14:53:09.567
false,false,1572,1482,90,438,00:00:30.000,2025-04-05 14:52:09.542
false,false,1576,1486,90,566,00:00:32.000,2025-04-05 14:54:09.593
false,false,1577,1487,90,598,00:00:32.000,2025-04-05 14:54:39.605
false,false,1578,1488,90,628,00:00:30.000,2025-04-05 14:55:09.620
false,false,1579,1489,90,659,00:00:31.000,2025-04-05 14:55:39.635
false,true,1579,1489,90,0,00:00:00.000,2025-04-05 14:56:09.650
false,true,1579,1489,90,0,00:00:00.000,2025-04-05 14:56:39.664
false,true,1579,1489,90,0,00:00:00.000,2025-04-05 14:57:09.675
false,true,1579,1489,90,0,00:00:00.000,2025-04-05 14:58:09.697
false,true,1579,1489,90,0,00:00:00.000,2025-04-05 14:58:39.707
false,false,1581,1491,90,65,00:00:32.000,2025-04-05 14:59:39.730
false,true,1579,1489,90,0,00:00:00.000,2025-04-05 14:57:39.685
false,false,1580,1490,90,33,00:00:33.000,2025-04-05 14:59:09.717
false,false,1582,1492,90,98,00:00:33.000,2025-04-05 15:00:09.745
false,false,1583,1492,91,130,00:00:32.000,2025-04-05 15:00:39.757
false,false,1585,1494,91,192,00:00:31.000,2025-04-05 15:01:39.778
false,false,1584,1493,91,161,00:00:31.000,2025-04-05 15:01:09.770
false,false,1588,1497,91,286,00:00:33.000,2025-04-05 15:03:09.819
false,false,1587,1496,91,253,00:00:30.000,2025-04-05 15:02:39.805
false,false,1589,1498,91,319,00:00:33.000,2025-04-05 15:03:39.830
false,false,1586,1495,91,223,00:00:31.000,2025-04-05 15:02:09.791
false,false,1591,1500,91,383,00:00:31.000,2025-04-05 15:04:39.855
false,false,1592,1500,92,414,00:00:31.000,2025-04-05 15:05:09.869
false,false,1593,1501,92,447,00:00:33.000,2025-04-05 15:05:39.880
false,false,1594,1502,92,480,00:00:33.000,2025-04-05 15:06:09.890
false,false,1595,1503,92,510,00:00:30.000,2025-04-05 15:06:39.905
false,false,1590,1499,91,352,00:00:33.000,2025-04-05 15:04:09.843
false,false,1597,1505,92,575,00:00:33.000,2025-04-05 15:07:39.917
false,false,1596,1504,92,542,00:00:32.000,2025-04-05 15:07:09.904
false,false,1598,1506,92,605,00:00:30.000,2025-04-05 15:08:09.918
false,false,1599,1507,92,637,00:00:32.000,2025-04-05 15:08:39.933
false,false,1601,1509,92,702,00:00:32.000,2025-04-05 15:09:39.954
false,false,1600,1508,92,670,00:00:33.000,2025-04-05 15:09:09.945
false,false,1602,1510,92,735,00:00:33.000,2025-04-05 15:10:09.969
false,false,4894,4621,273,284,00:00:31.000,2025-04-07 05:18:57.258
false,false,4892,4619,273,222,00:00:31.000,2025-04-07 05:17:57.233
false,false,4895,4621,274,314,00:00:30.000,2025-04-07 05:19:27.271
false,false,4897,4623,274,379,00:00:33.000,2025-04-07 05:20:27.289
false,false,4893,4620,273,253,00:00:31.000,2025-04-07 05:18:27.244
false,false,4896,4622,274,346,00:00:32.000,2025-04-07 05:19:57.278
false,false,4899,4625,274,444,00:00:32.000,2025-04-07 05:21:27.303
false,false,4901,4627,274,509,00:00:33.000,2025-04-07 05:22:27.331
false,false,4898,4624,274,412,00:00:33.000,2025-04-07 05:20:57.297
false,false,4900,4626,274,476,00:00:32.000,2025-04-07 05:21:57.317
false,false,4902,4628,274,540,00:00:31.000,2025-04-07 05:22:57.342
false,false,4904,4630,274,604,00:00:31.000,2025-04-07 05:23:57.371
false,false,4903,4629,274,573,00:00:33.000,2025-04-07 05:23:27.357
false,false,4905,4631,274,634,00:00:30.000,2025-04-07 05:24:27.386
false,true,4905,4631,274,0,00:00:00.000,2025-04-07 05:24:57.401
false,true,4905,4631,274,0,00:00:00.000,2025-04-07 05:25:27.414
false,true,4905,4631,274,0,00:00:00.000,2025-04-07 05:25:57.429
false,true,4905,4631,274,0,00:00:00.000,2025-04-07 05:26:27.443
false,true,4905,4631,274,0,00:00:00.000,2025-04-07 05:28:27.491
false,true,4905,4631,274,0,00:00:00.000,2025-04-07 05:27:27.465
false,true,4905,4631,274,0,00:00:00.000,2025-04-07 05:27:57.477
false,true,4905,4631,274,0,00:00:00.000,2025-04-07 05:26:57.453
false,true,4905,4631,274,0,00:00:00.000,2025-04-07 05:28:57.501
false,true,4905,4631,274,0,00:00:00.000,2025-04-07 05:29:57.527
false,false,4906,4632,274,33,00:00:33.000,2025-04-07 05:30:57.555
false,true,4905,4631,274,0,00:00:00.000,2025-04-07 05:30:27.540
false,true,4905,4631,274,0,00:00:00.000,2025-04-07 05:29:27.512
false,false,4907,4633,274,65,00:00:32.000,2025-04-07 05:31:27.562
false,false,4908,4634,274,95,00:00:30.000,2025-04-07 05:31:57.570
false,false,4910,4636,274,156,00:00:31.000,2025-04-07 05:32:57.595
false,false,4909,4635,274,125,00:00:30.000,2025-04-07 05:32:27.581
false,false,4914,4639,275,282,00:00:31.000,2025-04-07 05:34:57.642
false,false,4913,4638,275,251,00:00:32.000,2025-04-07 05:34:27.631
false,false,4911,4637,274,188,00:00:32.000,2025-04-07 05:33:27.608
false,false,4912,4637,275,219,00:00:31.000,2025-04-07 05:33:57.616
false,false,4916,4640,276,347,00:00:32.000,2025-04-07 05:35:57.667
false,false,4915,4639,276,315,00:00:33.000,2025-04-07 05:35:27.654
false,false,4917,4641,276,377,00:00:30.000,2025-04-07 05:36:27.679
false,true,4917,4641,276,0,00:00:00.000,2025-04-07 05:36:57.692
false,true,4917,4641,276,0,00:00:00.000,2025-04-07 05:37:27.705
false,true,4917,4641,276,0,00:00:00.000,2025-04-07 05:39:27.752
false,true,4917,4641,276,0,00:00:00.000,2025-04-07 05:37:57.714
false,false,4919,4643,276,65,00:00:33.000,2025-04-07 05:40:27.771
false,false,4918,4642,276,32,00:00:32.000,2025-04-07 05:39:57.766
false,true,4917,4641,276,0,00:00:00.000,2025-04-07 05:38:27.728
false,true,4917,4641,276,0,00:00:00.000,2025-04-07 05:38:57.739
false,false,4921,4645,276,131,00:00:33.000,2025-04-07 05:41:27.794
false,false,4923,4647,276,192,00:00:30.000,2025-04-07 05:42:27.815
false,false,4920,4644,276,98,00:00:33.000,2025-04-07 05:40:57.781
false,false,4922,4646,276,162,00:00:31.000,2025-04-07 05:41:57.805
false,false,4925,4649,276,253,00:00:30.000,2025-04-07 05:43:27.841
false,false,4924,4648,276,223,00:00:31.000,2025-04-07 05:42:57.826
false,false,4926,4650,276,284,00:00:31.000,2025-04-07 05:43:57.855
false,false,4927,4651,276,314,00:00:30.000,2025-04-07 05:44:27.865
false,false,4928,4652,276,344,00:00:30.000,2025-04-07 05:44:57.877
false,false,4930,4654,276,406,00:00:31.000,2025-04-07 05:45:57.899
false,false,4929,4653,276,375,00:00:31.000,2025-04-07 05:45:27.885
false,false,4931,4655,276,439,00:00:33.000,2025-04-07 05:46:27.912
false,false,4932,4656,276,472,00:00:33.000,2025-04-07 05:46:57.927
false,false,4935,4659,276,565,00:00:31.000,2025-04-07 05:48:27.966
false,false,4933,4657,276,503,00:00:31.000,2025-04-07 05:47:27.939
false,false,4936,4660,276,595,00:00:30.000,2025-04-07 05:48:57.981
false,false,4934,4658,276,534,00:00:31.000,2025-04-07 05:47:57.953
false,false,4939,4663,276,689,00:00:30.000,2025-04-07 05:50:28.020
false,false,4937,4661,276,628,00:00:33.000,2025-04-07 05:49:27.994
false,false,4938,4662,276,659,00:00:31.000,2025-04-07 05:49:58.006
false,false,4940,4663,277,719,00:00:30.000,2025-04-07 05:50:58.033
false,false,4941,4664,277,752,00:00:33.000,2025-04-07 05:51:28.046
false,false,4944,4667,277,847,00:00:33.000,2025-04-07 05:52:58.089
false,false,4942,4665,277,784,00:00:32.000,2025-04-07 05:51:58.061
false,false,4943,4666,277,814,00:00:30.000,2025-04-07 05:52:28.075
false,false,4948,4671,277,973,00:00:31.000,2025-04-07 05:54:58.144
false,false,4946,4669,277,909,00:00:30.000,2025-04-07 05:53:58.116
false,false,4945,4668,277,879,00:00:32.000,2025-04-07 05:53:28.104
false,false,4949,4672,277,1005,00:00:32.000,2025-04-07 05:55:28.156
false,false,4947,4670,277,942,00:00:33.000,2025-04-07 05:54:28.132
false,false,4950,4673,277,1035,00:00:30.000,2025-04-07 05:55:58.167
false,true,4951,4674,277,0,00:00:00.000,2025-04-07 05:56:58.193
false,false,4951,4674,277,1067,00:00:32.000,2025-04-07 05:56:28.182
false,true,4951,4674,277,0,00:00:00.000,2025-04-07 05:57:58.221
false,true,4951,4674,277,0,00:00:00.000,2025-04-07 05:58:28.233
false,true,4951,4674,277,0,00:00:00.000,2025-04-07 05:57:28.208
false,true,4951,4674,277,0,00:00:00.000,2025-04-07 05:58:58.245
false,true,4951,4674,277,0,00:00:00.000,2025-04-07 06:00:28.277
false,true,4951,4674,277,0,00:00:00.000,2025-04-07 05:59:28.249
false,true,4951,4674,277,0,00:00:00.000,2025-04-07 05:59:58.263
false,true,4951,4674,277,0,00:00:00.000,2025-04-07 06:00:58.289
false,true,4951,4674,277,0,00:00:00.000,2025-04-07 06:01:28.303
false,false,4952,4675,277,33,00:00:33.000,2025-04-07 06:02:58.345
false,true,4951,4674,277,0,00:00:00.000,2025-04-07 06:01:58.317
false,true,4951,4674,277,0,00:00:00.000,2025-04-07 06:02:28.331
false,true,4953,4676,277,0,00:00:00.000,2025-04-07 06:03:58.373
false,false,4953,4676,277,64,00:00:31.000,2025-04-07 06:03:28.358
false,true,4953,4676,277,0,00:00:00.000,2025-04-07 06:05:28.409
false,true,4953,4676,277,0,00:00:00.000,2025-04-07 06:04:28.381
false,true,4953,4676,277,0,00:00:00.000,2025-04-07 06:04:58.395
false,true,4953,4676,277,0,00:00:00.000,2025-04-07 06:06:28.432
false,false,4954,4677,277,33,00:00:33.000,2025-04-07 06:06:58.441
false,true,4953,4676,277,0,00:00:00.000,2025-04-07 06:05:58.421
false,false,4956,4679,277,97,00:00:33.000,2025-04-07 06:07:58.455
false,false,4955,4678,277,64,00:00:31.000,2025-04-07 06:07:28.441
false,false,4958,4680,278,158,00:00:31.000,2025-04-07 06:08:58.481
false,false,4959,4681,278,189,00:00:31.000,2025-04-07 06:09:28.495
false,false,4961,4683,278,252,00:00:31.000,2025-04-07 06:10:28.518
false,false,4957,4680,277,127,00:00:30.000,2025-04-07 06:08:28.467
false,false,4960,4682,278,221,00:00:32.000,2025-04-07 06:09:58.505
false,false,4962,4684,278,283,00:00:31.000,2025-04-07 06:10:58.533
false,false,4963,4685,278,314,00:00:31.000,2025-04-07 06:11:28.548
false,false,4964,4686,278,344,00:00:30.000,2025-04-07 06:11:58.556
false,false,4966,4688,278,405,00:00:31.000,2025-04-07 06:12:58.578
false,false,4967,4689,278,436,00:00:31.000,2025-04-07 06:13:28.592
false,true,4967,4689,278,0,00:00:00.000,2025-04-07 06:13:58.602
false,false,4965,4687,278,374,00:00:30.000,2025-04-07 06:12:28.566
false,true,4967,4689,278,0,00:00:00.000,2025-04-07 06:14:28.617
false,true,4967,4689,278,0,00:00:00.000,2025-04-07 06:14:58.632
false,true,4967,4689,278,0,00:00:00.000,2025-04-07 06:15:28.643
false,false,4968,4690,278,31,00:00:31.000,2025-04-07 06:16:58.681
false,true,4967,4689,278,0,00:00:00.000,2025-04-07 06:15:58.655
false,true,4967,4689,278,0,00:00:00.000,2025-04-07 06:16:28.667
false,false,4971,4693,278,126,00:00:31.000,2025-04-07 06:18:28.722
false,false,4972,4694,278,158,00:00:32.000,2025-04-07 06:18:58.733
false,false,4969,4691,278,64,00:00:33.000,2025-04-07 06:17:28.697
false,false,4970,4692,278,95,00:00:31.000,2025-04-07 06:17:58.709
false,false,4973,4695,278,190,00:00:32.000,2025-04-07 06:19:28.746
false,false,4975,4696,279,253,00:00:33.000,2025-04-07 06:20:28.773
false,false,4974,4695,279,220,00:00:30.000,2025-04-07 06:19:58.761
false,false,4976,4697,279,284,00:00:31.000,2025-04-07 06:20:58.784
false,false,4978,4699,279,347,00:00:32.000,2025-04-07 06:21:58.804
false,false,4977,4698,279,315,00:00:31.000,2025-04-07 06:21:28.794
false,false,4980,4701,279,410,00:00:33.000,2025-04-07 06:22:58.827
false,false,4979,4700,279,377,00:00:30.000,2025-04-07 06:22:28.816
false,false,4981,4702,279,443,00:00:33.000,2025-04-07 06:23:28.838
false,false,4982,4703,279,475,00:00:32.000,2025-04-07 06:23:58.849
false,false,4983,4704,279,508,00:00:33.000,2025-04-07 06:24:28.858
false,false,4984,4705,279,541,00:00:33.000,2025-04-07 06:24:58.868
false,false,4985,4706,279,571,00:00:30.000,2025-04-07 06:25:28.881
false,false,493,470,23,512,00:00:32.000,2025-04-05 02:25:22.993
false,false,490,467,23,417,00:00:33.000,2025-04-05 02:23:52.968
false,false,494,471,23,543,00:00:31.000,2025-04-05 02:25:52.997
false,false,491,468,23,450,00:00:33.000,2025-04-05 02:24:22.973
false,false,495,472,23,576,00:00:33.000,2025-04-05 02:26:23.004
false,false,492,469,23,480,00:00:30.000,2025-04-05 02:24:52.985
false,false,498,475,23,673,00:00:31.000,2025-04-05 02:27:53.036
false,false,497,474,23,642,00:00:33.000,2025-04-05 02:27:23.022
false,false,499,476,23,704,00:00:31.000,2025-04-05 02:28:23.048
false,false,500,477,23,734,00:00:30.000,2025-04-05 02:28:53.062
false,false,501,478,23,767,00:00:33.000,2025-04-05 02:29:23.074
false,false,502,479,23,798,00:00:31.000,2025-04-05 02:29:53.084
false,false,496,473,23,609,00:00:33.000,2025-04-05 02:26:53.019
false,true,502,479,23,0,00:00:00.000,2025-04-05 02:30:53.112
false,true,502,479,23,0,00:00:00.000,2025-04-05 02:31:23.125
false,true,502,479,23,0,00:00:00.000,2025-04-05 02:30:23.098
false,true,502,479,23,0,00:00:00.000,2025-04-05 02:31:53.137
false,true,502,479,23,0,00:00:00.000,2025-04-05 02:32:23.147
false,true,502,479,23,0,00:00:00.000,2025-04-05 02:32:53.157
false,false,503,480,23,32,00:00:32.000,2025-04-05 02:33:23.172
false,false,505,482,23,98,00:00:33.000,2025-04-05 02:34:23.198
false,false,504,481,23,65,00:00:33.000,2025-04-05 02:33:53.186
false,false,507,483,24,162,00:00:32.000,2025-04-05 02:35:23.217
false,false,508,484,24,193,00:00:31.000,2025-04-05 02:35:53.219
false,false,506,483,23,130,00:00:32.000,2025-04-05 02:34:53.213
false,false,509,485,24,225,00:00:32.000,2025-04-05 02:36:23.227
false,false,514,490,24,381,00:00:32.000,2025-04-05 02:38:53.278
false,false,510,486,24,257,00:00:32.000,2025-04-05 02:36:53.241
false,false,511,487,24,287,00:00:30.000,2025-04-05 02:37:23.251
false,false,513,489,24,349,00:00:30.000,2025-04-05 02:38:23.270
false,false,515,491,24,413,00:00:32.000,2025-04-05 02:39:23.288
false,false,517,493,24,477,00:00:32.000,2025-04-05 02:40:23.312
false,true,517,493,24,0,00:00:00.000,2025-04-05 02:41:23.331
false,true,517,493,24,0,00:00:00.000,2025-04-05 02:40:53.324
false,true,517,493,24,0,00:00:00.000,2025-04-05 02:41:53.342
false,false,516,492,24,445,00:00:32.000,2025-04-05 02:39:53.297
false,false,512,488,24,319,00:00:32.000,2025-04-05 02:37:53.257
false,true,517,493,24,0,00:00:00.000,2025-04-05 02:42:23.351
false,true,517,493,24,0,00:00:00.000,2025-04-05 02:43:23.376
false,false,519,495,24,60,00:00:30.000,2025-04-05 02:44:23.394
false,false,518,494,24,30,00:00:30.000,2025-04-05 02:43:53.381
false,false,520,496,24,91,00:00:31.000,2025-04-05 02:44:53.407
false,false,521,496,25,122,00:00:31.000,2025-04-05 02:45:23.416
false,true,517,493,24,0,00:00:00.000,2025-04-05 02:42:53.365
false,false,522,497,25,153,00:00:31.000,2025-04-05 02:45:53.428
false,false,523,498,25,186,00:00:33.000,2025-04-05 02:46:23.428
false,false,525,500,25,249,00:00:33.000,2025-04-05 02:47:23.441
false,false,524,499,25,216,00:00:30.000,2025-04-05 02:46:53.430
false,false,526,501,25,282,00:00:33.000,2025-04-05 02:47:53.454
false,false,527,502,25,313,00:00:31.000,2025-04-05 02:48:23.464
false,false,528,503,25,344,00:00:31.000,2025-04-05 02:48:53.475
false,false,530,505,25,409,00:00:33.000,2025-04-05 02:49:53.503
false,false,531,505,26,442,00:00:33.000,2025-04-05 02:50:23.514
false,false,532,506,26,473,00:00:31.000,2025-04-05 02:50:53.521
false,false,529,504,25,376,00:00:32.000,2025-04-05 02:49:23.488
false,false,534,508,26,539,00:00:33.000,2025-04-05 02:51:53.538
false,false,535,509,26,569,00:00:30.000,2025-04-05 02:52:23.552
false,false,533,507,26,506,00:00:33.000,2025-04-05 02:51:23.532
false,false,537,511,26,632,00:00:32.000,2025-04-05 02:53:23.580
false,false,536,510,26,600,00:00:31.000,2025-04-05 02:52:53.565
false,false,539,513,26,695,00:00:31.000,2025-04-05 02:54:23.599
false,false,538,512,26,664,00:00:32.000,2025-04-05 02:53:53.588
false,false,540,514,26,728,00:00:33.000,2025-04-05 02:54:53.600
false,false,541,515,26,758,00:00:30.000,2025-04-05 02:55:23.615
false,false,543,517,26,821,00:00:33.000,2025-04-05 02:56:23.641
false,false,545,518,27,886,00:00:33.000,2025-04-05 02:57:23.659
false,false,546,519,27,916,00:00:30.000,2025-04-05 02:57:53.672
false,false,542,516,26,788,00:00:30.000,2025-04-05 02:55:53.631
false,false,544,517,27,853,00:00:32.000,2025-04-05 02:56:53.655
false,false,548,521,27,978,00:00:30.000,2025-04-05 02:58:53.694
false,false,547,520,27,948,00:00:32.000,2025-04-05 02:58:23.686
false,false,551,524,27,1073,00:00:32.000,2025-04-05 03:00:23.726
false,false,549,522,27,1011,00:00:33.000,2025-04-05 02:59:23.708
false,false,554,527,27,1168,00:00:32.000,2025-04-05 03:01:53.754
false,false,552,525,27,1106,00:00:33.000,2025-04-05 03:00:53.737
false,false,553,526,27,1136,00:00:30.000,2025-04-05 03:01:23.753
false,false,555,528,27,1198,00:00:30.000,2025-04-05 03:02:23.758
false,false,550,523,27,1041,00:00:30.000,2025-04-05 02:59:53.718
false,false,556,529,27,1230,00:00:32.000,2025-04-05 03:02:53.771
false,false,558,531,27,1292,00:00:31.000,2025-04-05 03:03:53.792
false,false,557,530,27,1261,00:00:31.000,2025-04-05 03:03:23.781
false,false,559,532,27,1325,00:00:33.000,2025-04-05 03:04:23.796
false,false,560,533,27,1357,00:00:32.000,2025-04-05 03:04:53.802
false,false,562,535,27,1421,00:00:33.000,2025-04-05 03:05:53.827
false,false,564,536,28,1483,00:00:30.000,2025-04-05 03:06:53.854
false,false,561,534,27,1388,00:00:31.000,2025-04-05 03:05:23.816
false,false,566,537,29,1545,00:00:31.000,2025-04-05 03:07:53.885
false,false,563,535,28,1453,00:00:32.000,2025-04-05 03:06:23.842
false,false,567,538,29,1575,00:00:30.000,2025-04-05 03:08:23.898
false,false,565,537,28,1514,00:00:31.000,2025-04-05 03:07:23.869
false,false,568,539,29,1608,00:00:33.000,2025-04-05 03:08:53.904
false,true,568,539,29,0,00:00:00.000,2025-04-05 03:09:23.914
false,true,568,539,29,0,00:00:00.000,2025-04-05 03:10:23.936
false,true,568,539,29,0,00:00:00.000,2025-04-05 03:10:53.951
false,true,568,539,29,0,00:00:00.000,2025-04-05 03:09:53.926
false,true,568,539,29,0,00:00:00.000,2025-04-05 03:11:53.969
false,true,568,539,29,0,00:00:00.000,2025-04-05 03:11:23.967
false,false,570,541,29,65,00:00:32.000,2025-04-05 03:12:53.997
false,false,569,540,29,33,00:00:33.000,2025-04-05 03:12:23.982
false,false,572,543,29,128,00:00:31.000,2025-04-05 03:13:54.014
false,false,571,542,29,97,00:00:32.000,2025-04-05 03:13:24.001
false,false,574,545,29,191,00:00:33.000,2025-04-05 03:14:54.042
false,false,573,544,29,158,00:00:30.000,2025-04-05 03:14:24.027
false,false,576,547,29,252,00:00:30.000,2025-04-05 03:15:54.056
false,false,575,546,29,222,00:00:31.000,2025-04-05 03:15:24.053
false,false,577,548,29,283,00:00:31.000,2025-04-05 03:16:24.059
false,false,579,550,29,344,00:00:30.000,2025-04-05 03:17:24.070
false,false,578,549,29,314,00:00:31.000,2025-04-05 03:16:54.063
false,false,580,551,29,374,00:00:30.000,2025-04-05 03:17:54.082
false,false,581,552,29,404,00:00:30.000,2025-04-05 03:18:24.094
false,false,583,554,29,466,00:00:30.000,2025-04-05 03:19:24.123
false,false,582,553,29,436,00:00:32.000,2025-04-05 03:18:54.109
false,false,584,554,30,499,00:00:33.000,2025-04-05 03:19:54.137
false,false,587,557,30,591,00:00:31.000,2025-04-05 03:21:24.179
false,false,585,555,30,529,00:00:30.000,2025-04-05 03:20:24.149
false,false,588,558,30,622,00:00:31.000,2025-04-05 03:21:54.186
false,false,586,556,30,560,00:00:31.000,2025-04-05 03:20:54.165
false,false,589,559,30,655,00:00:33.000,2025-04-05 03:22:24.200
false,false,593,563,30,785,00:00:33.000,2025-04-05 03:24:24.236
false,false,592,562,30,752,00:00:33.000,2025-04-05 03:23:54.233
false,false,590,560,30,687,00:00:32.000,2025-04-05 03:22:54.206
false,false,591,561,30,719,00:00:32.000,2025-04-05 03:23:24.218
false,false,594,564,30,818,00:00:33.000,2025-04-05 03:24:54.250
false,false,595,565,30,850,00:00:32.000,2025-04-05 03:25:24.265
false,false,597,567,30,914,00:00:32.000,2025-04-05 03:26:24.271
false,false,600,569,31,1009,00:00:33.000,2025-04-05 03:27:54.299
false,false,598,567,31,945,00:00:31.000,2025-04-05 03:26:54.280
false,false,599,568,31,976,00:00:31.000,2025-04-05 03:27:24.294
false,false,596,566,30,882,00:00:32.000,2025-04-05 03:25:54.270
false,true,600,569,31,0,00:00:00.000,2025-04-05 03:28:54.323
false,true,600,569,31,0,00:00:00.000,2025-04-05 03:28:24.312
false,true,600,569,31,0,00:00:00.000,2025-04-05 03:29:24.337
false,false,2580,2434,146,219,00:00:30.000,2025-04-06 01:52:24.740
false,false,2578,2432,146,157,00:00:32.000,2025-04-06 01:51:24.715
false,false,2577,2431,146,125,00:00:32.000,2025-04-06 01:50:54.704
false,false,2579,2433,146,189,00:00:32.000,2025-04-06 01:51:54.729
false,false,2581,2435,146,249,00:00:30.000,2025-04-06 01:52:54.749
false,false,2576,2430,146,93,00:00:32.000,2025-04-06 01:50:24.691
false,false,2582,2436,146,281,00:00:32.000,2025-04-06 01:53:24.760
false,false,2584,2437,147,346,00:00:33.000,2025-04-06 01:54:24.784
false,false,2583,2437,146,313,00:00:32.000,2025-04-06 01:53:54.771
false,false,2587,2440,147,444,00:00:33.000,2025-04-06 01:55:54.819
false,false,2586,2439,147,411,00:00:33.000,2025-04-06 01:55:24.813
false,false,2585,2438,147,378,00:00:32.000,2025-04-06 01:54:54.798
false,false,2589,2442,147,507,00:00:33.000,2025-04-06 01:56:54.845
false,false,2591,2444,147,569,00:00:30.000,2025-04-06 01:57:54.873
false,false,2588,2441,147,474,00:00:30.000,2025-04-06 01:56:24.833
false,false,2592,2445,147,600,00:00:31.000,2025-04-06 01:58:24.886
false,false,2593,2446,147,633,00:00:33.000,2025-04-06 01:58:54.899
false,false,2590,2443,147,539,00:00:32.000,2025-04-06 01:57:24.859
false,true,2593,2446,147,0,00:00:00.000,2025-04-06 01:59:24.914
false,true,2593,2446,147,0,00:00:00.000,2025-04-06 02:00:24.936
false,true,2593,2446,147,0,00:00:00.000,2025-04-06 02:01:24.964
false,true,2593,2446,147,0,00:00:00.000,2025-04-06 01:59:54.929
false,false,2594,2447,147,32,00:00:32.000,2025-04-06 02:02:24.986
false,false,2596,2449,147,95,00:00:31.000,2025-04-06 02:03:25.004
false,false,2595,2448,147,64,00:00:32.000,2025-04-06 02:02:54.997
false,true,2593,2446,147,0,00:00:00.000,2025-04-06 02:01:54.977
false,true,2593,2446,147,0,00:00:00.000,2025-04-06 02:00:54.952
false,false,2600,2452,148,222,00:00:32.000,2025-04-06 02:05:25.053
false,false,2599,2451,148,190,00:00:31.000,2025-04-06 02:04:55.043
false,false,2598,2450,148,159,00:00:33.000,2025-04-06 02:04:25.031
false,false,2597,2450,147,126,00:00:31.000,2025-04-06 02:03:55.016
false,false,2601,2452,149,253,00:00:31.000,2025-04-06 02:05:55.066
false,false,2604,2455,149,346,00:00:31.000,2025-04-06 02:07:25.102
false,false,2605,2456,149,377,00:00:31.000,2025-04-06 02:07:55.114
false,false,2606,2457,149,410,00:00:33.000,2025-04-06 02:08:25.126
false,false,2602,2453,149,283,00:00:30.000,2025-04-06 02:06:25.077
false,false,2603,2454,149,315,00:00:32.000,2025-04-06 02:06:55.090
false,true,2606,2457,149,0,00:00:00.000,2025-04-06 02:08:55.136
false,true,2606,2457,149,0,00:00:00.000,2025-04-06 02:10:25.170
false,true,2606,2457,149,0,00:00:00.000,2025-04-06 02:11:25.191
false,true,2606,2457,149,0,00:00:00.000,2025-04-06 02:10:55.183
false,true,2606,2457,149,0,00:00:00.000,2025-04-06 02:09:25.150
false,true,2606,2457,149,0,00:00:00.000,2025-04-06 02:09:55.160
false,false,2607,2457,150,33,00:00:33.000,2025-04-06 02:11:55.205
false,false,2610,2460,150,128,00:00:33.000,2025-04-06 02:13:25.243
false,false,2612,2462,150,193,00:00:32.000,2025-04-06 02:14:25.260
false,false,2608,2458,150,63,00:00:30.000,2025-04-06 02:12:25.219
false,false,2609,2459,150,95,00:00:32.000,2025-04-06 02:12:55.234
false,false,2611,2461,150,161,00:00:33.000,2025-04-06 02:13:55.254
false,false,2613,2463,150,226,00:00:33.000,2025-04-06 02:14:55.271
false,false,2614,2464,150,256,00:00:30.000,2025-04-06 02:15:25.283
false,false,2617,2467,150,349,00:00:32.000,2025-04-06 02:16:55.321
false,false,2616,2466,150,317,00:00:31.000,2025-04-06 02:16:25.309
false,false,2618,2468,150,379,00:00:30.000,2025-04-06 02:17:25.336
false,false,2615,2465,150,286,00:00:30.000,2025-04-06 02:15:55.298
false,false,2620,2470,150,444,00:00:33.000,2025-04-06 02:18:25.360
false,false,2619,2469,150,411,00:00:32.000,2025-04-06 02:17:55.347
false,false,2621,2471,150,477,00:00:33.000,2025-04-06 02:18:55.369
false,false,2622,2472,150,510,00:00:33.000,2025-04-06 02:19:25.384
false,false,2623,2473,150,540,00:00:30.000,2025-04-06 02:19:55.397
false,false,2625,2474,151,603,00:00:32.000,2025-04-06 02:20:55.424
false,false,2626,2475,151,633,00:00:30.000,2025-04-06 02:21:25.439
false,false,2627,2476,151,666,00:00:33.000,2025-04-06 02:21:55.451
false,false,2624,2474,150,571,00:00:31.000,2025-04-06 02:20:25.410
false,false,2628,2477,151,697,00:00:31.000,2025-04-06 02:22:25.462
false,false,2629,2478,151,727,00:00:30.000,2025-04-06 02:22:55.473
false,true,2629,2478,151,0,00:00:00.000,2025-04-06 02:23:55.496
false,true,2629,2478,151,0,00:00:00.000,2025-04-06 02:24:55.515
false,true,2629,2478,151,0,00:00:00.000,2025-04-06 02:24:25.502
false,true,2629,2478,151,0,00:00:00.000,2025-04-06 02:25:55.543
false,false,2630,2479,151,30,00:00:30.000,2025-04-06 02:26:25.557
false,true,2629,2478,151,0,00:00:00.000,2025-04-06 02:23:25.483
false,true,2629,2478,151,0,00:00:00.000,2025-04-06 02:25:25.529
false,false,2632,2481,151,96,00:00:33.000,2025-04-06 02:27:25.582
false,false,2631,2480,151,63,00:00:33.000,2025-04-06 02:26:55.571
false,false,2633,2482,151,126,00:00:30.000,2025-04-06 02:27:55.592
false,false,2634,2483,151,156,00:00:30.000,2025-04-06 02:28:25.607
false,true,2634,2483,151,0,00:00:00.000,2025-04-06 02:28:55.620
false,true,2634,2483,151,0,00:00:00.000,2025-04-06 02:29:25.633
false,true,2634,2483,151,0,00:00:00.000,2025-04-06 02:30:55.678
false,true,2634,2483,151,0,00:00:00.000,2025-04-06 02:30:25.664
false,true,2634,2483,151,0,00:00:00.000,2025-04-06 02:31:25.691
false,true,2634,2483,151,0,00:00:00.000,2025-04-06 02:29:55.648
false,false,2635,2483,152,32,00:00:32.000,2025-04-06 02:31:55.705
false,false,2638,2486,152,127,00:00:31.000,2025-04-06 02:33:25.745
false,false,2636,2484,152,63,00:00:31.000,2025-04-06 02:32:25.717
false,false,2637,2485,152,96,00:00:33.000,2025-04-06 02:32:55.731
false,false,2639,2487,152,158,00:00:31.000,2025-04-06 02:33:55.758
false,false,2641,2489,152,220,00:00:32.000,2025-04-06 02:34:55.783
false,false,2640,2488,152,188,00:00:30.000,2025-04-06 02:34:25.773
false,true,2642,2490,152,0,00:00:00.000,2025-04-06 02:36:25.827
false,true,2642,2490,152,0,00:00:00.000,2025-04-06 02:35:55.812
false,false,2642,2490,152,253,00:00:33.000,2025-04-06 02:35:25.798
false,true,2642,2490,152,0,00:00:00.000,2025-04-06 02:36:55.839
false,true,2642,2490,152,0,00:00:00.000,2025-04-06 02:37:55.869
false,true,2642,2490,152,0,00:00:00.000,2025-04-06 02:37:25.854
false,false,2645,2493,152,94,00:00:32.000,2025-04-06 02:39:55.906
false,true,2642,2490,152,0,00:00:00.000,2025-04-06 02:38:25.874
false,false,2644,2492,152,62,00:00:30.000,2025-04-06 02:39:25.892
false,false,2646,2494,152,124,00:00:30.000,2025-04-06 02:40:25.920
false,false,2643,2491,152,32,00:00:32.000,2025-04-06 02:38:55.886
false,false,2647,2495,152,156,00:00:32.000,2025-04-06 02:40:55.933
false,false,2648,2496,152,186,00:00:30.000,2025-04-06 02:41:25.947
false,false,2650,2498,152,250,00:00:31.000,2025-04-06 02:42:25.971
false,false,2649,2497,152,219,00:00:33.000,2025-04-06 02:41:55.957
false,false,2652,2500,152,315,00:00:33.000,2025-04-06 02:43:25.994
false,false,2654,2502,152,378,00:00:32.000,2025-04-06 02:44:26.012
false,false,2651,2499,152,282,00:00:32.000,2025-04-06 02:42:55.981
false,false,2653,2501,152,346,00:00:31.000,2025-04-06 02:43:56.005
false,false,2655,2503,152,408,00:00:30.000,2025-04-06 02:44:56.025
false,false,2656,2504,152,441,00:00:33.000,2025-04-06 02:45:26.038
false,false,2657,2505,152,473,00:00:32.000,2025-04-06 02:45:56.053
false,false,2659,2507,152,535,00:00:32.000,2025-04-06 02:46:56.072
false,false,2658,2506,152,503,00:00:30.000,2025-04-06 02:46:26.067
false,false,2661,2509,152,597,00:00:30.000,2025-04-06 02:47:56.091
false,false,2662,2510,152,627,00:00:30.000,2025-04-06 02:48:26.106
false,false,2660,2508,152,567,00:00:32.000,2025-04-06 02:47:26.081
false,false,2663,2511,152,659,00:00:32.000,2025-04-06 02:48:56.121
false,false,2664,2512,152,690,00:00:31.000,2025-04-06 02:49:26.130
false,false,2665,2513,152,721,00:00:31.000,2025-04-06 02:49:56.142
false,false,2666,2514,152,754,00:00:33.000,2025-04-06 02:50:26.154
false,false,2667,2515,152,785,00:00:31.000,2025-04-06 02:50:56.167
false,false,3916,3693,223,216,00:00:30.000,2025-04-06 17:42:46.726
false,false,3914,3692,222,154,00:00:31.000,2025-04-06 17:41:46.705
false,false,3917,3694,223,249,00:00:33.000,2025-04-06 17:43:16.738
false,false,3919,3696,223,310,00:00:31.000,2025-04-06 17:44:16.760
false,false,3915,3693,222,186,00:00:32.000,2025-04-06 17:42:16.716
false,false,3918,3695,223,279,00:00:30.000,2025-04-06 17:43:46.749
false,false,3921,3698,223,375,00:00:33.000,2025-04-06 17:45:16.786
false,false,3920,3697,223,342,00:00:32.000,2025-04-06 17:44:46.773
false,false,3925,3702,223,505,00:00:33.000,2025-04-06 17:47:16.826
false,false,3922,3699,223,407,00:00:32.000,2025-04-06 17:45:46.794
false,false,3923,3700,223,439,00:00:32.000,2025-04-06 17:46:16.807
false,false,3924,3701,223,472,00:00:33.000,2025-04-06 17:46:46.814
false,false,3927,3704,223,569,00:00:32.000,2025-04-06 17:48:16.849
false,false,3926,3703,223,537,00:00:32.000,2025-04-06 17:47:46.836
false,false,3929,3706,223,630,00:00:30.000,2025-04-06 17:49:16.867
false,false,3928,3705,223,600,00:00:31.000,2025-04-06 17:48:46.861
false,false,3931,3708,223,695,00:00:33.000,2025-04-06 17:50:16.887
false,false,3930,3707,223,662,00:00:32.000,2025-04-06 17:49:46.880
false,false,3935,3712,223,821,00:00:31.000,2025-04-06 17:52:16.915
false,false,3934,3711,223,790,00:00:33.000,2025-04-06 17:51:46.906
false,false,3936,3713,223,851,00:00:30.000,2025-04-06 17:52:46.927
false,false,3933,3710,223,757,00:00:32.000,2025-04-06 17:51:16.900
false,false,3937,3714,223,883,00:00:32.000,2025-04-06 17:53:16.937
false,false,3938,3715,223,914,00:00:31.000,2025-04-06 17:53:46.949
false,false,3932,3709,223,725,00:00:30.000,2025-04-06 17:50:46.899
false,false,3940,3717,223,977,00:00:32.000,2025-04-06 17:54:46.971
false,false,3939,3716,223,945,00:00:31.000,2025-04-06 17:54:16.959
false,false,3941,3718,223,1007,00:00:30.000,2025-04-06 17:55:16.982
false,false,3944,3721,223,1105,00:00:33.000,2025-04-06 17:56:47.016
false,false,3943,3720,223,1072,00:00:33.000,2025-04-06 17:56:17.005
false,false,3942,3719,223,1039,00:00:32.000,2025-04-06 17:55:46.995
false,false,3945,3721,224,1136,00:00:31.000,2025-04-06 17:57:17.023
false,false,3947,3723,224,1198,00:00:32.000,2025-04-06 17:58:17.044
false,false,3946,3722,224,1166,00:00:30.000,2025-04-06 17:57:47.033
false,false,3950,3726,224,1292,00:00:33.000,2025-04-06 17:59:47.075
false,false,3949,3725,224,1259,00:00:31.000,2025-04-06 17:59:17.065
false,false,3948,3724,224,1228,00:00:30.000,2025-04-06 17:58:47.055
false,false,3952,3728,224,1357,00:00:33.000,2025-04-06 18:00:47.094
false,false,3953,3729,224,1389,00:00:32.000,2025-04-06 18:01:17.105
false,false,3951,3727,224,1324,00:00:32.000,2025-04-06 18:00:17.082
false,false,3954,3730,224,1419,00:00:30.000,2025-04-06 18:01:47.114
false,false,3955,3731,224,1450,00:00:31.000,2025-04-06 18:02:17.121
false,false,3957,3733,224,1512,00:00:31.000,2025-04-06 18:03:17.141
false,true,3958,3734,224,0,00:00:00.000,2025-04-06 18:04:17.164
false,false,3958,3734,224,1545,00:00:33.000,2025-04-06 18:03:47.152
false,false,3956,3732,224,1481,00:00:31.000,2025-04-06 18:02:47.130
false,true,3958,3734,224,0,00:00:00.000,2025-04-06 18:04:47.175
false,true,3958,3734,224,0,00:00:00.000,2025-04-06 18:05:17.188
false,true,3958,3734,224,0,00:00:00.000,2025-04-06 18:05:47.200
false,true,3958,3734,224,0,00:00:00.000,2025-04-06 18:06:17.210
false,true,3958,3734,224,0,00:00:00.000,2025-04-06 18:06:47.221
false,false,3960,3735,225,62,00:00:31.000,2025-04-06 18:07:47.246
false,false,3959,3734,225,31,00:00:31.000,2025-04-06 18:07:17.233
false,false,3961,3736,225,93,00:00:31.000,2025-04-06 18:08:17.259
false,false,3962,3737,225,123,00:00:30.000,2025-04-06 18:08:47.270
false,false,3963,3738,225,156,00:00:33.000,2025-04-06 18:09:17.281
false,false,3965,3740,225,217,00:00:31.000,2025-04-06 18:10:17.305
false,false,3964,3739,225,186,00:00:30.000,2025-04-06 18:09:47.292
false,false,3968,3743,225,310,00:00:32.000,2025-04-06 18:11:47.338
false,false,3966,3741,225,247,00:00:30.000,2025-04-06 18:10:47.317
false,false,3967,3742,225,278,00:00:31.000,2025-04-06 18:11:17.327
false,false,3972,3747,225,435,00:00:30.000,2025-04-06 18:13:47.384
false,true,3973,3748,225,0,00:00:00.000,2025-04-06 18:14:47.407
false,false,3970,3745,225,373,00:00:30.000,2025-04-06 18:12:47.364
false,false,3969,3744,225,343,00:00:33.000,2025-04-06 18:12:17.351
false,false,3973,3748,225,467,00:00:32.000,2025-04-06 18:14:17.394
false,false,3971,3746,225,405,00:00:32.000,2025-04-06 18:13:17.371
false,true,3973,3748,225,0,00:00:00.000,2025-04-06 18:15:47.419
false,true,3973,3748,225,0,00:00:00.000,2025-04-06 18:15:17.416
false,true,3973,3748,225,0,00:00:00.000,2025-04-06 18:17:17.453
false,true,3973,3748,225,0,00:00:00.000,2025-04-06 18:16:17.431
false,true,3973,3748,225,0,00:00:00.000,2025-04-06 18:16:47.443
false,false,3974,3749,225,32,00:00:32.000,2025-04-06 18:17:47.454
false,false,3975,3750,225,63,00:00:31.000,2025-04-06 18:18:17.461
false,false,3977,3752,225,124,00:00:31.000,2025-04-06 18:19:17.483
false,false,3978,3753,225,156,00:00:32.000,2025-04-06 18:19:47.492
false,false,3976,3751,225,93,00:00:30.000,2025-04-06 18:18:47.473
false,false,3979,3754,225,186,00:00:30.000,2025-04-06 18:20:17.504
false,false,3980,3755,225,218,00:00:32.000,2025-04-06 18:20:47.517
false,false,3981,3756,225,248,00:00:30.000,2025-04-06 18:21:17.527
false,false,3984,3759,225,342,00:00:32.000,2025-04-06 18:22:47.556
false,false,3982,3757,225,279,00:00:31.000,2025-04-06 18:21:47.539
false,false,3986,3760,226,404,00:00:31.000,2025-04-06 18:23:47.580
false,false,3983,3758,225,310,00:00:31.000,2025-04-06 18:22:17.549
false,false,3989,3763,226,501,00:00:32.000,2025-04-06 18:25:17.616
false,false,3988,3762,226,469,00:00:32.000,2025-04-06 18:24:47.603
false,false,3987,3761,226,437,00:00:33.000,2025-04-06 18:24:17.591
false,false,3985,3759,226,373,00:00:31.000,2025-04-06 18:23:17.568
false,false,3990,3764,226,534,00:00:33.000,2025-04-06 18:25:47.626
false,false,3993,3766,227,631,00:00:32.000,2025-04-06 18:27:17.660
false,false,3991,3765,226,567,00:00:33.000,2025-04-06 18:26:17.636
false,false,3992,3765,227,599,00:00:32.000,2025-04-06 18:26:47.648
false,true,3993,3766,227,0,00:00:00.000,2025-04-06 18:28:17.683
false,true,3993,3766,227,0,00:00:00.000,2025-04-06 18:27:47.672
false,true,3993,3766,227,0,00:00:00.000,2025-04-06 18:28:47.693
false,true,3993,3766,227,0,00:00:00.000,2025-04-06 18:29:17.704
false,true,3993,3766,227,0,00:00:00.000,2025-04-06 18:30:17.725
false,false,3994,3767,227,30,00:00:30.000,2025-04-06 18:30:47.736
false,true,3993,3766,227,0,00:00:00.000,2025-04-06 18:29:47.715
false,false,3995,3768,227,63,00:00:33.000,2025-04-06 18:31:17.745
false,false,3998,3771,227,158,00:00:31.000,2025-04-06 18:32:47.764
false,false,3996,3769,227,95,00:00:32.000,2025-04-06 18:31:47.754
false,false,3997,3770,227,127,00:00:32.000,2025-04-06 18:32:17.759
false,false,4000,3773,227,219,00:00:31.000,2025-04-06 18:33:47.783
false,false,3999,3772,227,188,00:00:30.000,2025-04-06 18:33:17.773
false,false,4001,3774,227,250,00:00:31.000,2025-04-06 18:34:17.792
false,true,4001,3774,227,0,00:00:00.000,2025-04-06 18:34:47.805
false,true,4001,3774,227,0,00:00:00.000,2025-04-06 18:35:47.828
false,true,4001,3774,227,0,00:00:00.000,2025-04-06 18:35:17.817
false,true,4001,3774,227,0,00:00:00.000,2025-04-06 18:36:47.850
false,true,4001,3774,227,0,00:00:00.000,2025-04-06 18:36:17.839
false,true,4001,3774,227,0,00:00:00.000,2025-04-06 18:37:17.861
false,false,4003,3775,228,60,00:00:30.000,2025-04-06 18:38:17.885
false,false,4002,3775,227,30,00:00:30.000,2025-04-06 18:37:47.873
false,false,4005,3777,228,121,00:00:31.000,2025-04-06 18:39:17.902
false,false,4004,3776,228,90,00:00:30.000,2025-04-06 18:38:47.890
false,false,4007,3779,228,184,00:00:31.000,2025-04-06 18:40:17.926
false,false,4006,3778,228,153,00:00:32.000,2025-04-06 18:39:47.913
false,false,4008,3780,228,216,00:00:32.000,2025-04-06 18:40:47.938
false,true,4008,3780,228,0,00:00:00.000,2025-04-06 18:42:47.986
false,true,4008,3780,228,0,00:00:00.000,2025-04-06 18:41:47.963
false,true,4008,3780,228,0,00:00:00.000,2025-04-06 18:43:17.994
false,true,4008,3780,228,0,00:00:00.000,2025-04-06 18:42:17.975
false,true,4008,3780,228,0,00:00:00.000,2025-04-06 18:43:48.005
false,true,4008,3780,228,0,00:00:00.000,2025-04-06 18:41:17.950
false,false,4009,3781,228,32,00:00:32.000,2025-04-06 18:44:18.016
false,false,4011,3783,228,94,00:00:31.000,2025-04-06 18:45:18.036
false,false,4010,3782,228,63,00:00:31.000,2025-04-06 18:44:48.025
false,false,3188,3005,183,154,00:00:30.000,2025-04-06 09:11:35.128
false,false,3190,3007,183,219,00:00:33.000,2025-04-06 09:12:35.152
false,false,3191,3008,183,249,00:00:30.000,2025-04-06 09:13:05.165
false,false,3189,3006,183,186,00:00:32.000,2025-04-06 09:12:05.139
false,false,3186,3004,182,94,00:00:30.000,2025-04-06 09:10:35.111
false,false,3187,3004,183,124,00:00:30.000,2025-04-06 09:11:05.118
false,false,3192,3009,183,282,00:00:33.000,2025-04-06 09:13:35.179
false,false,3194,3011,183,348,00:00:33.000,2025-04-06 09:14:35.199
false,false,3197,3014,183,445,00:00:32.000,2025-04-06 09:16:05.236
false,false,3195,3012,183,381,00:00:33.000,2025-04-06 09:15:05.209
false,false,3193,3010,183,315,00:00:33.000,2025-04-06 09:14:05.189
false,false,3198,3015,183,477,00:00:32.000,2025-04-06 09:16:35.239
false,false,3196,3013,183,413,00:00:32.000,2025-04-06 09:15:35.222
false,false,3199,3016,183,508,00:00:31.000,2025-04-06 09:17:05.252
false,false,3201,3018,183,571,00:00:31.000,2025-04-06 09:18:05.278
false,false,3203,3020,183,637,00:00:33.000,2025-04-06 09:19:05.295
false,false,3202,3019,183,604,00:00:33.000,2025-04-06 09:18:35.283
false,false,3200,3017,183,540,00:00:32.000,2025-04-06 09:17:35.263
false,false,3204,3021,183,669,00:00:32.000,2025-04-06 09:19:35.308
false,true,3204,3021,183,0,00:00:00.000,2025-04-06 09:20:05.322
false,true,3204,3021,183,0,00:00:00.000,2025-04-06 09:20:35.334
false,true,3204,3021,183,0,00:00:00.000,2025-04-06 09:21:35.348
false,true,3204,3021,183,0,00:00:00.000,2025-04-06 09:22:35.369
false,true,3204,3021,183,0,00:00:00.000,2025-04-06 09:22:05.358
false,true,3204,3021,183,0,00:00:00.000,2025-04-06 09:21:05.340
false,false,3208,3025,183,127,00:00:31.000,2025-04-06 09:24:35.416
false,false,3206,3023,183,63,00:00:33.000,2025-04-06 09:23:35.391
false,false,3207,3024,183,96,00:00:33.000,2025-04-06 09:24:05.403
false,false,3205,3022,183,30,00:00:30.000,2025-04-06 09:23:05.381
false,false,3209,3026,183,157,00:00:30.000,2025-04-06 09:25:05.427
false,false,3210,3027,183,188,00:00:31.000,2025-04-06 09:25:35.442
false,false,3211,3027,184,221,00:00:33.000,2025-04-06 09:26:05.448
false,false,3213,3029,184,282,00:00:30.000,2025-04-06 09:27:05.472
false,false,3212,3028,184,252,00:00:31.000,2025-04-06 09:26:35.459
false,false,3216,3032,184,378,00:00:33.000,2025-04-06 09:28:35.506
false,false,3214,3030,184,313,00:00:31.000,2025-04-06 09:27:35.482
false,false,3215,3031,184,345,00:00:32.000,2025-04-06 09:28:05.492
false,false,3218,3034,184,439,00:00:30.000,2025-04-06 09:29:35.532
false,false,3219,3035,184,471,00:00:32.000,2025-04-06 09:30:05.539
false,false,3217,3033,184,409,00:00:31.000,2025-04-06 09:29:05.519
false,false,3222,3037,185,563,00:00:30.000,2025-04-06 09:31:35.570
false,false,3220,3036,184,503,00:00:32.000,2025-04-06 09:30:35.552
false,false,3221,3037,184,533,00:00:30.000,2025-04-06 09:31:05.561
false,false,3224,3039,185,623,00:00:30.000,2025-04-06 09:32:35.589
false,false,3223,3038,185,593,00:00:30.000,2025-04-06 09:32:05.581
false,false,3226,3041,185,689,00:00:33.000,2025-04-06 09:33:35.617
false,false,3228,3043,185,752,00:00:31.000,2025-04-06 09:34:35.640
false,false,3227,3042,185,721,00:00:32.000,2025-04-06 09:34:05.628
false,false,3225,3040,185,656,00:00:33.000,2025-04-06 09:33:05.604
false,false,3230,3044,186,813,00:00:31.000,2025-04-06 09:35:35.662
false,false,3231,3044,187,843,00:00:30.000,2025-04-06 09:36:05.671
false,false,3232,3045,187,874,00:00:31.000,2025-04-06 09:36:35.684
false,true,3232,3045,187,0,00:00:00.000,2025-04-06 09:37:05.696
false,false,3229,3044,185,782,00:00:30.000,2025-04-06 09:35:05.649
false,true,3232,3045,187,0,00:00:00.000,2025-04-06 09:37:35.707
false,true,3232,3045,187,0,00:00:00.000,2025-04-06 09:39:05.744
false,true,3232,3045,187,0,00:00:00.000,2025-04-06 09:38:05.721
false,true,3232,3045,187,0,00:00:00.000,2025-04-06 09:38:35.734
false,true,3232,3045,187,0,00:00:00.000,2025-04-06 09:39:35.755
false,false,3235,3048,187,91,00:00:31.000,2025-04-06 09:41:05.780
false,false,3234,3047,187,60,00:00:30.000,2025-04-06 09:40:35.766
false,false,3233,3046,187,30,00:00:30.000,2025-04-06 09:40:05.756
false,false,3236,3049,187,123,00:00:32.000,2025-04-06 09:41:35.793
false,false,3237,3050,187,156,00:00:33.000,2025-04-06 09:42:05.806
false,false,3238,3051,187,186,00:00:30.000,2025-04-06 09:42:35.820
false,false,3239,3052,187,217,00:00:31.000,2025-04-06 09:43:05.831
false,false,3242,3055,187,309,00:00:30.000,2025-04-06 09:44:35.871
false,false,3243,3056,187,340,00:00:31.000,2025-04-06 09:45:05.881
false,false,3241,3054,187,279,00:00:30.000,2025-04-06 09:44:05.861
false,false,3240,3053,187,249,00:00:32.000,2025-04-06 09:43:35.846
false,false,3244,3057,187,373,00:00:33.000,2025-04-06 09:45:35.894
false,false,3246,3059,187,437,00:00:31.000,2025-04-06 09:46:35.921
false,false,3245,3058,187,406,00:00:33.000,2025-04-06 09:46:05.909
false,false,3247,3060,187,470,00:00:33.000,2025-04-06 09:47:05.933
false,false,3249,3062,187,530,00:00:30.000,2025-04-06 09:48:05.962
false,false,3250,3063,187,560,00:00:30.000,2025-04-06 09:48:35.974
false,true,3250,3063,187,0,00:00:00.000,2025-04-06 09:49:05.987
false,false,3248,3061,187,500,00:00:30.000,2025-04-06 09:47:35.947
false,true,3250,3063,187,0,00:00:00.000,2025-04-06 09:49:35.998
false,true,3250,3063,187,0,00:00:00.000,2025-04-06 09:50:36.027
false,true,3250,3063,187,0,00:00:00.000,2025-04-06 09:50:06.013
false,false,3251,3064,187,30,00:00:30.000,2025-04-06 09:52:06.065
false,false,3252,3065,187,61,00:00:31.000,2025-04-06 09:52:36.080
false,false,3253,3066,187,93,00:00:32.000,2025-04-06 09:53:06.091
false,true,3250,3063,187,0,00:00:00.000,2025-04-06 09:51:06.041
false,false,3254,3067,187,125,00:00:32.000,2025-04-06 09:53:36.106
false,true,3250,3063,187,0,00:00:00.000,2025-04-06 09:51:36.055
false,true,3254,3067,187,0,00:00:00.000,2025-04-06 09:54:06.114
false,true,3254,3067,187,0,00:00:00.000,2025-04-06 09:55:06.136
false,true,3254,3067,187,0,00:00:00.000,2025-04-06 09:54:36.126
false,true,3254,3067,187,0,00:00:00.000,2025-04-06 09:56:06.150
false,true,3254,3067,187,0,00:00:00.000,2025-04-06 09:55:36.141
false,true,3254,3067,187,0,00:00:00.000,2025-04-06 09:56:36.161
false,false,3255,3068,187,31,00:00:31.000,2025-04-06 09:57:06.175
false,false,3256,3069,187,61,00:00:30.000,2025-04-06 09:57:36.186
false,false,3258,3071,187,125,00:00:31.000,2025-04-06 09:58:36.214
false,false,3260,3073,187,191,00:00:33.000,2025-04-06 09:59:36.242
false,false,3261,3074,187,224,00:00:33.000,2025-04-06 10:00:06.249
false,false,3259,3072,187,158,00:00:33.000,2025-04-06 09:59:06.229
false,false,3257,3070,187,94,00:00:33.000,2025-04-06 09:58:06.201
false,false,3262,3075,187,254,00:00:30.000,2025-04-06 10:00:36.263
false,false,3264,3077,187,315,00:00:30.000,2025-04-06 10:01:36.290
false,false,3263,3076,187,285,00:00:31.000,2025-04-06 10:01:06.275
false,false,3265,3078,187,348,00:00:33.000,2025-04-06 10:02:06.299
false,false,3268,3081,187,444,00:00:31.000,2025-04-06 10:03:36.340
false,false,3266,3079,187,380,00:00:32.000,2025-04-06 10:02:36.314
false,false,3267,3080,187,413,00:00:33.000,2025-04-06 10:03:06.326
false,false,3270,3083,187,507,00:00:30.000,2025-04-06 10:04:36.363
false,false,3271,3084,187,537,00:00:30.000,2025-04-06 10:05:06.378
false,false,3269,3082,187,477,00:00:33.000,2025-04-06 10:04:06.350
false,false,3272,3085,187,567,00:00:30.000,2025-04-06 10:05:36.391
false,false,3275,3088,187,665,00:00:33.000,2025-04-06 10:07:06.425
false,false,3273,3086,187,599,00:00:32.000,2025-04-06 10:06:06.405
false,false,3274,3087,187,632,00:00:33.000,2025-04-06 10:06:36.418
false,false,3276,3089,187,697,00:00:32.000,2025-04-06 10:07:36.436
false,false,3278,3091,187,757,00:00:30.000,2025-04-06 10:08:36.461
false,false,3277,3090,187,727,00:00:30.000,2025-04-06 10:08:06.451
false,true,3278,3091,187,0,00:00:00.000,2025-04-06 10:09:06.472
false,true,3278,3091,187,0,00:00:00.000,2025-04-06 10:09:36.485
false,true,3278,3091,187,0,00:00:00.000,2025-04-06 10:10:06.499
false,true,3278,3091,187,0,00:00:00.000,2025-04-06 10:10:36.514
false,true,3278,3091,187,0,00:00:00.000,2025-04-06 10:11:06.525
false,true,3278,3091,187,0,00:00:00.000,2025-04-06 10:11:36.538
false,false,3280,3093,187,63,00:00:30.000,2025-04-06 10:12:36.562
false,false,3279,3092,187,33,00:00:33.000,2025-04-06 10:12:06.552
false,false,3282,3095,187,124,00:00:31.000,2025-04-06 10:13:36.585
false,false,3281,3094,187,93,00:00:30.000,2025-04-06 10:13:06.574
false,true,23,22,1,0,00:00:00.000,2025-04-04 21:05:19.509
false,true,23,22,1,0,00:00:00.000,2025-04-04 21:03:49.502
false,false,22,21,1,128,00:00:33.000,2025-04-04 21:02:49.494
false,false,23,22,1,160,00:00:32.000,2025-04-04 21:03:19.498
false,true,23,22,1,0,00:00:00.000,2025-04-04 21:04:19.504
false,true,23,22,1,0,00:00:00.000,2025-04-04 21:04:49.505
false,false,24,23,1,31,00:00:31.000,2025-04-04 21:06:49.515
false,true,23,22,1,0,00:00:00.000,2025-04-04 21:06:19.513
false,false,27,26,1,129,00:00:32.000,2025-04-04 21:08:19.522
false,true,23,22,1,0,00:00:00.000,2025-04-04 21:05:49.510
false,false,26,25,1,97,00:00:33.000,2025-04-04 21:07:49.520
false,false,25,24,1,64,00:00:33.000,2025-04-04 21:07:19.519
false,false,29,28,1,192,00:00:33.000,2025-04-04 21:09:19.527
false,false,28,27,1,159,00:00:30.000,2025-04-04 21:08:49.523
false,false,30,29,1,222,00:00:30.000,2025-04-04 21:09:49.528
false,false,31,30,1,255,00:00:33.000,2025-04-04 21:10:19.531
false,false,32,31,1,288,00:00:33.000,2025-04-04 21:10:49.534
false,false,33,32,1,320,00:00:32.000,2025-04-04 21:11:19.536
false,false,34,33,1,350,00:00:30.000,2025-04-04 21:11:49.536
false,false,37,35,2,443,00:00:30.000,2025-04-04 21:13:19.546
false,false,35,34,1,380,00:00:30.000,2025-04-04 21:12:19.540
false,false,38,36,2,474,00:00:31.000,2025-04-04 21:13:49.547
false,false,39,37,2,506,00:00:32.000,2025-04-04 21:14:19.550
false,false,36,34,2,413,00:00:33.000,2025-04-04 21:12:49.543
false,false,40,38,2,536,00:00:30.000,2025-04-04 21:14:49.554
false,false,41,39,2,568,00:00:32.000,2025-04-04 21:15:19.556
false,false,43,41,2,629,00:00:31.000,2025-04-04 21:16:19.560
false,true,43,41,2,0,00:00:00.000,2025-04-04 21:17:19.565
false,false,42,40,2,598,00:00:30.000,2025-04-04 21:15:49.560
false,true,43,41,2,0,00:00:00.000,2025-04-04 21:18:19.572
false,true,43,41,2,0,00:00:00.000,2025-04-04 21:17:49.569
false,true,43,41,2,0,00:00:00.000,2025-04-04 21:16:49.563
false,true,43,41,2,0,00:00:00.000,2025-04-04 21:18:49.574
false,true,43,41,2,0,00:00:00.000,2025-04-04 21:19:19.578
false,false,45,43,2,65,00:00:32.000,2025-04-04 21:20:19.581
false,false,44,42,2,33,00:00:33.000,2025-04-04 21:19:49.579
false,false,47,45,2,128,00:00:30.000,2025-04-04 21:21:19.588
false,false,46,44,2,98,00:00:33.000,2025-04-04 21:20:49.585
false,false,48,46,2,161,00:00:33.000,2025-04-04 21:21:49.591
false,true,48,46,2,0,00:00:00.000,2025-04-04 21:23:19.597
false,true,48,46,2,0,00:00:00.000,2025-04-04 21:22:49.596
false,true,48,46,2,0,00:00:00.000,2025-04-04 21:22:19.592
false,true,48,46,2,0,00:00:00.000,2025-04-04 21:23:49.601
false,true,48,46,2,0,00:00:00.000,2025-04-04 21:24:49.604
false,true,48,46,2,0,00:00:00.000,2025-04-04 21:24:19.602
false,false,49,47,2,33,00:00:33.000,2025-04-04 21:25:19.605
false,false,50,48,2,64,00:00:31.000,2025-04-04 21:25:49.609
false,true,51,49,2,0,00:00:00.000,2025-04-04 21:27:49.621
false,false,51,49,2,96,00:00:32.000,2025-04-04 21:26:19.610
false,true,51,49,2,0,00:00:00.000,2025-04-04 21:26:49.613
false,true,51,49,2,0,00:00:00.000,2025-04-04 21:27:19.617
false,true,51,49,2,0,00:00:00.000,2025-04-04 21:29:19.627
false,true,51,49,2,0,00:00:00.000,2025-04-04 21:28:19.624
false,true,51,49,2,0,00:00:00.000,2025-04-04 21:28:49.625
false,true,51,49,2,0,00:00:00.000,2025-04-04 21:30:19.635
false,true,51,49,2,0,00:00:00.000,2025-04-04 21:30:49.639
false,true,51,49,2,0,00:00:00.000,2025-04-04 21:29:49.631
false,true,51,49,2,0,00:00:00.000,2025-04-04 21:31:19.642
false,true,51,49,2,0,00:00:00.000,2025-04-04 21:31:49.646
false,false,52,50,2,32,00:00:32.000,2025-04-04 21:32:49.651
false,false,53,51,2,65,00:00:33.000,2025-04-04 21:33:19.652
false,true,51,49,2,0,00:00:00.000,2025-04-04 21:32:19.649
false,true,54,52,2,0,00:00:00.000,2025-04-04 21:34:19.656
false,false,54,52,2,97,00:00:32.000,2025-04-04 21:33:49.655
false,true,54,52,2,0,00:00:00.000,2025-04-04 21:34:49.659
false,true,54,52,2,0,00:00:00.000,2025-04-04 21:35:19.662
false,true,54,52,2,0,00:00:00.000,2025-04-04 21:36:19.666
false,true,54,52,2,0,00:00:00.000,2025-04-04 21:35:49.664
false,true,54,52,2,0,00:00:00.000,2025-04-04 21:36:49.668
false,false,55,53,2,31,00:00:31.000,2025-04-04 21:37:19.669
false,false,56,54,2,61,00:00:30.000,2025-04-04 21:37:49.670
false,false,57,55,2,91,00:00:30.000,2025-04-04 21:38:19.674
false,false,58,56,2,124,00:00:33.000,2025-04-04 21:38:49.677
false,false,59,57,2,156,00:00:32.000,2025-04-04 21:39:19.679
false,false,60,58,2,187,00:00:31.000,2025-04-04 21:39:49.683
false,false,64,61,3,313,00:00:33.000,2025-04-04 21:41:49.697
false,false,63,60,3,280,00:00:31.000,2025-04-04 21:41:19.693
false,false,62,59,3,249,00:00:30.000,2025-04-04 21:40:49.689
false,false,66,63,3,377,00:00:33.000,2025-04-04 21:42:49.702
false,false,65,62,3,344,00:00:31.000,2025-04-04 21:42:19.698
false,false,67,64,3,407,00:00:30.000,2025-04-04 21:43:19.705
false,false,61,59,2,219,00:00:32.000,2025-04-04 21:40:19.685
false,false,68,65,3,438,00:00:31.000,2025-04-04 21:43:49.707
false,false,69,66,3,469,00:00:31.000,2025-04-04 21:44:19.709
false,false,72,69,3,566,00:00:32.000,2025-04-04 21:45:49.719
false,false,70,67,3,501,00:00:32.000,2025-04-04 21:44:49.712
false,false,71,68,3,534,00:00:33.000,2025-04-04 21:45:19.716
false,false,73,70,3,597,00:00:31.000,2025-04-04 21:46:19.722
false,false,74,71,3,630,00:00:33.000,2025-04-04 21:46:49.723
false,false,79,76,3,787,00:00:31.000,2025-04-04 21:49:19.737
false,false,75,72,3,662,00:00:32.000,2025-04-04 21:47:19.726
false,false,78,75,3,756,00:00:31.000,2025-04-04 21:48:49.733
false,false,76,73,3,694,00:00:32.000,2025-04-04 21:47:49.728
false,false,80,77,3,817,00:00:30.000,2025-04-04 21:49:49.740
false,false,77,74,3,725,00:00:31.000,2025-04-04 21:48:19.730
false,false,81,78,3,849,00:00:32.000,2025-04-04 21:50:19.744
false,false,84,80,4,943,00:00:32.000,2025-04-04 21:51:49.751
false,false,82,79,3,881,00:00:32.000,2025-04-04 21:50:49.747
false,false,85,81,4,976,00:00:33.000,2025-04-04 21:52:19.754
false,false,83,79,4,911,00:00:30.000,2025-04-04 21:51:19.749
false,false,87,83,4,1038,00:00:30.000,2025-04-04 21:53:19.759
false,false,86,82,4,1008,00:00:32.000,2025-04-04 21:52:49.757
false,true,88,84,4,0,00:00:00.000,2025-04-04 21:54:19.764
false,false,88,84,4,1069,00:00:31.000,2025-04-04 21:53:49.761
false,true,88,84,4,0,00:00:00.000,2025-04-04 21:54:49.767
false,true,88,84,4,0,00:00:00.000,2025-04-04 21:55:49.771
false,true,88,84,4,0,00:00:00.000,2025-04-04 21:55:19.770
false,false,89,85,4,32,00:00:32.000,2025-04-04 21:57:19.780
false,true,88,84,4,0,00:00:00.000,2025-04-04 21:56:19.775
false,true,88,84,4,0,00:00:00.000,2025-04-04 21:56:49.777
false,false,91,87,4,95,00:00:31.000,2025-04-04 21:58:19.784
false,false,93,89,4,157,00:00:31.000,2025-04-04 21:59:19.787
false,false,90,86,4,64,00:00:32.000,2025-04-04 21:57:49.782
false,false,92,88,4,126,00:00:31.000,2025-04-04 21:58:49.785
false,false,95,91,4,220,00:00:32.000,2025-04-04 22:00:19.791
false,true,95,91,4,0,00:00:00.000,2025-04-04 22:00:49.791
false,false,94,90,4,188,00:00:31.000,2025-04-04 21:59:49.790
false,true,95,91,4,0,00:00:00.000,2025-04-04 22:02:49.801
false,true,95,91,4,0,00:00:00.000,2025-04-04 22:01:19.793
false,true,95,91,4,0,00:00:00.000,2025-04-04 22:02:19.798
false,false,96,92,4,31,00:00:31.000,2025-04-04 22:03:49.804
false,true,95,91,4,0,00:00:00.000,2025-04-04 22:03:19.803
false,true,95,91,4,0,00:00:00.000,2025-04-04 22:01:49.796
false,false,97,93,4,61,00:00:30.000,2025-04-04 22:04:19.806
false,false,100,96,4,156,00:00:31.000,2025-04-04 22:05:49.815
false,false,98,94,4,93,00:00:32.000,2025-04-04 22:04:49.809
false,false,99,95,4,125,00:00:32.000,2025-04-04 22:05:19.812
false,false,101,97,4,187,00:00:31.000,2025-04-04 22:06:19.817
false,false,102,98,4,220,00:00:33.000,2025-04-04 22:06:49.819
false,false,103,99,4,250,00:00:30.000,2025-04-04 22:07:19.822
false,false,105,101,4,316,00:00:33.000,2025-04-04 22:08:19.826
false,false,106,102,4,348,00:00:32.000,2025-04-04 22:08:49.828
false,false,104,100,4,283,00:00:33.000,2025-04-04 22:07:49.823
false,false,107,103,4,380,00:00:32.000,2025-04-04 22:09:19.830
false,true,107,103,4,0,00:00:00.000,2025-04-04 22:09:49.831
false,true,107,103,4,0,00:00:00.000,2025-04-04 22:10:49.833
false,true,107,103,4,0,00:00:00.000,2025-04-04 22:11:19.836
false,true,107,103,4,0,00:00:00.000,2025-04-04 22:12:19.839
false,true,107,103,4,0,00:00:00.000,2025-04-04 22:10:19.832
false,true,107,103,4,0,00:00:00.000,2025-04-04 22:11:49.838
false,false,108,104,4,32,00:00:32.000,2025-04-04 22:12:49.842
false,true,108,104,4,0,00:00:00.000,2025-04-04 22:13:19.844
false,true,108,104,4,0,00:00:00.000,2025-04-04 22:13:49.846
false,false,405,385,20,64,00:00:31.000,2025-04-05 01:23:21.706
false,false,408,388,20,158,00:00:30.000,2025-04-05 01:24:51.739
false,false,404,384,20,33,00:00:33.000,2025-04-05 01:22:51.696
false,true,403,383,20,0,00:00:00.000,2025-04-05 01:22:21.682
false,false,406,386,20,97,00:00:33.000,2025-04-05 01:23:51.715
false,false,407,387,20,128,00:00:31.000,2025-04-05 01:24:21.728
false,false,411,391,20,253,00:00:33.000,2025-04-05 01:26:21.766
false,false,412,392,20,284,00:00:31.000,2025-04-05 01:26:51.780
false,false,414,394,20,349,00:00:33.000,2025-04-05 01:27:51.792
false,false,413,393,20,316,00:00:32.000,2025-04-05 01:27:21.788
false,false,410,390,20,220,00:00:31.000,2025-04-05 01:25:51.760
false,false,409,389,20,189,00:00:31.000,2025-04-05 01:25:21.753
false,false,417,397,20,441,00:00:30.000,2025-04-05 01:29:21.822
false,false,418,398,20,474,00:00:33.000,2025-04-05 01:29:51.828
false,false,419,399,20,505,00:00:31.000,2025-04-05 01:30:21.834
false,false,416,396,20,411,00:00:30.000,2025-04-05 01:28:51.809
false,false,415,395,20,381,00:00:32.000,2025-04-05 01:28:21.800
false,false,422,401,21,602,00:00:33.000,2025-04-05 01:31:51.867
false,false,420,400,20,536,00:00:31.000,2025-04-05 01:30:51.845
false,false,424,403,21,665,00:00:30.000,2025-04-05 01:32:51.891
false,false,423,402,21,635,00:00:33.000,2025-04-05 01:32:21.879
false,false,421,400,21,569,00:00:33.000,2025-04-05 01:31:21.853
false,false,426,405,21,729,00:00:32.000,2025-04-05 01:33:51.915
false,true,427,406,21,0,00:00:00.000,2025-04-05 01:34:51.939
false,false,427,406,21,762,00:00:33.000,2025-04-05 01:34:21.925
false,true,427,406,21,0,00:00:00.000,2025-04-05 01:35:21.941
false,false,425,404,21,697,00:00:32.000,2025-04-05 01:33:21.906
false,true,427,406,21,0,00:00:00.000,2025-04-05 01:35:51.952
false,true,427,406,21,0,00:00:00.000,2025-04-05 01:36:21.957
false,false,428,407,21,31,00:00:31.000,2025-04-05 01:37:51.971
false,true,427,406,21,0,00:00:00.000,2025-04-05 01:36:51.968
false,true,427,406,21,0,00:00:00.000,2025-04-05 01:37:21.969
false,false,429,408,21,61,00:00:30.000,2025-04-05 01:38:21.986
false,false,432,411,21,156,00:00:33.000,2025-04-05 01:39:52.010
false,false,430,409,21,92,00:00:31.000,2025-04-05 01:38:51.990
false,true,432,411,21,0,00:00:00.000,2025-04-05 01:40:22.021
false,true,432,411,21,0,00:00:00.000,2025-04-05 01:40:52.031
false,false,431,410,21,123,00:00:31.000,2025-04-05 01:39:22.003
false,true,432,411,21,0,00:00:00.000,2025-04-05 01:41:22.043
false,true,432,411,21,0,00:00:00.000,2025-04-05 01:41:52.054
false,true,432,411,21,0,00:00:00.000,2025-04-05 01:42:22.064
false,true,432,411,21,0,00:00:00.000,2025-04-05 01:42:52.076
false,false,433,412,21,32,00:00:32.000,2025-04-05 01:43:22.082
false,false,435,414,21,95,00:00:30.000,2025-04-05 01:44:22.110
false,false,434,413,21,65,00:00:33.000,2025-04-05 01:43:52.097
false,false,436,415,21,126,00:00:31.000,2025-04-05 01:44:52.121
false,false,439,418,21,222,00:00:32.000,2025-04-05 01:46:22.140
false,false,437,416,21,158,00:00:32.000,2025-04-05 01:45:22.123
false,false,440,419,21,255,00:00:33.000,2025-04-05 01:46:52.152
false,false,442,421,21,318,00:00:33.000,2025-04-05 01:47:52.174
false,false,438,417,21,190,00:00:32.000,2025-04-05 01:45:52.132
false,false,443,422,21,348,00:00:30.000,2025-04-05 01:48:22.187
false,false,441,420,21,285,00:00:30.000,2025-04-05 01:47:22.160
false,false,445,424,21,414,00:00:33.000,2025-04-05 01:49:22.201
false,false,446,425,21,447,00:00:33.000,2025-04-05 01:49:52.215
false,false,447,426,21,480,00:00:33.000,2025-04-05 01:50:22.227
false,false,448,427,21,513,00:00:33.000,2025-04-05 01:50:52.237
false,false,444,423,21,381,00:00:33.000,2025-04-05 01:48:52.200
false,false,450,429,21,576,00:00:31.000,2025-04-05 01:51:52.263
false,false,449,428,21,545,00:00:32.000,2025-04-05 01:51:22.248
false,false,452,431,21,638,00:00:30.000,2025-04-05 01:52:52.290
false,true,452,431,21,0,00:00:00.000,2025-04-05 01:53:52.315
false,false,451,430,21,608,00:00:32.000,2025-04-05 01:52:22.274
false,true,452,431,21,0,00:00:00.000,2025-04-05 01:54:22.331
false,true,452,431,21,0,00:00:00.000,2025-04-05 01:53:22.300
false,true,452,431,21,0,00:00:00.000,2025-04-05 01:55:22.359
false,true,452,431,21,0,00:00:00.000,2025-04-05 01:54:52.346
false,false,453,432,21,30,00:00:30.000,2025-04-05 01:56:22.380
false,false,454,433,21,63,00:00:33.000,2025-04-05 01:56:52.395
false,true,452,431,21,0,00:00:00.000,2025-04-05 01:55:52.372
false,false,455,434,21,94,00:00:31.000,2025-04-05 01:57:22.409
false,false,456,435,21,124,00:00:30.000,2025-04-05 01:57:52.423
false,false,458,437,21,187,00:00:30.000,2025-04-05 01:58:52.442
false,false,457,436,21,157,00:00:33.000,2025-04-05 01:58:22.431
false,true,460,439,21,0,00:00:00.000,2025-04-05 02:00:22.476
false,false,459,438,21,218,00:00:31.000,2025-04-05 01:59:22.456
false,false,460,439,21,249,00:00:31.000,2025-04-05 01:59:52.467
false,true,460,439,21,0,00:00:00.000,2025-04-05 02:00:52.486
false,true,460,439,21,0,00:00:00.000,2025-04-05 02:01:52.509
false,true,460,439,21,0,00:00:00.000,2025-04-05 02:01:22.498
false,true,460,439,21,0,00:00:00.000,2025-04-05 02:02:22.525
false,false,461,440,21,31,00:00:31.000,2025-04-05 02:03:22.542
false,true,460,439,21,0,00:00:00.000,2025-04-05 02:02:52.536
false,false,463,442,21,92,00:00:30.000,2025-04-05 02:04:22.571
false,false,462,441,21,62,00:00:31.000,2025-04-05 02:03:52.556
false,false,466,445,21,187,00:00:33.000,2025-04-05 02:05:52.598
false,false,465,444,21,154,00:00:32.000,2025-04-05 02:05:22.596
false,false,467,446,21,219,00:00:32.000,2025-04-05 02:06:22.609
false,false,464,443,21,122,00:00:30.000,2025-04-05 02:04:52.583
false,false,468,447,21,252,00:00:33.000,2025-04-05 02:06:52.624
false,false,469,448,21,283,00:00:31.000,2025-04-05 02:07:22.636
false,false,470,449,21,316,00:00:33.000,2025-04-05 02:07:52.642
false,false,471,450,21,349,00:00:33.000,2025-04-05 02:08:22.656
false,false,472,451,21,382,00:00:33.000,2025-04-05 02:08:52.663
false,false,473,452,21,413,00:00:31.000,2025-04-05 02:09:22.679
false,true,473,452,21,0,00:00:00.000,2025-04-05 02:09:52.691
false,true,473,452,21,0,00:00:00.000,2025-04-05 02:10:52.713
false,true,473,452,21,0,00:00:00.000,2025-04-05 02:11:52.729
false,true,473,452,21,0,00:00:00.000,2025-04-05 02:10:22.699
false,true,473,452,21,0,00:00:00.000,2025-04-05 02:12:22.738
false,false,477,455,22,127,00:00:31.000,2025-04-05 02:14:22.772
false,false,475,454,21,63,00:00:31.000,2025-04-05 02:13:22.755
false,true,473,452,21,0,00:00:00.000,2025-04-05 02:11:22.723
false,false,476,454,22,96,00:00:33.000,2025-04-05 02:13:52.765
false,false,474,453,21,32,00:00:32.000,2025-04-05 02:12:52.753
false,true,477,455,22,0,00:00:00.000,2025-04-05 02:17:22.842
false,true,477,455,22,0,00:00:00.000,2025-04-05 02:15:22.800
false,true,477,455,22,0,00:00:00.000,2025-04-05 02:15:52.814
false,true,477,455,22,0,00:00:00.000,2025-04-05 02:16:22.826
false,true,477,455,22,0,00:00:00.000,2025-04-05 02:14:52.786
false,false,479,457,22,65,00:00:32.000,2025-04-05 02:18:22.857
false,false,481,459,22,128,00:00:30.000,2025-04-05 02:19:22.887
false,false,478,456,22,33,00:00:33.000,2025-04-05 02:17:52.857
false,true,477,455,22,0,00:00:00.000,2025-04-05 02:16:52.833
false,false,480,458,22,98,00:00:33.000,2025-04-05 02:18:52.872
false,false,482,459,23,160,00:00:32.000,2025-04-05 02:19:52.896
false,false,483,460,23,193,00:00:33.000,2025-04-05 02:20:22.911
false,false,486,463,23,287,00:00:32.000,2025-04-05 02:21:52.944
false,false,487,464,23,320,00:00:33.000,2025-04-05 02:22:22.948
false,false,485,462,23,255,00:00:30.000,2025-04-05 02:21:22.930
false,false,488,465,23,351,00:00:31.000,2025-04-05 02:22:52.958
false,false,484,461,23,225,00:00:32.000,2025-04-05 02:20:52.922
false,false,489,466,23,384,00:00:33.000,2025-04-05 02:23:22.966
false,false,200,192,8,93,00:00:32.000,2025-04-04 23:16:50.070
false,false,203,195,8,187,00:00:31.000,2025-04-04 23:18:20.074
false,false,202,194,8,156,00:00:32.000,2025-04-04 23:17:50.073
false,false,201,193,8,124,00:00:31.000,2025-04-04 23:17:20.072
false,false,199,191,8,61,00:00:31.000,2025-04-04 23:16:20.068
false,false,198,190,8,30,00:00:30.000,2025-04-04 23:15:50.066
false,false,205,197,8,250,00:00:32.000,2025-04-04 23:19:20.076
false,false,204,196,8,218,00:00:31.000,2025-04-04 23:18:50.075
false,false,207,199,8,311,00:00:31.000,2025-04-04 23:20:20.079
false,false,206,198,8,280,00:00:30.000,2025-04-04 23:19:50.078
false,false,209,200,9,374,00:00:33.000,2025-04-04 23:21:20.082
false,false,210,201,9,407,00:00:33.000,2025-04-04 23:21:50.084
false,false,208,200,8,341,00:00:30.000,2025-04-04 23:20:50.081
false,false,211,202,9,439,00:00:32.000,2025-04-04 23:22:20.084
false,false,213,204,9,500,00:00:30.000,2025-04-04 23:23:20.087
false,false,212,203,9,470,00:00:31.000,2025-04-04 23:22:50.086
false,false,214,205,9,530,00:00:30.000,2025-04-04 23:23:50.089
false,false,215,206,9,562,00:00:32.000,2025-04-04 23:24:20.090
false,true,216,207,9,0,00:00:00.000,2025-04-04 23:25:50.094
false,true,216,207,9,0,00:00:00.000,2025-04-04 23:25:20.093
false,true,216,207,9,0,00:00:00.000,2025-04-04 23:26:20.095
false,false,216,207,9,594,00:00:32.000,2025-04-04 23:24:50.092
false,true,216,207,9,0,00:00:00.000,2025-04-04 23:26:50.096
false,true,216,207,9,0,00:00:00.000,2025-04-04 23:27:20.098
false,true,216,207,9,0,00:00:00.000,2025-04-04 23:27:50.099
false,false,217,208,9,32,00:00:32.000,2025-04-04 23:28:20.100
false,false,220,211,9,127,00:00:33.000,2025-04-04 23:29:50.104
false,false,218,209,9,64,00:00:32.000,2025-04-04 23:28:50.101
false,false,219,210,9,94,00:00:30.000,2025-04-04 23:29:20.103
false,false,222,213,9,190,00:00:32.000,2025-04-04 23:30:50.107
false,false,221,212,9,158,00:00:31.000,2025-04-04 23:30:20.105
false,false,225,215,10,287,00:00:33.000,2025-04-04 23:32:20.112
false,false,224,215,9,254,00:00:31.000,2025-04-04 23:31:50.110
false,false,227,217,10,350,00:00:33.000,2025-04-04 23:33:20.114
false,false,223,214,9,223,00:00:33.000,2025-04-04 23:31:20.108
false,false,228,218,10,381,00:00:31.000,2025-04-04 23:33:50.116
false,false,226,216,10,317,00:00:30.000,2025-04-04 23:32:50.114
false,false,230,220,10,447,00:00:33.000,2025-04-04 23:34:50.117
false,false,229,219,10,414,00:00:33.000,2025-04-04 23:34:20.116
false,false,231,221,10,478,00:00:31.000,2025-04-04 23:35:20.118
false,false,233,223,10,542,00:00:32.000,2025-04-04 23:36:20.120
false,false,232,222,10,510,00:00:32.000,2025-04-04 23:35:50.119
false,false,234,224,10,575,00:00:33.000,2025-04-04 23:36:50.121
false,false,235,225,10,605,00:00:30.000,2025-04-04 23:37:20.122
false,true,235,225,10,0,00:00:00.000,2025-04-04 23:37:50.123
false,true,235,225,10,0,00:00:00.000,2025-04-04 23:38:20.124
false,true,235,225,10,0,00:00:00.000,2025-04-04 23:38:50.125
false,true,235,225,10,0,00:00:00.000,2025-04-04 23:39:50.126
false,true,235,225,10,0,00:00:00.000,2025-04-04 23:39:20.125
false,true,235,225,10,0,00:00:00.000,2025-04-04 23:40:20.127
false,true,235,225,10,0,00:00:00.000,2025-04-04 23:40:50.127
false,true,235,225,10,0,00:00:00.000,2025-04-04 23:41:50.129
false,true,235,225,10,0,00:00:00.000,2025-04-04 23:41:20.128
false,true,235,225,10,0,00:00:00.000,2025-04-04 23:42:20.129
false,true,235,225,10,0,00:00:00.000,2025-04-04 23:42:50.130
false,false,236,226,10,32,00:00:32.000,2025-04-04 23:43:50.131
false,true,235,225,10,0,00:00:00.000,2025-04-04 23:43:20.130
false,false,238,228,10,94,00:00:32.000,2025-04-04 23:44:50.132
false,false,239,229,10,125,00:00:31.000,2025-04-04 23:45:20.133
false,false,241,231,10,191,00:00:33.000,2025-04-04 23:46:20.134
false,false,240,230,10,158,00:00:33.000,2025-04-04 23:45:50.133
false,false,242,232,10,224,00:00:33.000,2025-04-04 23:46:50.136
false,false,237,227,10,62,00:00:30.000,2025-04-04 23:44:20.132
false,false,243,233,10,256,00:00:32.000,2025-04-04 23:47:20.137
false,false,244,234,10,286,00:00:30.000,2025-04-04 23:47:50.138
false,false,246,236,10,348,00:00:30.000,2025-04-04 23:48:50.139
false,false,249,239,10,443,00:00:31.000,2025-04-04 23:50:20.142
false,false,250,240,10,474,00:00:31.000,2025-04-04 23:50:50.142
false,false,247,237,10,381,00:00:33.000,2025-04-04 23:49:20.140
false,false,245,235,10,318,00:00:32.000,2025-04-04 23:48:20.138
false,false,251,241,10,507,00:00:33.000,2025-04-04 23:51:20.143
false,false,248,238,10,412,00:00:31.000,2025-04-04 23:49:50.141
false,false,252,242,10,538,00:00:31.000,2025-04-04 23:51:50.145
false,false,254,244,10,602,00:00:33.000,2025-04-04 23:52:50.146
false,false,253,243,10,569,00:00:31.000,2025-04-04 23:52:20.145
false,false,256,246,10,665,00:00:32.000,2025-04-04 23:53:50.148
false,false,258,248,10,731,00:00:33.000,2025-04-04 23:54:50.149
false,false,257,247,10,698,00:00:33.000,2025-04-04 23:54:20.148
false,false,259,249,10,764,00:00:33.000,2025-04-04 23:55:20.150
false,false,255,245,10,633,00:00:31.000,2025-04-04 23:53:20.147
false,false,262,252,10,856,00:00:30.000,2025-04-04 23:56:50.151
false,false,260,250,10,795,00:00:31.000,2025-04-04 23:55:50.150
false,false,261,251,10,826,00:00:31.000,2025-04-04 23:56:20.150
false,false,264,254,10,918,00:00:30.000,2025-04-04 23:57:50.153
false,false,265,255,10,949,00:00:31.000,2025-04-04 23:58:20.154
false,false,266,256,10,980,00:00:31.000,2025-04-04 23:58:50.155
false,false,263,253,10,888,00:00:32.000,2025-04-04 23:57:20.152
false,true,266,256,10,0,00:00:00.000,2025-04-04 23:59:20.155
false,true,266,256,10,0,00:00:00.000,2025-04-05 00:00:20.156
false,true,266,256,10,0,00:00:00.000,2025-04-04 23:59:50.156
false,true,266,256,10,0,00:00:00.000,2025-04-05 00:01:50.159
false,true,266,256,10,0,00:00:00.000,2025-04-05 00:00:50.157
false,true,266,256,10,0,00:00:00.000,2025-04-05 00:01:20.158
false,false,268,258,10,64,00:00:31.000,2025-04-05 00:02:50.160
false,false,267,257,10,33,00:00:33.000,2025-04-05 00:02:20.159
false,false,270,260,10,125,00:00:31.000,2025-04-05 00:03:50.161
false,false,272,262,10,188,00:00:31.000,2025-04-05 00:04:50.162
false,false,269,259,10,94,00:00:30.000,2025-04-05 00:03:20.160
false,false,273,263,10,221,00:00:33.000,2025-04-05 00:05:20.163
false,false,271,261,10,157,00:00:32.000,2025-04-05 00:04:20.162
false,false,275,265,10,285,00:00:32.000,2025-04-05 00:06:20.163
false,false,274,264,10,253,00:00:32.000,2025-04-05 00:05:50.163
false,false,277,267,10,351,00:00:33.000,2025-04-05 00:07:20.165
false,false,276,266,10,318,00:00:33.000,2025-04-05 00:06:50.164
false,false,279,269,10,414,00:00:32.000,2025-04-05 00:08:20.166
false,false,278,268,10,382,00:00:31.000,2025-04-05 00:07:50.165
false,true,279,269,10,0,00:00:00.000,2025-04-05 00:09:20.176
false,true,279,269,10,0,00:00:00.000,2025-04-05 00:08:50.174
false,true,279,269,10,0,00:00:00.000,2025-04-05 00:10:20.195
false,true,279,269,10,0,00:00:00.000,2025-04-05 00:09:50.185
false,true,279,269,10,0,00:00:00.000,2025-04-05 00:10:50.209
false,true,279,269,10,0,00:00:00.000,2025-04-05 00:11:20.223
false,false,280,270,10,31,00:00:31.000,2025-04-05 00:11:50.229
false,false,283,273,10,122,00:00:30.000,2025-04-05 00:13:20.268
false,false,282,272,10,92,00:00:30.000,2025-04-05 00:12:50.257
false,false,281,271,10,62,00:00:31.000,2025-04-05 00:12:20.243
false,false,285,274,11,183,00:00:31.000,2025-04-05 00:14:20.288
false,false,284,273,11,152,00:00:30.000,2025-04-05 00:13:50.278
false,false,287,275,12,249,00:00:33.000,2025-04-05 00:15:20.311
false,false,286,274,12,216,00:00:33.000,2025-04-05 00:14:50.299
false,false,288,276,12,279,00:00:30.000,2025-04-05 00:15:50.312
false,false,289,277,12,311,00:00:32.000,2025-04-05 00:16:20.326
false,false,290,278,12,341,00:00:30.000,2025-04-05 00:16:50.341
false,false,291,279,12,374,00:00:33.000,2025-04-05 00:17:20.343
false,false,292,280,12,405,00:00:31.000,2025-04-05 00:17:50.357
false,false,293,281,12,435,00:00:30.000,2025-04-05 00:18:20.365
false,false,3385,3192,193,66,00:00:33.000,2025-04-06 11:20:08.153
false,true,3383,3190,193,0,00:00:00.000,2025-04-06 11:19:08.127
false,true,3383,3190,193,0,00:00:00.000,2025-04-06 11:18:08.102
false,true,3383,3190,193,0,00:00:00.000,2025-04-06 11:18:38.115
false,false,3384,3191,193,33,00:00:33.000,2025-04-06 11:19:38.139
false,true,3383,3190,193,0,00:00:00.000,2025-04-06 11:17:38.088
false,false,3387,3194,193,128,00:00:30.000,2025-04-06 11:21:08.176
false,false,3386,3193,193,98,00:00:32.000,2025-04-06 11:20:38.164
false,false,3388,3195,193,160,00:00:32.000,2025-04-06 11:21:38.187
false,false,3389,3196,193,191,00:00:31.000,2025-04-06 11:22:08.198
false,false,3390,3197,193,222,00:00:31.000,2025-04-06 11:22:38.210
false,false,3391,3198,193,255,00:00:33.000,2025-04-06 11:23:08.223
false,false,3393,3200,193,317,00:00:31.000,2025-04-06 11:24:08.243
false,false,3392,3199,193,286,00:00:31.000,2025-04-06 11:23:38.234
false,false,3395,3202,193,380,00:00:33.000,2025-04-06 11:25:08.272
false,false,3396,3203,193,413,00:00:33.000,2025-04-06 11:25:38.285
false,true,3398,3205,193,0,00:00:00.000,2025-04-06 11:27:38.339
false,false,3397,3204,193,443,00:00:30.000,2025-04-06 11:26:08.300
false,true,3398,3205,193,0,00:00:00.000,2025-04-06 11:27:08.325
false,false,3398,3205,193,476,00:00:33.000,2025-04-06 11:26:38.314
false,true,3398,3205,193,0,00:00:00.000,2025-04-06 11:28:08.348
false,true,3398,3205,193,0,00:00:00.000,2025-04-06 11:28:38.360
false,false,3400,3207,193,63,00:00:32.000,2025-04-06 11:30:38.404
false,false,3399,3206,193,31,00:00:31.000,2025-04-06 11:30:08.393
false,false,3394,3201,193,347,00:00:30.000,2025-04-06 11:24:38.258
false,true,3398,3205,193,0,00:00:00.000,2025-04-06 11:29:38.381
false,false,3401,3208,193,95,00:00:32.000,2025-04-06 11:31:08.410
false,true,3398,3205,193,0,00:00:00.000,2025-04-06 11:29:08.372
false,false,3402,3209,193,125,00:00:30.000,2025-04-06 11:31:38.419
false,true,3403,3210,193,0,00:00:00.000,2025-04-06 11:32:38.448
false,false,3403,3210,193,155,00:00:30.000,2025-04-06 11:32:08.434
false,true,3403,3210,193,0,00:00:00.000,2025-04-06 11:33:08.463
false,true,3403,3210,193,0,00:00:00.000,2025-04-06 11:33:38.478
false,true,3403,3210,193,0,00:00:00.000,2025-04-06 11:34:08.485
false,false,3404,3211,193,32,00:00:32.000,2025-04-06 11:35:38.515
false,true,3403,3210,193,0,00:00:00.000,2025-04-06 11:35:08.505
false,true,3403,3210,193,0,00:00:00.000,2025-04-06 11:34:38.495
false,true,3404,3211,193,0,00:00:00.000,2025-04-06 11:36:08.529
false,true,3404,3211,193,0,00:00:00.000,2025-04-06 11:36:38.532
false,true,3404,3211,193,0,00:00:00.000,2025-04-06 11:37:08.546
false,true,3404,3211,193,0,00:00:00.000,2025-04-06 11:37:38.555
false,true,3404,3211,193,0,00:00:00.000,2025-04-06 11:38:08.569
false,true,3404,3211,193,0,00:00:00.000,2025-04-06 11:38:38.579
false,false,3405,3212,193,30,00:00:30.000,2025-04-06 11:39:08.593
false,false,3406,3213,193,62,00:00:32.000,2025-04-06 11:39:38.606
false,true,3408,3215,193,0,00:00:00.000,2025-04-06 11:41:08.637
false,false,3407,3214,193,94,00:00:32.000,2025-04-06 11:40:08.616
false,false,3408,3215,193,125,00:00:31.000,2025-04-06 11:40:38.625
false,true,3408,3215,193,0,00:00:00.000,2025-04-06 11:41:38.645
false,true,3408,3215,193,0,00:00:00.000,2025-04-06 11:42:38.672
false,true,3408,3215,193,0,00:00:00.000,2025-04-06 11:42:08.658
false,true,3408,3215,193,0,00:00:00.000,2025-04-06 11:44:08.707
false,true,3408,3215,193,0,00:00:00.000,2025-04-06 11:43:38.695
false,true,3408,3215,193,0,00:00:00.000,2025-04-06 11:43:08.685
false,true,3408,3215,193,0,00:00:00.000,2025-04-06 11:44:38.718
false,true,3408,3215,193,0,00:00:00.000,2025-04-06 11:46:38.763
false,true,3408,3215,193,0,00:00:00.000,2025-04-06 11:46:08.751
false,false,3409,3216,193,32,00:00:32.000,2025-04-06 11:47:08.776
false,true,3408,3215,193,0,00:00:00.000,2025-04-06 11:45:08.732
false,true,3408,3215,193,0,00:00:00.000,2025-04-06 11:45:38.739
false,true,3410,3217,193,0,00:00:00.000,2025-04-06 11:48:08.803
false,false,3410,3217,193,62,00:00:30.000,2025-04-06 11:47:38.789
false,true,3410,3217,193,0,00:00:00.000,2025-04-06 11:49:08.828
false,true,3410,3217,193,0,00:00:00.000,2025-04-06 11:48:38.814
false,true,3410,3217,193,0,00:00:00.000,2025-04-06 11:50:38.862
false,true,3410,3217,193,0,00:00:00.000,2025-04-06 11:50:08.848
false,false,3411,3218,193,30,00:00:30.000,2025-04-06 11:51:08.868
false,true,3410,3217,193,0,00:00:00.000,2025-04-06 11:49:38.836
false,false,3412,3219,193,63,00:00:33.000,2025-04-06 11:51:38.869
false,false,3414,3221,193,127,00:00:31.000,2025-04-06 11:52:38.898
false,false,3416,3223,193,188,00:00:30.000,2025-04-06 11:53:38.926
false,false,3413,3220,193,96,00:00:33.000,2025-04-06 11:52:08.883
false,false,3418,3225,193,251,00:00:33.000,2025-04-06 11:54:38.949
false,false,3415,3222,193,158,00:00:31.000,2025-04-06 11:53:08.912
false,false,3417,3224,193,218,00:00:30.000,2025-04-06 11:54:08.938
false,false,3419,3226,193,284,00:00:33.000,2025-04-06 11:55:08.957
false,false,3420,3227,193,315,00:00:31.000,2025-04-06 11:55:38.969
false,false,3421,3228,193,347,00:00:32.000,2025-04-06 11:56:08.980
false,false,3423,3230,193,411,00:00:33.000,2025-04-06 11:57:09.003
false,false,3422,3229,193,378,00:00:31.000,2025-04-06 11:56:38.994
false,false,3424,3231,193,444,00:00:33.000,2025-04-06 11:57:39.017
false,false,3425,3231,194,477,00:00:33.000,2025-04-06 11:58:09.031
false,false,3426,3232,194,507,00:00:30.000,2025-04-06 11:58:39.040
false,false,3427,3233,194,540,00:00:33.000,2025-04-06 11:59:09.052
false,false,3428,3234,194,570,00:00:30.000,2025-04-06 11:59:39.065
false,false,3431,3237,194,663,00:00:32.000,2025-04-06 12:01:09.099
false,false,3430,3236,194,631,00:00:30.000,2025-04-06 12:00:39.088
false,false,3433,3239,194,725,00:00:32.000,2025-04-06 12:02:09.122
false,false,3434,3240,194,755,00:00:30.000,2025-04-06 12:02:39.134
false,false,3429,3235,194,601,00:00:31.000,2025-04-06 12:00:09.075
false,false,3432,3238,194,693,00:00:30.000,2025-04-06 12:01:39.112
false,false,3436,3242,194,820,00:00:33.000,2025-04-06 12:03:39.156
false,false,3435,3241,194,787,00:00:32.000,2025-04-06 12:03:09.144
false,false,3437,3243,194,852,00:00:32.000,2025-04-06 12:04:09.165
false,false,3439,3244,195,915,00:00:33.000,2025-04-06 12:05:09.185
false,true,3440,3245,195,0,00:00:00.000,2025-04-06 12:06:09.204
false,false,3438,3244,194,882,00:00:30.000,2025-04-06 12:04:39.175
false,false,3440,3245,195,947,00:00:32.000,2025-04-06 12:05:39.192
false,true,3440,3245,195,0,00:00:00.000,2025-04-06 12:07:09.229
false,true,3440,3245,195,0,00:00:00.000,2025-04-06 12:07:39.243
false,true,3440,3245,195,0,00:00:00.000,2025-04-06 12:08:09.257
false,true,3440,3245,195,0,00:00:00.000,2025-04-06 12:08:39.270
false,false,3441,3246,195,31,00:00:31.000,2025-04-06 12:09:09.282
false,false,3442,3247,195,61,00:00:30.000,2025-04-06 12:09:39.287
false,true,3440,3245,195,0,00:00:00.000,2025-04-06 12:06:39.218
false,false,3444,3249,195,123,00:00:31.000,2025-04-06 12:10:39.313
false,false,3443,3248,195,92,00:00:31.000,2025-04-06 12:10:09.299
false,false,3445,3250,195,156,00:00:33.000,2025-04-06 12:11:09.321
false,false,3447,3252,195,218,00:00:30.000,2025-04-06 12:12:09.347
false,false,3449,3254,195,283,00:00:32.000,2025-04-06 12:13:09.375
false,false,3448,3253,195,251,00:00:33.000,2025-04-06 12:12:39.361
false,false,3446,3251,195,188,00:00:32.000,2025-04-06 12:11:39.333
false,false,3451,3256,195,346,00:00:30.000,2025-04-06 12:14:09.402
false,false,3452,3257,195,379,00:00:33.000,2025-04-06 12:14:39.415
false,false,3453,3258,195,410,00:00:31.000,2025-04-06 12:15:09.428
false,false,3450,3255,195,316,00:00:33.000,2025-04-06 12:13:39.389
false,false,3455,3260,195,473,00:00:32.000,2025-04-06 12:16:09.452
false,false,3454,3259,195,441,00:00:31.000,2025-04-06 12:15:39.441
false,false,3456,3261,195,503,00:00:30.000,2025-04-06 12:16:39.464
false,false,3457,3262,195,536,00:00:33.000,2025-04-06 12:17:09.475
false,false,3458,3263,195,566,00:00:30.000,2025-04-06 12:17:39.489
false,false,3459,3264,195,597,00:00:31.000,2025-04-06 12:18:09.501
false,false,787,745,42,1414,00:00:32.000,2025-04-05 05:37:27.085
false,false,788,745,43,1446,00:00:32.000,2025-04-05 05:37:57.085
false,false,792,749,43,1573,00:00:33.000,2025-04-05 05:39:57.132
false,false,789,746,43,1476,00:00:30.000,2025-04-05 05:38:27.100
false,false,791,748,43,1540,00:00:33.000,2025-04-05 05:39:27.127
false,false,790,747,43,1507,00:00:31.000,2025-04-05 05:38:57.115
false,false,796,753,43,1696,00:00:30.000,2025-04-05 05:41:57.183
false,false,793,750,43,1604,00:00:31.000,2025-04-05 05:40:27.143
false,false,794,751,43,1636,00:00:32.000,2025-04-05 05:40:57.157
false,false,798,755,43,1760,00:00:31.000,2025-04-05 05:42:57.198
false,false,797,754,43,1729,00:00:33.000,2025-04-05 05:42:27.188
false,false,795,752,43,1666,00:00:30.000,2025-04-05 05:41:27.170
false,false,799,756,43,1791,00:00:31.000,2025-04-05 05:43:27.214
false,false,802,759,43,1886,00:00:32.000,2025-04-05 05:44:57.243
false,false,803,760,43,1919,00:00:33.000,2025-04-05 05:45:27.254
false,false,804,761,43,1952,00:00:33.000,2025-04-05 05:45:57.265
false,false,800,757,43,1823,00:00:32.000,2025-04-05 05:43:57.223
false,false,801,758,43,1854,00:00:31.000,2025-04-05 05:44:27.233
false,false,807,763,44,2049,00:00:31.000,2025-04-05 05:47:27.303
false,false,805,761,44,1985,00:00:33.000,2025-04-05 05:46:27.275
false,false,810,766,44,2143,00:00:30.000,2025-04-05 05:48:57.337
false,false,806,762,44,2018,00:00:33.000,2025-04-05 05:46:57.290
false,false,809,765,44,2113,00:00:31.000,2025-04-05 05:48:27.323
false,false,808,764,44,2082,00:00:33.000,2025-04-05 05:47:57.316
false,false,813,768,45,2239,00:00:33.000,2025-04-05 05:50:27.373
false,false,811,767,44,2175,00:00:32.000,2025-04-05 05:49:27.346
false,false,812,768,44,2206,00:00:31.000,2025-04-05 05:49:57.359
false,false,814,769,45,2272,00:00:33.000,2025-04-05 05:50:57.386
false,false,815,770,45,2304,00:00:32.000,2025-04-05 05:51:27.399
false,false,817,772,45,2368,00:00:32.000,2025-04-05 05:52:27.421
false,false,820,775,45,2466,00:00:32.000,2025-04-05 05:53:57.460
false,false,818,773,45,2401,00:00:33.000,2025-04-05 05:52:57.432
false,false,819,774,45,2434,00:00:33.000,2025-04-05 05:53:27.447
false,false,821,776,45,2499,00:00:33.000,2025-04-05 05:54:27.475
false,false,816,771,45,2336,00:00:32.000,2025-04-05 05:51:57.410
false,false,826,780,46,2656,00:00:31.000,2025-04-05 05:56:57.521
false,false,825,779,46,2625,00:00:32.000,2025-04-05 05:56:27.509
false,false,823,778,45,2562,00:00:30.000,2025-04-05 05:55:27.489
false,false,822,777,45,2532,00:00:33.000,2025-04-05 05:54:57.487
false,false,827,781,46,2688,00:00:32.000,2025-04-05 05:57:27.524
false,false,824,778,46,2593,00:00:31.000,2025-04-05 05:55:57.501
false,false,829,783,46,2751,00:00:33.000,2025-04-05 05:58:27.549
false,false,830,784,46,2781,00:00:30.000,2025-04-05 05:58:57.561
false,false,828,782,46,2718,00:00:30.000,2025-04-05 05:57:57.537
false,false,831,785,46,2814,00:00:33.000,2025-04-05 05:59:27.576
false,false,832,786,46,2847,00:00:33.000,2025-04-05 05:59:57.589
false,false,833,787,46,2878,00:00:31.000,2025-04-05 06:00:27.597
false,true,833,787,46,0,00:00:00.000,2025-04-05 06:00:57.611
false,true,833,787,46,0,00:00:00.000,2025-04-05 06:01:57.633
false,true,833,787,46,0,00:00:00.000,2025-04-05 06:01:27.621
false,true,833,787,46,0,00:00:00.000,2025-04-05 06:02:27.645
false,true,833,787,46,0,00:00:00.000,2025-04-05 06:02:57.652
false,true,833,787,46,0,00:00:00.000,2025-04-05 06:03:27.667
false,true,833,787,46,0,00:00:00.000,2025-04-05 06:04:27.689
false,true,833,787,46,0,00:00:00.000,2025-04-05 06:04:57.701
false,true,833,787,46,0,00:00:00.000,2025-04-05 06:05:27.710
false,true,833,787,46,0,00:00:00.000,2025-04-05 06:03:57.679
false,true,833,787,46,0,00:00:00.000,2025-04-05 06:05:57.722
false,true,833,787,46,0,00:00:00.000,2025-04-05 06:06:27.737
false,false,834,788,46,31,00:00:31.000,2025-04-05 06:06:57.751
false,true,835,789,46,0,00:00:00.000,2025-04-05 06:08:27.789
false,true,835,789,46,0,00:00:00.000,2025-04-05 06:07:57.777
false,false,835,789,46,61,00:00:30.000,2025-04-05 06:07:27.764
false,true,835,789,46,0,00:00:00.000,2025-04-05 06:09:27.811
false,true,835,789,46,0,00:00:00.000,2025-04-05 06:09:57.812
false,true,835,789,46,0,00:00:00.000,2025-04-05 06:08:57.797
false,false,837,790,47,63,00:00:31.000,2025-04-05 06:11:27.836
false,true,835,789,46,0,00:00:00.000,2025-04-05 06:10:27.814
false,false,836,789,47,32,00:00:32.000,2025-04-05 06:10:57.826
false,false,840,793,47,160,00:00:32.000,2025-04-05 06:12:57.876
false,false,839,792,47,128,00:00:32.000,2025-04-05 06:12:27.862
false,false,838,791,47,96,00:00:33.000,2025-04-05 06:11:57.850
false,false,841,794,47,190,00:00:30.000,2025-04-05 06:13:27.885
false,false,843,796,47,256,00:00:33.000,2025-04-05 06:14:27.905
false,false,842,795,47,223,00:00:33.000,2025-04-05 06:13:57.895
false,false,846,798,48,348,00:00:30.000,2025-04-05 06:15:57.940
false,false,845,797,48,318,00:00:30.000,2025-04-05 06:15:27.932
false,true,846,798,48,0,00:00:00.000,2025-04-05 06:16:27.954
false,true,846,798,48,0,00:00:00.000,2025-04-05 06:16:57.967
false,false,844,797,47,288,00:00:32.000,2025-04-05 06:14:57.919
false,true,846,798,48,0,00:00:00.000,2025-04-05 06:17:27.978
false,true,846,798,48,0,00:00:00.000,2025-04-05 06:17:57.989
false,true,846,798,48,0,00:00:00.000,2025-04-05 06:18:28.004
false,true,846,798,48,0,00:00:00.000,2025-04-05 06:18:58.013
false,false,847,799,48,31,00:00:31.000,2025-04-05 06:19:28.027
false,false,849,801,48,97,00:00:33.000,2025-04-05 06:20:28.055
false,false,851,803,48,159,00:00:31.000,2025-04-05 06:21:28.065
false,false,848,800,48,64,00:00:33.000,2025-04-05 06:19:58.041
false,false,852,804,48,189,00:00:30.000,2025-04-05 06:21:58.068
false,false,850,802,48,128,00:00:31.000,2025-04-05 06:20:58.059
false,false,855,807,48,287,00:00:33.000,2025-04-05 06:23:28.102
false,false,854,806,48,254,00:00:32.000,2025-04-05 06:22:58.087
false,false,853,805,48,222,00:00:33.000,2025-04-05 06:22:28.073
false,true,855,807,48,0,00:00:00.000,2025-04-05 06:23:58.109
false,true,855,807,48,0,00:00:00.000,2025-04-05 06:24:28.121
false,true,855,807,48,0,00:00:00.000,2025-04-05 06:24:58.133
false,true,855,807,48,0,00:00:00.000,2025-04-05 06:25:28.149
false,true,855,807,48,0,00:00:00.000,2025-04-05 06:25:58.160
false,false,856,808,48,32,00:00:32.000,2025-04-05 06:26:58.185
false,true,855,807,48,0,00:00:00.000,2025-04-05 06:26:28.171
false,false,857,809,48,65,00:00:33.000,2025-04-05 06:27:28.198
false,false,858,810,48,97,00:00:32.000,2025-04-05 06:27:58.206
false,false,861,812,49,189,00:00:32.000,2025-04-05 06:29:28.238
false,false,860,811,49,157,00:00:30.000,2025-04-05 06:28:58.233
false,false,859,811,48,127,00:00:30.000,2025-04-05 06:28:28.217
false,false,863,814,49,252,00:00:32.000,2025-04-05 06:30:28.258
false,false,864,815,49,282,00:00:30.000,2025-04-05 06:30:58.268
false,true,865,816,49,0,00:00:00.000,2025-04-05 06:32:28.305
false,true,865,816,49,0,00:00:00.000,2025-04-05 06:31:58.297
false,false,865,816,49,312,00:00:30.000,2025-04-05 06:31:28.281
false,false,862,813,49,220,00:00:31.000,2025-04-05 06:29:58.253
false,true,865,816,49,0,00:00:00.000,2025-04-05 06:33:28.335
false,true,865,816,49,0,00:00:00.000,2025-04-05 06:33:58.349
false,true,865,816,49,0,00:00:00.000,2025-04-05 06:34:28.361
false,true,865,816,49,0,00:00:00.000,2025-04-05 06:32:58.320
false,false,866,817,49,32,00:00:32.000,2025-04-05 06:34:58.377
false,false,867,818,49,64,00:00:32.000,2025-04-05 06:35:28.392
false,false,868,819,49,94,00:00:30.000,2025-04-05 06:35:58.399
false,false,869,820,49,124,00:00:30.000,2025-04-05 06:36:28.409
false,false,870,821,49,156,00:00:32.000,2025-04-05 06:36:58.422
false,false,872,823,49,220,00:00:32.000,2025-04-05 06:37:58.445
false,false,871,822,49,188,00:00:32.000,2025-04-05 06:37:28.436
false,false,1342,1263,79,254,00:00:32.000,2025-04-05 12:03:05.721
false,false,1341,1262,79,222,00:00:32.000,2025-04-05 12:02:35.707
false,false,1345,1266,79,350,00:00:31.000,2025-04-05 12:04:35.755
false,false,1340,1261,79,190,00:00:30.000,2025-04-05 12:02:05.693
false,false,1344,1265,79,319,00:00:32.000,2025-04-05 12:04:05.743
false,false,1343,1264,79,287,00:00:33.000,2025-04-05 12:03:35.732
false,false,1348,1269,79,441,00:00:30.000,2025-04-05 12:06:05.785
false,false,1349,1270,79,473,00:00:32.000,2025-04-05 12:06:35.792
false,false,1350,1271,79,506,00:00:33.000,2025-04-05 12:07:05.803
false,false,1346,1267,79,380,00:00:30.000,2025-04-05 12:05:05.763
false,false,1352,1273,79,571,00:00:33.000,2025-04-05 12:08:05.826
false,false,1351,1272,79,538,00:00:32.000,2025-04-05 12:07:35.816
false,false,1354,1275,79,632,00:00:30.000,2025-04-05 12:09:05.850
false,false,1353,1274,79,602,00:00:31.000,2025-04-05 12:08:35.839
false,false,1347,1268,79,411,00:00:31.000,2025-04-05 12:05:35.777
false,false,1355,1276,79,662,00:00:30.000,2025-04-05 12:09:35.858
false,false,1358,1279,79,759,00:00:33.000,2025-04-05 12:11:05.898
false,false,1356,1277,79,694,00:00:32.000,2025-04-05 12:10:05.873
false,false,1359,1280,79,792,00:00:33.000,2025-04-05 12:11:35.906
false,false,1357,1278,79,726,00:00:32.000,2025-04-05 12:10:35.886
false,false,1360,1281,79,822,00:00:30.000,2025-04-05 12:12:05.918
false,false,1361,1282,79,854,00:00:32.000,2025-04-05 12:12:35.928
false,false,1364,1285,79,949,00:00:30.000,2025-04-05 12:14:05.958
false,false,1363,1284,79,919,00:00:33.000,2025-04-05 12:13:35.949
false,false,1362,1283,79,886,00:00:32.000,2025-04-05 12:13:05.937
false,false,1365,1285,80,981,00:00:32.000,2025-04-05 12:14:35.967
false,false,1366,1286,80,1014,00:00:33.000,2025-04-05 12:15:05.980
false,false,1367,1287,80,1046,00:00:32.000,2025-04-05 12:15:35.990
false,false,1369,1289,80,1107,00:00:30.000,2025-04-05 12:16:36.013
false,false,1370,1290,80,1137,00:00:30.000,2025-04-05 12:17:06.027
false,false,1371,1291,80,1167,00:00:30.000,2025-04-05 12:17:36.039
false,false,1372,1292,80,1200,00:00:33.000,2025-04-05 12:18:06.049
false,false,1373,1293,80,1233,00:00:33.000,2025-04-05 12:18:36.063
false,false,1374,1294,80,1265,00:00:32.000,2025-04-05 12:19:06.077
false,false,1368,1288,80,1077,00:00:31.000,2025-04-05 12:16:06.002
false,false,1377,1297,80,1360,00:00:32.000,2025-04-05 12:20:36.106
false,false,1376,1296,80,1328,00:00:30.000,2025-04-05 12:20:06.095
false,false,1375,1295,80,1298,00:00:33.000,2025-04-05 12:19:36.090
false,false,1378,1298,80,1391,00:00:31.000,2025-04-05 12:21:06.119
false,false,1379,1299,80,1423,00:00:32.000,2025-04-05 12:21:36.122
false,false,1380,1300,80,1456,00:00:33.000,2025-04-05 12:22:06.137
false,false,1383,1303,80,1550,00:00:31.000,2025-04-05 12:23:36.178
false,false,1381,1301,80,1487,00:00:31.000,2025-04-05 12:22:36.152
false,false,1382,1302,80,1519,00:00:32.000,2025-04-05 12:23:06.164
false,false,1385,1305,80,1614,00:00:31.000,2025-04-05 12:24:36.206
false,false,1386,1306,80,1644,00:00:30.000,2025-04-05 12:25:06.215
false,false,1384,1304,80,1583,00:00:33.000,2025-04-05 12:24:06.191
false,false,1388,1308,80,1706,00:00:32.000,2025-04-05 12:26:06.235
false,false,1387,1307,80,1674,00:00:30.000,2025-04-05 12:25:36.223
false,false,1390,1310,80,1768,00:00:30.000,2025-04-05 12:27:06.255
false,false,1389,1309,80,1738,00:00:32.000,2025-04-05 12:26:36.251
false,false,1391,1311,80,1799,00:00:31.000,2025-04-05 12:27:36.267
false,false,1392,1312,80,1831,00:00:32.000,2025-04-05 12:28:06.281
false,false,1393,1313,80,1863,00:00:32.000,2025-04-05 12:28:36.292
false,false,1394,1314,80,1895,00:00:32.000,2025-04-05 12:29:06.305
false,false,1395,1315,80,1927,00:00:32.000,2025-04-05 12:29:36.309
false,true,1395,1315,80,0,00:00:00.000,2025-04-05 12:30:36.336
false,true,1395,1315,80,0,00:00:00.000,2025-04-05 12:30:06.321
false,true,1395,1315,80,0,00:00:00.000,2025-04-05 12:32:06.369
false,true,1395,1315,80,0,00:00:00.000,2025-04-05 12:31:06.348
false,false,1396,1316,80,32,00:00:32.000,2025-04-05 12:33:06.389
false,true,1395,1315,80,0,00:00:00.000,2025-04-05 12:32:36.381
false,true,1395,1315,80,0,00:00:00.000,2025-04-05 12:31:36.360
false,true,1396,1316,80,0,00:00:00.000,2025-04-05 12:34:06.416
false,true,1396,1316,80,0,00:00:00.000,2025-04-05 12:34:36.430
false,true,1396,1316,80,0,00:00:00.000,2025-04-05 12:33:36.401
false,false,1397,1317,80,32,00:00:32.000,2025-04-05 12:36:36.478
false,true,1396,1316,80,0,00:00:00.000,2025-04-05 12:35:36.458
false,true,1396,1316,80,0,00:00:00.000,2025-04-05 12:35:06.446
false,true,1396,1316,80,0,00:00:00.000,2025-04-05 12:36:06.468
false,false,1398,1318,80,62,00:00:30.000,2025-04-05 12:37:06.492
false,false,1399,1319,80,92,00:00:30.000,2025-04-05 12:37:36.506
false,false,1400,1320,80,122,00:00:30.000,2025-04-05 12:38:06.514
false,true,1400,1320,80,0,00:00:00.000,2025-04-05 12:39:36.557
false,true,1400,1320,80,0,00:00:00.000,2025-04-05 12:40:06.572
false,true,1400,1320,80,0,00:00:00.000,2025-04-05 12:40:36.586
false,true,1400,1320,80,0,00:00:00.000,2025-04-05 12:39:06.542
false,true,1400,1320,80,0,00:00:00.000,2025-04-05 12:41:36.612
false,true,1400,1320,80,0,00:00:00.000,2025-04-05 12:42:36.626
false,true,1400,1320,80,0,00:00:00.000,2025-04-05 12:38:36.528
false,true,1400,1320,80,0,00:00:00.000,2025-04-05 12:42:06.626
false,true,1400,1320,80,0,00:00:00.000,2025-04-05 12:41:06.599
false,true,1400,1320,80,0,00:00:00.000,2025-04-05 12:43:06.634
false,true,1400,1320,80,0,00:00:00.000,2025-04-05 12:44:06.654
false,true,1400,1320,80,0,00:00:00.000,2025-04-05 12:43:36.647
false,false,1403,1323,80,97,00:00:32.000,2025-04-05 12:45:36.694
false,false,1401,1321,80,32,00:00:32.000,2025-04-05 12:44:36.667
false,false,1402,1322,80,65,00:00:33.000,2025-04-05 12:45:06.681
false,false,1404,1324,80,127,00:00:30.000,2025-04-05 12:46:06.701
false,false,1406,1326,80,192,00:00:32.000,2025-04-05 12:47:06.729
false,false,1407,1327,80,224,00:00:32.000,2025-04-05 12:47:36.743
false,false,1409,1329,80,288,00:00:32.000,2025-04-05 12:48:36.760
false,false,1405,1325,80,160,00:00:33.000,2025-04-05 12:46:36.715
false,false,1408,1328,80,256,00:00:32.000,2025-04-05 12:48:06.751
false,true,1409,1329,80,0,00:00:00.000,2025-04-05 12:49:06.768
false,true,1409,1329,80,0,00:00:00.000,2025-04-05 12:51:06.814
false,true,1409,1329,80,0,00:00:00.000,2025-04-05 12:50:36.803
false,true,1409,1329,80,0,00:00:00.000,2025-04-05 12:49:36.781
false,true,1409,1329,80,0,00:00:00.000,2025-04-05 12:51:36.822
false,true,1409,1329,80,0,00:00:00.000,2025-04-05 12:50:06.793
false,false,1410,1330,80,33,00:00:33.000,2025-04-05 12:52:06.836
false,false,1414,1334,80,159,00:00:33.000,2025-04-05 12:54:06.883
false,false,1411,1331,80,63,00:00:30.000,2025-04-05 12:52:36.849
false,false,1413,1333,80,126,00:00:33.000,2025-04-05 12:53:36.872
false,false,1412,1332,80,93,00:00:30.000,2025-04-05 12:53:06.861
false,false,1417,1337,80,253,00:00:33.000,2025-04-05 12:55:36.918
false,false,1416,1336,80,220,00:00:31.000,2025-04-05 12:55:06.905
false,false,1419,1339,80,318,00:00:33.000,2025-04-05 12:56:36.936
false,false,1420,1340,80,350,00:00:32.000,2025-04-05 12:57:06.949
false,false,1418,1338,80,285,00:00:32.000,2025-04-05 12:56:06.923
false,false,1415,1335,80,189,00:00:30.000,2025-04-05 12:54:36.895
false,false,1421,1341,80,380,00:00:30.000,2025-04-05 12:57:36.963
false,false,1422,1342,80,413,00:00:33.000,2025-04-05 12:58:06.975
false,false,1425,1344,81,506,00:00:32.000,2025-04-05 12:59:37.008
false,false,1423,1342,81,443,00:00:30.000,2025-04-05 12:58:36.985
false,false,1424,1343,81,474,00:00:31.000,2025-04-05 12:59:06.998
false,false,1426,1345,81,537,00:00:31.000,2025-04-05 13:00:07.019
false,false,1427,1346,81,568,00:00:31.000,2025-04-05 13:00:37.033
false,false,1428,1347,81,598,00:00:30.000,2025-04-05 13:01:07.047
false,false,1429,1348,81,629,00:00:31.000,2025-04-05 13:01:37.060
false,false,3546,3345,201,285,00:00:32.000,2025-04-06 13:22:40.988
false,false,3550,3349,201,412,00:00:31.000,2025-04-06 13:24:41.035
false,false,3545,3345,200,253,00:00:31.000,2025-04-06 13:22:10.975
false,false,3548,3347,201,348,00:00:30.000,2025-04-06 13:23:41.013
false,false,3547,3346,201,318,00:00:33.000,2025-04-06 13:23:11.000
false,false,3549,3348,201,381,00:00:33.000,2025-04-06 13:24:11.024
false,false,3551,3350,201,445,00:00:33.000,2025-04-06 13:25:11.045
false,false,3552,3351,201,475,00:00:30.000,2025-04-06 13:25:41.058
false,false,3554,3353,201,535,00:00:30.000,2025-04-06 13:26:41.083
false,false,3555,3354,201,566,00:00:31.000,2025-04-06 13:27:11.093
false,false,3553,3352,201,505,00:00:30.000,2025-04-06 13:26:11.071
false,false,3557,3356,201,629,00:00:31.000,2025-04-06 13:28:11.114
false,false,3556,3355,201,598,00:00:32.000,2025-04-06 13:27:41.102
false,false,3558,3357,201,662,00:00:33.000,2025-04-06 13:28:41.126
false,false,3561,3360,201,754,00:00:30.000,2025-04-06 13:30:11.161
false,false,3563,3362,201,819,00:00:33.000,2025-04-06 13:31:11.182
false,false,3559,3358,201,692,00:00:30.000,2025-04-06 13:29:11.137
false,false,3562,3361,201,786,00:00:32.000,2025-04-06 13:30:41.173
false,false,3560,3359,201,724,00:00:32.000,2025-04-06 13:29:41.150
false,false,3564,3363,201,852,00:00:33.000,2025-04-06 13:31:41.193
false,false,3566,3364,202,915,00:00:30.000,2025-04-06 13:32:41.206
false,false,3568,3366,202,976,00:00:30.000,2025-04-06 13:33:41.230
false,false,3565,3364,201,885,00:00:33.000,2025-04-06 13:32:11.197
false,false,3567,3365,202,946,00:00:31.000,2025-04-06 13:33:11.220
false,false,3569,3366,203,1008,00:00:32.000,2025-04-06 13:34:11.243
false,false,3570,3367,203,1041,00:00:33.000,2025-04-06 13:34:41.254
false,false,3572,3368,204,1105,00:00:32.000,2025-04-06 13:35:41.279
false,false,3571,3367,204,1073,00:00:32.000,2025-04-06 13:35:11.266
false,false,3574,3370,204,1170,00:00:32.000,2025-04-06 13:36:41.302
false,false,3575,3371,204,1201,00:00:31.000,2025-04-06 13:37:11.316
false,false,3573,3369,204,1138,00:00:33.000,2025-04-06 13:36:11.292
false,false,3577,3372,205,1263,00:00:31.000,2025-04-06 13:38:11.336
false,false,3576,3371,205,1232,00:00:31.000,2025-04-06 13:37:41.325
false,false,3578,3373,205,1294,00:00:31.000,2025-04-06 13:38:41.346
false,false,3579,3374,205,1327,00:00:33.000,2025-04-06 13:39:11.357
false,false,3581,3376,205,1390,00:00:31.000,2025-04-06 13:40:11.374
false,false,3580,3375,205,1359,00:00:32.000,2025-04-06 13:39:41.362
false,true,3582,3377,205,0,00:00:00.000,2025-04-06 13:41:11.401
false,false,3582,3377,205,1420,00:00:30.000,2025-04-06 13:40:41.388
false,true,3582,3377,205,0,00:00:00.000,2025-04-06 13:41:41.413
false,true,3582,3377,205,0,00:00:00.000,2025-04-06 13:42:41.436
false,true,3582,3377,205,0,00:00:00.000,2025-04-06 13:42:11.424
false,true,3582,3377,205,0,00:00:00.000,2025-04-06 13:43:11.450
false,true,3582,3377,205,0,00:00:00.000,2025-04-06 13:43:41.463
false,false,3585,3379,206,91,00:00:31.000,2025-04-06 13:45:11.498
false,false,3587,3381,206,153,00:00:30.000,2025-04-06 13:46:11.520
false,false,3583,3378,205,30,00:00:30.000,2025-04-06 13:44:11.474
false,false,3584,3378,206,60,00:00:30.000,2025-04-06 13:44:41.485
false,false,3586,3380,206,123,00:00:32.000,2025-04-06 13:45:41.509
false,false,3588,3382,206,184,00:00:31.000,2025-04-06 13:46:41.532
false,false,3589,3383,206,217,00:00:33.000,2025-04-06 13:47:11.542
false,true,3589,3383,206,0,00:00:00.000,2025-04-06 13:47:41.555
false,true,3589,3383,206,0,00:00:00.000,2025-04-06 13:48:11.566
false,true,3589,3383,206,0,00:00:00.000,2025-04-06 13:48:41.580
false,true,3589,3383,206,0,00:00:00.000,2025-04-06 13:49:11.594
false,true,3589,3383,206,0,00:00:00.000,2025-04-06 13:49:41.601
false,true,3589,3383,206,0,00:00:00.000,2025-04-06 13:50:11.612
false,false,3590,3384,206,31,00:00:31.000,2025-04-06 13:50:41.624
false,false,3593,3387,206,128,00:00:33.000,2025-04-06 13:52:11.656
false,false,3592,3386,206,95,00:00:31.000,2025-04-06 13:51:41.643
false,false,3591,3385,206,64,00:00:33.000,2025-04-06 13:51:11.634
false,false,3594,3388,206,160,00:00:32.000,2025-04-06 13:52:41.670
false,false,3595,3389,206,192,00:00:32.000,2025-04-06 13:53:11.678
false,false,3598,3392,206,285,00:00:31.000,2025-04-06 13:54:41.717
false,false,3599,3393,206,318,00:00:33.000,2025-04-06 13:55:11.727
false,false,3600,3394,206,348,00:00:30.000,2025-04-06 13:55:41.738
false,true,3600,3394,206,0,00:00:00.000,2025-04-06 13:56:11.751
false,false,3597,3391,206,254,00:00:31.000,2025-04-06 13:54:11.703
false,false,3596,3390,206,223,00:00:31.000,2025-04-06 13:53:41.690
false,true,3600,3394,206,0,00:00:00.000,2025-04-06 13:56:41.757
false,true,3600,3394,206,0,00:00:00.000,2025-04-06 13:57:11.771
false,true,3600,3394,206,0,00:00:00.000,2025-04-06 13:57:41.782
false,true,3600,3394,206,0,00:00:00.000,2025-04-06 13:58:41.805
false,false,3601,3395,206,33,00:00:33.000,2025-04-06 13:59:11.819
false,true,3600,3394,206,0,00:00:00.000,2025-04-06 13:58:11.793
false,false,3603,3397,206,99,00:00:33.000,2025-04-06 14:00:11.847
false,false,3604,3398,206,130,00:00:31.000,2025-04-06 14:00:41.861
false,false,3602,3396,206,66,00:00:33.000,2025-04-06 13:59:41.833
false,false,3605,3399,206,163,00:00:33.000,2025-04-06 14:01:11.866
false,false,3607,3400,207,229,00:00:33.000,2025-04-06 14:02:11.876
false,false,3611,3403,208,356,00:00:32.000,2025-04-06 14:04:11.927
false,false,3609,3401,208,293,00:00:32.000,2025-04-06 14:03:11.901
false,false,3606,3399,207,196,00:00:33.000,2025-04-06 14:01:41.871
false,false,3608,3401,207,261,00:00:32.000,2025-04-06 14:02:41.890
false,false,3612,3404,208,386,00:00:30.000,2025-04-06 14:04:41.938
false,false,3610,3402,208,324,00:00:31.000,2025-04-06 14:03:41.914
false,false,3614,3405,209,447,00:00:31.000,2025-04-06 14:05:41.963
false,false,3613,3405,208,416,00:00:30.000,2025-04-06 14:05:11.951
false,false,3615,3406,209,479,00:00:32.000,2025-04-06 14:06:11.975
false,false,3616,3407,209,511,00:00:32.000,2025-04-06 14:06:41.987
false,true,3616,3407,209,0,00:00:00.000,2025-04-06 14:07:42.013
false,true,3616,3407,209,0,00:00:00.000,2025-04-06 14:08:12.027
false,true,3616,3407,209,0,00:00:00.000,2025-04-06 14:08:42.041
false,true,3616,3407,209,0,00:00:00.000,2025-04-06 14:07:12.000
false,true,3616,3407,209,0,00:00:00.000,2025-04-06 14:09:42.064
false,false,3617,3408,209,33,00:00:33.000,2025-04-06 14:10:12.078
false,true,3616,3407,209,0,00:00:00.000,2025-04-06 14:09:12.053
false,false,3619,3410,209,98,00:00:33.000,2025-04-06 14:11:12.100
false,false,3623,3414,209,226,00:00:33.000,2025-04-06 14:13:12.147
false,false,3621,3412,209,161,00:00:33.000,2025-04-06 14:12:12.123
false,false,3622,3413,209,193,00:00:32.000,2025-04-06 14:12:42.134
false,false,3618,3409,209,65,00:00:32.000,2025-04-06 14:10:42.088
false,false,3620,3411,209,128,00:00:30.000,2025-04-06 14:11:42.111
false,false,3624,3415,209,258,00:00:32.000,2025-04-06 14:13:42.159
false,false,3629,3420,209,413,00:00:30.000,2025-04-06 14:16:12.216
false,false,3625,3416,209,289,00:00:31.000,2025-04-06 14:14:12.173
false,false,3627,3418,209,353,00:00:33.000,2025-04-06 14:15:12.193
false,false,3628,3419,209,383,00:00:30.000,2025-04-06 14:15:42.205
false,false,3626,3417,209,320,00:00:31.000,2025-04-06 14:14:42.181
false,true,3629,3420,209,0,00:00:00.000,2025-04-06 14:16:42.231
false,true,3629,3420,209,0,00:00:00.000,2025-04-06 14:18:42.281
false,true,3629,3420,209,0,00:00:00.000,2025-04-06 14:18:12.266
false,true,3629,3420,209,0,00:00:00.000,2025-04-06 14:17:42.252
false,true,3629,3420,209,0,00:00:00.000,2025-04-06 14:17:12.241
false,true,3629,3420,209,0,00:00:00.000,2025-04-06 14:19:12.291
false,false,3630,3421,209,32,00:00:32.000,2025-04-06 14:19:42.304
false,false,3631,3422,209,62,00:00:30.000,2025-04-06 14:20:12.316
false,false,3632,3423,209,94,00:00:32.000,2025-04-06 14:20:42.327
false,false,3633,3424,209,127,00:00:33.000,2025-04-06 14:21:12.339
false,true,3633,3424,209,0,00:00:00.000,2025-04-06 14:21:42.352
false,true,3633,3424,209,0,00:00:00.000,2025-04-06 14:22:42.371
false,true,3633,3424,209,0,00:00:00.000,2025-04-06 14:22:12.359
false,true,3633,3424,209,0,00:00:00.000,2025-04-06 14:23:42.388
false,true,3633,3424,209,0,00:00:00.000,2025-04-06 14:24:12.398
false,true,3633,3424,209,0,00:00:00.000,2025-04-06 14:23:12.382
false,false,3634,3425,209,30,00:00:30.000,2025-04-06 14:24:42.410
false,false,3635,3426,209,60,00:00:30.000,2025-04-06 14:25:12.420
false,true,5,5,0,0,00:00:00.000,2025-04-10 15:49:43.518
false,true,5,5,0,0,00:00:00.000,2025-04-10 15:49:48.520
false,true,5,5,0,0,00:00:00.000,2025-04-10 15:49:53.525
false,true,5,5,0,0,00:00:00.000,2025-04-10 15:49:58.527
false,true,5,5,0,0,00:00:00.000,2025-04-10 15:50:03.529
false,false,1,1,0,32,00:00:32.000,2025-04-10 15:48:51.889
false,false,2,2,0,65,00:00:33.000,2025-04-10 15:48:56.889
false,false,3,3,0,98,00:00:33.000,2025-04-10 15:49:01.890
false,false,4,4,0,129,00:00:31.000,2025-04-10 15:49:06.890
false,false,5,5,0,159,00:00:30.000,2025-04-10 15:49:11.891
false,false,10,10,0,161,00:00:33.000,2025-04-10 15:50:33.555
false,false,11,11,0,192,00:00:31.000,2025-04-10 15:50:38.560
false,false,12,12,0,222,00:00:30.000,2025-04-10 15:50:43.565
false,false,13,13,0,252,00:00:30.000,2025-04-10 15:50:48.568
false,false,14,14,0,282,00:00:30.000,2025-04-10 15:50:53.574
false,true,5,5,0,0,00:00:00.000,2025-04-10 15:50:08.534
false,false,6,6,0,33,00:00:33.000,2025-04-10 15:50:13.539
false,false,7,7,0,65,00:00:32.000,2025-04-10 15:50:18.542
false,false,8,8,0,97,00:00:32.000,2025-04-10 15:50:23.548
false,false,9,9,0,128,00:00:31.000,2025-04-10 15:50:28.552
false,false,1,1,0,33,00:00:33.000,2025-04-10 15:49:18.497
false,false,2,2,0,63,00:00:30.000,2025-04-10 15:49:23.499
false,false,3,3,0,94,00:00:31.000,2025-04-10 15:49:28.505
false,false,4,4,0,127,00:00:33.000,2025-04-10 15:49:33.507
false,false,5,5,0,160,00:00:33.000,2025-04-10 15:49:38.513
false,false,15,15,0,312,00:00:30.000,2025-04-10 15:50:58.575
false,false,16,16,0,345,00:00:33.000,2025-04-10 15:51:03.577
false,false,17,17,0,378,00:00:33.000,2025-04-10 15:51:08.583
false,false,18,18,0,410,00:00:32.000,2025-04-10 15:51:13.588
false,false,19,19,0,440,00:00:30.000,2025-04-10 15:51:18.590
false,false,20,20,0,472,00:00:32.000,2025-04-10 15:51:23.594
false,false,21,21,0,505,00:00:33.000,2025-04-10 15:51:28.599
false,false,22,22,0,538,00:00:33.000,2025-04-10 15:51:33.601
false,false,23,23,0,569,00:00:31.000,2025-04-10 15:51:38.606
false,false,24,24,0,602,00:00:33.000,2025-04-10 15:51:43.611
false,false,25,25,0,633,00:00:31.000,2025-04-10 15:51:48.613
false,false,26,26,0,665,00:00:32.000,2025-04-10 15:51:53.618
false,false,27,27,0,697,00:00:32.000,2025-04-10 15:51:58.619
false,false,28,28,0,729,00:00:32.000,2025-04-10 15:52:03.621
false,false,29,29,0,759,00:00:30.000,2025-04-10 15:52:08.626
false,false,30,30,0,789,00:00:30.000,2025-04-10 15:52:13.627
false,true,30,30,0,0,00:00:00.000,2025-04-10 15:52:18.630
false,true,30,30,0,0,00:00:00.000,2025-04-10 15:52:23.636
false,true,30,30,0,0,00:00:00.000,2025-04-10 15:52:28.641
false,true,30,30,0,0,00:00:00.000,2025-04-10 15:52:33.644
false,true,30,30,0,0,00:00:00.000,2025-04-10 15:52:38.650
false,true,30,30,0,0,00:00:00.000,2025-04-10 15:52:43.654
false,false,31,31,0,30,00:00:30.000,2025-04-10 15:52:48.657
false,false,32,32,0,61,00:00:31.000,2025-04-10 15:52:53.659
false,false,33,33,0,92,00:00:31.000,2025-04-10 15:52:58.663
false,false,34,34,0,122,00:00:30.000,2025-04-10 15:53:03.665
false,false,35,35,0,155,00:00:33.000,2025-04-10 15:53:08.670
false,false,36,36,0,187,00:00:32.000,2025-04-10 15:53:13.675
false,false,37,37,0,219,00:00:32.000,2025-04-10 15:53:18.677
false,false,38,38,0,249,00:00:30.000,2025-04-10 15:53:23.683
false,false,39,39,0,280,00:00:31.000,2025-04-10 15:53:28.688
false,false,40,40,0,313,00:00:33.000,2025-04-10 15:53:33.690
false,true,40,40,0,0,00:00:00.000,2025-04-10 15:53:38.690
false,true,40,40,0,0,00:00:00.000,2025-04-10 15:53:43.695
false,true,40,40,0,0,00:00:00.000,2025-04-10 15:53:48.698
false,true,40,40,0,0,00:00:00.000,2025-04-10 15:53:53.702
false,true,40,40,0,0,00:00:00.000,2025-04-10 15:53:58.707
false,true,40,40,0,0,00:00:00.000,2025-04-10 15:54:03.710
false,false,41,41,0,33,00:00:33.000,2025-04-10 15:54:08.715
false,false,42,42,0,65,00:00:32.000,2025-04-10 15:54:13.720
false,true,44,44,0,0,00:00:00.000,2025-04-10 15:54:43.741
false,true,44,44,0,0,00:00:00.000,2025-04-10 15:54:48.744
false,true,44,44,0,0,00:00:00.000,2025-04-10 15:54:53.749
false,false,45,45,0,32,00:00:32.000,2025-04-10 15:54:58.753
false,false,46,46,0,65,00:00:33.000,2025-04-10 15:55:03.756
false,false,47,47,0,96,00:00:31.000,2025-04-10 15:55:08.761
false,false,48,48,0,127,00:00:31.000,2025-04-10 15:55:13.764
false,false,49,49,0,157,00:00:30.000,2025-04-10 15:55:18.764
false,false,50,50,0,187,00:00:30.000,2025-04-10 15:55:23.769
false,false,51,51,0,217,00:00:30.000,2025-04-10 15:55:28.770
false,false,43,43,0,96,00:00:31.000,2025-04-10 15:54:18.722
false,false,44,44,0,128,00:00:32.000,2025-04-10 15:54:23.728
false,true,44,44,0,0,00:00:00.000,2025-04-10 15:54:28.733
false,true,44,44,0,0,00:00:00.000,2025-04-10 15:54:33.733
false,true,44,44,0,0,00:00:00.000,2025-04-10 15:54:38.739
false,true,53,53,0,0,00:00:00.000,2025-04-10 15:55:58.789
false,true,53,53,0,0,00:00:00.000,2025-04-10 15:56:03.792
false,true,53,53,0,0,00:00:00.000,2025-04-10 15:56:08.795
false,false,54,54,0,33,00:00:33.000,2025-04-10 15:56:13.797
false,false,55,55,0,66,00:00:33.000,2025-04-10 15:56:18.798
false,false,56,56,0,99,00:00:33.000,2025-04-10 15:56:23.799
false,false,57,57,0,129,00:00:30.000,2025-04-10 15:56:28.800
false,false,58,58,0,161,00:00:32.000,2025-04-10 15:56:33.801
false,false,59,59,0,191,00:00:30.000,2025-04-10 15:56:38.806
false,false,60,60,0,221,00:00:30.000,2025-04-10 15:56:43.811
false,false,52,52,0,248,00:00:31.000,2025-04-10 15:55:33.771
false,false,53,53,0,279,00:00:31.000,2025-04-10 15:55:38.774
false,true,53,53,0,0,00:00:00.000,2025-04-10 15:55:43.779
false,true,53,53,0,0,00:00:00.000,2025-04-10 15:55:48.782
false,true,53,53,0,0,00:00:00.000,2025-04-10 15:55:53.785
false,true,63,63,0,0,00:00:00.000,2025-04-10 15:57:13.836
false,true,63,63,0,0,00:00:00.000,2025-04-10 15:57:18.836
false,true,63,63,0,0,00:00:00.000,2025-04-10 15:57:23.841
false,true,63,63,0,0,00:00:00.000,2025-04-10 15:57:28.846
false,true,63,63,0,0,00:00:00.000,2025-04-10 15:57:33.849
false,false,61,61,0,254,00:00:33.000,2025-04-10 15:56:48.814
false,false,62,62,0,284,00:00:30.000,2025-04-10 15:56:53.819
false,false,63,63,0,316,00:00:32.000,2025-04-10 15:56:58.824
false,true,63,63,0,0,00:00:00.000,2025-04-10 15:57:03.824
false,true,63,63,0,0,00:00:00.000,2025-04-10 15:57:08.830
false,false,69,69,0,189,00:00:30.000,2025-04-10 15:58:28.889
false,false,70,70,0,220,00:00:31.000,2025-04-10 15:58:33.892
false,false,71,71,0,250,00:00:30.000,2025-04-10 15:58:38.894
false,false,72,72,0,282,00:00:32.000,2025-04-10 15:58:43.898
false,false,73,73,0,313,00:00:31.000,2025-04-10 15:58:48.901
false,true,63,63,0,0,00:00:00.000,2025-04-10 15:57:38.854
false,true,63,63,0,0,00:00:00.000,2025-04-10 15:57:43.859
false,true,63,63,0,0,00:00:00.000,2025-04-10 15:57:48.861
false,true,63,63,0,0,00:00:00.000,2025-04-10 15:57:53.866
false,true,63,63,0,0,00:00:00.000,2025-04-10 15:57:58.871
false,false,64,64,0,33,00:00:33.000,2025-04-10 15:58:03.875
false,false,65,65,0,66,00:00:33.000,2025-04-10 15:58:08.876
false,false,66,66,0,99,00:00:33.000,2025-04-10 15:58:13.877
false,false,67,67,0,129,00:00:30.000,2025-04-10 15:58:18.880
false,false,68,68,0,159,00:00:30.000,2025-04-10 15:58:23.884
false,true,78,77,1,0,00:00:00.000,2025-04-10 15:59:43.946
false,false,79,78,1,33,00:00:33.000,2025-04-10 15:59:48.949
false,false,80,79,1,64,00:00:31.000,2025-04-10 15:59:53.950
false,true,80,79,1,0,00:00:00.000,2025-04-10 15:59:58.951
false,true,80,79,1,0,00:00:00.000,2025-04-10 16:00:03.954
false,false,74,74,0,346,00:00:33.000,2025-04-10 15:58:53.903
false,false,75,75,0,379,00:00:33.000,2025-04-10 15:58:58.909
false,false,76,76,0,409,00:00:30.000,2025-04-10 15:59:03.913
false,false,77,76,1,442,00:00:33.000,2025-04-10 15:59:08.917
false,false,78,77,1,473,00:00:31.000,2025-04-10 15:59:13.922
false,true,78,77,1,0,00:00:00.000,2025-04-10 15:59:18.924
false,true,78,77,1,0,00:00:00.000,2025-04-10 15:59:23.929
false,true,78,77,1,0,00:00:00.000,2025-04-10 15:59:28.934
false,true,78,77,1,0,00:00:00.000,2025-04-10 15:59:33.936
false,true,78,77,1,0,00:00:00.000,2025-04-10 15:59:38.941
false,false,82,80,2,65,00:00:33.000,2025-04-10 16:00:33.971
false,false,83,81,2,98,00:00:33.000,2025-04-10 16:00:38.975
false,false,84,82,2,129,00:00:31.000,2025-04-10 16:00:43.980
false,false,85,83,2,162,00:00:33.000,2025-04-10 16:00:48.983
false,false,86,84,2,194,00:00:32.000,2025-04-10 16:00:53.986
false,false,87,85,2,227,00:00:33.000,2025-04-10 16:00:58.991
false,false,88,86,2,259,00:00:32.000,2025-04-10 16:01:03.992
false,false,89,87,2,289,00:00:30.000,2025-04-10 16:01:08.994
false,false,90,88,2,322,00:00:33.000,2025-04-10 16:01:13.993
false,false,91,89,2,353,00:00:31.000,2025-04-10 16:01:18.996
false,false,92,90,2,386,00:00:33.000,2025-04-10 16:01:23.999
false,false,93,91,2,416,00:00:30.000,2025-04-10 16:01:29.000
false,false,94,92,2,446,00:00:30.000,2025-04-10 16:01:34.003
false,true,94,92,2,0,00:00:00.000,2025-04-10 16:01:39.009
false,true,94,92,2,0,00:00:00.000,2025-04-10 16:01:44.011
false,false,96,94,2,64,00:00:31.000,2025-04-10 16:02:14.030
false,true,96,94,2,0,00:00:00.000,2025-04-10 16:02:19.034
false,true,96,94,2,0,00:00:00.000,2025-04-10 16:02:24.036
false,true,96,94,2,0,00:00:00.000,2025-04-10 16:02:29.041
false,true,96,94,2,0,00:00:00.000,2025-04-10 16:02:34.041
false,true,94,92,2,0,00:00:00.000,2025-04-10 16:01:49.013
false,true,94,92,2,0,00:00:00.000,2025-04-10 16:01:54.015
false,true,94,92,2,0,00:00:00.000,2025-04-10 16:01:59.018
false,true,94,92,2,0,00:00:00.000,2025-04-10 16:02:04.020
false,false,95,93,2,33,00:00:33.000,2025-04-10 16:02:09.025
false,true,80,79,1,0,00:00:00.000,2025-04-10 16:00:08.958
false,true,80,79,1,0,00:00:00.000,2025-04-10 16:00:13.963
false,true,80,79,1,0,00:00:00.000,2025-04-10 16:00:18.964
false,true,80,79,1,0,00:00:00.000,2025-04-10 16:00:23.969
false,false,81,79,2,32,00:00:32.000,2025-04-10 16:00:28.971
false,false,100,98,2,130,00:00:33.000,2025-04-10 16:03:04.065
false,false,101,99,2,160,00:00:30.000,2025-04-10 16:03:09.071
false,false,102,100,2,191,00:00:31.000,2025-04-10 16:03:14.075
false,false,103,101,2,223,00:00:32.000,2025-04-10 16:03:19.075
false,false,104,102,2,255,00:00:32.000,2025-04-10 16:03:24.080
false,false,110,108,2,440,00:00:30.000,2025-04-10 16:03:54.099
false,false,111,108,3,470,00:00:30.000,2025-04-10 16:03:59.100
false,false,112,109,3,501,00:00:31.000,2025-04-10 16:04:04.101
false,false,113,110,3,534,00:00:33.000,2025-04-10 16:04:09.106
false,false,114,111,3,564,00:00:30.000,2025-04-10 16:04:14.111
false,true,96,94,2,0,00:00:00.000,2025-04-10 16:02:39.046
false,true,96,94,2,0,00:00:00.000,2025-04-10 16:02:44.049
false,false,97,95,2,32,00:00:32.000,2025-04-10 16:02:49.051
false,false,98,96,2,64,00:00:32.000,2025-04-10 16:02:54.056
false,false,99,97,2,97,00:00:33.000,2025-04-10 16:02:59.062
false,false,105,103,2,285,00:00:30.000,2025-04-10 16:03:29.082
false,false,106,104,2,318,00:00:33.000,2025-04-10 16:03:34.084
false,false,107,105,2,350,00:00:32.000,2025-04-10 16:03:39.086
false,false,108,106,2,380,00:00:30.000,2025-04-10 16:03:44.091
false,false,109,107,2,410,00:00:30.000,2025-04-10 16:03:49.094
false,false,120,116,4,748,00:00:30.000,2025-04-10 16:04:44.132
false,false,121,117,4,780,00:00:32.000,2025-04-10 16:04:49.135
false,false,122,118,4,813,00:00:33.000,2025-04-10 16:04:54.141
false,false,123,119,4,846,00:00:33.000,2025-04-10 16:04:59.146
false,false,124,120,4,876,00:00:30.000,2025-04-10 16:05:04.149
false,false,115,112,3,595,00:00:31.000,2025-04-10 16:04:19.112
false,false,116,113,3,625,00:00:30.000,2025-04-10 16:04:24.118
false,false,117,113,4,657,00:00:32.000,2025-04-10 16:04:29.123
false,false,118,114,4,688,00:00:31.000,2025-04-10 16:04:34.126
false,false,119,115,4,718,00:00:30.000,2025-04-10 16:04:39.127
false,false,125,121,4,908,00:00:32.000,2025-04-10 16:05:09.150
false,false,126,122,4,940,00:00:32.000,2025-04-10 16:05:14.155
false,false,127,123,4,973,00:00:33.000,2025-04-10 16:05:19.156
false,false,128,124,4,1004,00:00:31.000,2025-04-10 16:05:24.157
false,false,129,125,4,1034,00:00:30.000,2025-04-10 16:05:29.162
false,false,135,130,5,1221,00:00:32.000,2025-04-10 16:05:59.188
false,false,136,131,5,1252,00:00:31.000,2025-04-10 16:06:04.191
false,false,137,131,6,1285,00:00:33.000,2025-04-10 16:06:09.196
false,false,138,132,6,1318,00:00:33.000,2025-04-10 16:06:14.202
false,false,139,133,6,1348,00:00:30.000,2025-04-10 16:06:19.205
false,false,140,134,6,1380,00:00:32.000,2025-04-10 16:06:24.211
false,false,141,135,6,1411,00:00:31.000,2025-04-10 16:06:29.215
false,false,142,136,6,1443,00:00:32.000,2025-04-10 16:06:34.218
false,false,143,137,6,1474,00:00:31.000,2025-04-10 16:06:39.220
false,false,144,138,6,1507,00:00:33.000,2025-04-10 16:06:44.222
false,false,145,139,6,1537,00:00:30.000,2025-04-10 16:06:49.223
false,false,146,140,6,1569,00:00:32.000,2025-04-10 16:06:54.227
false,false,147,141,6,1600,00:00:31.000,2025-04-10 16:06:59.234
false,false,148,142,6,1631,00:00:31.000,2025-04-10 16:07:04.237
false,true,148,142,6,0,00:00:00.000,2025-04-10 16:07:09.240
false,true,148,142,6,0,00:00:00.000,2025-04-10 16:07:14.245
false,true,148,142,6,0,00:00:00.000,2025-04-10 16:07:19.247
false,true,148,142,6,0,00:00:00.000,2025-04-10 16:07:24.253
false,true,148,142,6,0,00:00:00.000,2025-04-10 16:07:29.255
false,true,148,142,6,0,00:00:00.000,2025-04-10 16:07:34.258
false,false,130,126,4,1065,00:00:31.000,2025-04-10 16:05:34.165
false,false,131,127,4,1097,00:00:32.000,2025-04-10 16:05:39.170
false,false,132,127,5,1128,00:00:31.000,2025-04-10 16:05:44.174
false,false,133,128,5,1158,00:00:30.000,2025-04-10 16:05:49.178
false,false,134,129,5,1189,00:00:31.000,2025-04-10 16:05:54.183
false,false,149,143,6,31,00:00:31.000,2025-04-10 16:07:39.263
false,false,150,144,6,64,00:00:33.000,2025-04-10 16:07:44.268
false,false,151,145,6,97,00:00:33.000,2025-04-10 16:07:49.272
false,false,152,146,6,127,00:00:30.000,2025-04-10 16:07:54.272
false,false,153,147,6,157,00:00:30.000,2025-04-10 16:07:59.277
false,false,159,152,7,348,00:00:31.000,2025-04-10 16:08:29.303
false,false,160,152,8,379,00:00:31.000,2025-04-10 16:08:34.306
false,false,161,153,8,409,00:00:30.000,2025-04-10 16:08:39.310
false,false,162,154,8,442,00:00:33.000,2025-04-10 16:08:44.315
false,false,163,154,9,475,00:00:33.000,2025-04-10 16:08:49.318
false,false,154,148,6,190,00:00:33.000,2025-04-10 16:08:04.280
false,false,155,149,6,223,00:00:33.000,2025-04-10 16:08:09.286
false,false,156,149,7,254,00:00:31.000,2025-04-10 16:08:14.290
false,false,157,150,7,287,00:00:33.000,2025-04-10 16:08:19.293
false,false,158,151,7,317,00:00:30.000,2025-04-10 16:08:24.298
false,false,164,155,9,507,00:00:32.000,2025-04-10 16:08:54.320
false,false,165,156,9,537,00:00:30.000,2025-04-10 16:08:59.324
false,false,166,157,9,570,00:00:33.000,2025-04-10 16:09:04.328
false,false,167,158,9,601,00:00:31.000,2025-04-10 16:09:09.333
false,false,168,159,9,631,00:00:30.000,2025-04-10 16:09:14.337
false,false,169,160,9,664,00:00:33.000,2025-04-10 16:09:19.341
false,false,170,161,9,695,00:00:31.000,2025-04-10 16:09:24.346
false,false,171,162,9,727,00:00:32.000,2025-04-10 16:09:29.346
false,false,172,163,9,760,00:00:33.000,2025-04-10 16:09:34.347
false,false,173,164,9,792,00:00:32.000,2025-04-10 16:09:39.350
false,false,182,173,9,126,00:00:32.000,2025-04-10 16:11:24.433
false,true,182,173,9,0,00:00:00.000,2025-04-10 16:11:29.436
false,true,182,173,9,0,00:00:00.000,2025-04-10 16:11:34.436
false,true,182,173,9,0,00:00:00.000,2025-04-10 16:11:39.448
false,true,182,173,9,0,00:00:00.000,2025-04-10 16:11:44.452
false,true,178,169,9,0,00:00:00.000,2025-04-10 16:10:59.413
false,true,178,169,9,0,00:00:00.000,2025-04-10 16:11:04.416
false,false,179,170,9,33,00:00:33.000,2025-04-10 16:11:09.422
false,false,180,171,9,64,00:00:31.000,2025-04-10 16:11:14.427
false,false,181,172,9,94,00:00:30.000,2025-04-10 16:11:19.427
false,false,178,169,9,31,00:00:31.000,2025-04-10 16:10:34.388
false,true,178,169,9,0,00:00:00.000,2025-04-10 16:10:39.393
false,true,178,169,9,0,00:00:00.000,2025-04-10 16:10:44.399
false,true,178,169,9,0,00:00:00.000,2025-04-10 16:10:49.402
false,true,178,169,9,0,00:00:00.000,2025-04-10 16:10:54.408
false,false,174,165,9,824,00:00:32.000,2025-04-10 16:09:44.355
false,false,175,166,9,857,00:00:33.000,2025-04-10 16:09:49.356
false,false,176,167,9,888,00:00:31.000,2025-04-10 16:09:54.359
false,false,177,168,9,920,00:00:32.000,2025-04-10 16:09:59.359
false,true,177,168,9,0,00:00:00.000,2025-04-10 16:10:04.362
false,true,182,173,9,0,00:00:00.000,2025-04-10 16:11:49.452
false,true,182,173,9,0,00:00:00.000,2025-04-10 16:11:54.457
false,false,183,174,9,30,00:00:30.000,2025-04-10 16:11:59.461
false,false,184,174,10,60,00:00:30.000,2025-04-10 16:12:04.464
false,false,185,175,10,90,00:00:30.000,2025-04-10 16:12:09.465
false,true,177,168,9,0,00:00:00.000,2025-04-10 16:10:09.367
false,true,177,168,9,0,00:00:00.000,2025-04-10 16:10:14.373
false,true,177,168,9,0,00:00:00.000,2025-04-10 16:10:19.376
false,true,177,168,9,0,00:00:00.000,2025-04-10 16:10:24.381
false,true,177,168,9,0,00:00:00.000,2025-04-10 16:10:29.385
false,false,186,175,11,123,00:00:33.000,2025-04-10 16:12:14.467
false,false,187,176,11,156,00:00:33.000,2025-04-10 16:12:19.470
false,false,188,177,11,189,00:00:33.000,2025-04-10 16:12:24.473
false,false,189,178,11,221,00:00:32.000,2025-04-10 16:12:29.478
false,false,190,179,11,251,00:00:30.000,2025-04-10 16:12:34.481
false,true,196,184,12,0,00:00:00.000,2025-04-10 16:13:29.517
false,true,196,184,12,0,00:00:00.000,2025-04-10 16:13:34.519
false,false,197,185,12,30,00:00:30.000,2025-04-10 16:13:39.524
false,false,198,186,12,60,00:00:30.000,2025-04-10 16:13:44.530
false,false,199,187,12,92,00:00:32.000,2025-04-10 16:13:49.533
false,false,191,180,11,282,00:00:31.000,2025-04-10 16:12:39.487
false,false,192,181,11,312,00:00:30.000,2025-04-10 16:12:44.490
false,false,193,181,12,345,00:00:33.000,2025-04-10 16:12:49.492
false,false,194,182,12,376,00:00:31.000,2025-04-10 16:12:54.497
false,false,195,183,12,409,00:00:33.000,2025-04-10 16:12:59.498
false,false,196,184,12,441,00:00:32.000,2025-04-10 16:13:04.499
false,true,196,184,12,0,00:00:00.000,2025-04-10 16:13:09.503
false,true,196,184,12,0,00:00:00.000,2025-04-10 16:13:14.508
false,true,196,184,12,0,00:00:00.000,2025-04-10 16:13:19.511
false,true,196,184,12,0,00:00:00.000,2025-04-10 16:13:24.516
false,false,205,193,12,286,00:00:31.000,2025-04-10 16:14:19.554
false,false,206,194,12,318,00:00:32.000,2025-04-10 16:14:24.555
false,false,207,195,12,350,00:00:32.000,2025-04-10 16:14:29.562
false,false,208,196,12,381,00:00:31.000,2025-04-10 16:14:34.566
false,false,209,197,12,413,00:00:32.000,2025-04-10 16:14:39.571
false,false,200,188,12,125,00:00:33.000,2025-04-10 16:13:54.538
false,false,201,189,12,158,00:00:33.000,2025-04-10 16:13:59.542
false,false,202,190,12,190,00:00:32.000,2025-04-10 16:14:04.545
false,false,203,191,12,223,00:00:33.000,2025-04-10 16:14:09.550
false,false,204,192,12,255,00:00:32.000,2025-04-10 16:14:14.552
false,false,215,203,12,596,00:00:30.000,2025-04-10 16:15:09.597
false,false,216,204,12,626,00:00:30.000,2025-04-10 16:15:14.602
false,false,217,204,13,659,00:00:33.000,2025-04-10 16:15:19.604
false,false,218,205,13,692,00:00:33.000,2025-04-10 16:15:24.609
false,false,219,205,14,723,00:00:31.000,2025-04-10 16:15:29.614
false,false,210,198,12,443,00:00:30.000,2025-04-10 16:14:44.576
false,false,211,199,12,474,00:00:31.000,2025-04-10 16:14:49.579
false,false,212,200,12,506,00:00:32.000,2025-04-10 16:14:54.584
false,false,213,201,12,536,00:00:30.000,2025-04-10 16:14:59.590
false,false,214,202,12,566,00:00:30.000,2025-04-10 16:15:04.591
false,false,225,210,15,913,00:00:32.000,2025-04-10 16:15:59.637
false,false,226,211,15,944,00:00:31.000,2025-04-10 16:16:04.640
false,false,227,212,15,974,00:00:30.000,2025-04-10 16:16:09.641
false,false,228,213,15,1007,00:00:33.000,2025-04-10 16:16:14.647
false,false,229,214,15,1040,00:00:33.000,2025-04-10 16:16:19.650
false,true,229,214,15,0,00:00:00.000,2025-04-10 16:16:24.654
false,true,229,214,15,0,00:00:00.000,2025-04-10 16:16:29.659
false,true,229,214,15,0,00:00:00.000,2025-04-10 16:16:34.663
false,true,229,214,15,0,00:00:00.000,2025-04-10 16:16:39.668
false,true,229,214,15,0,00:00:00.000,2025-04-10 16:16:44.672
false,true,229,214,15,0,00:00:00.000,2025-04-10 16:16:49.675
false,false,230,215,15,31,00:00:31.000,2025-04-10 16:16:54.679
false,false,231,216,15,63,00:00:32.000,2025-04-10 16:16:59.685
false,false,232,217,15,94,00:00:31.000,2025-04-10 16:17:04.687
false,false,233,218,15,125,00:00:31.000,2025-04-10 16:17:09.689
false,false,234,218,16,156,00:00:31.000,2025-04-10 16:17:14.691
false,false,235,219,16,189,00:00:33.000,2025-04-10 16:17:19.693
false,false,236,220,16,220,00:00:31.000,2025-04-10 16:17:24.695
false,false,237,221,16,253,00:00:33.000,2025-04-10 16:17:29.695
false,false,238,222,16,283,00:00:30.000,2025-04-10 16:17:34.699
false,false,239,223,16,315,00:00:32.000,2025-04-10 16:17:39.703
false,false,240,224,16,346,00:00:31.000,2025-04-10 16:17:44.709
false,true,240,224,16,0,00:00:00.000,2025-04-10 16:17:49.712
false,true,240,224,16,0,00:00:00.000,2025-04-10 16:17:54.713
false,true,240,224,16,0,00:00:00.000,2025-04-10 16:17:59.720
false,false,220,206,14,755,00:00:32.000,2025-04-10 16:15:34.618
false,false,221,207,14,787,00:00:32.000,2025-04-10 16:15:39.621
false,false,222,208,14,819,00:00:32.000,2025-04-10 16:15:44.626
false,false,223,209,14,850,00:00:31.000,2025-04-10 16:15:49.630
false,false,224,210,14,881,00:00:31.000,2025-04-10 16:15:54.631
false,true,240,224,16,0,00:00:00.000,2025-04-10 16:18:04.722
false,true,240,224,16,0,00:00:00.000,2025-04-10 16:18:09.723
false,true,240,224,16,0,00:00:00.000,2025-04-10 16:18:14.729
false,false,241,225,16,33,00:00:33.000,2025-04-10 16:18:19.731
false,false,242,226,16,63,00:00:30.000,2025-04-10 16:18:24.734
false,false,248,232,16,251,00:00:33.000,2025-04-10 16:18:54.748
false,false,249,233,16,284,00:00:33.000,2025-04-10 16:18:59.753
false,false,250,234,16,315,00:00:31.000,2025-04-10 16:19:04.757
false,false,251,235,16,347,00:00:32.000,2025-04-10 16:19:09.758
false,false,252,236,16,380,00:00:33.000,2025-04-10 16:19:14.763
false,false,253,237,16,412,00:00:32.000,2025-04-10 16:19:19.765
false,false,254,238,16,444,00:00:32.000,2025-04-10 16:19:24.772
false,false,255,239,16,477,00:00:33.000,2025-04-10 16:19:29.776
false,false,256,240,16,508,00:00:31.000,2025-04-10 16:19:34.780
false,false,257,241,16,538,00:00:30.000,2025-04-10 16:19:39.782
false,false,243,227,16,94,00:00:31.000,2025-04-10 16:18:29.734
false,false,244,228,16,125,00:00:31.000,2025-04-10 16:18:34.737
false,false,245,229,16,157,00:00:32.000,2025-04-10 16:18:39.741
false,false,246,230,16,188,00:00:31.000,2025-04-10 16:18:44.743
false,false,247,231,16,218,00:00:30.000,2025-04-10 16:18:49.746
false,true,258,242,16,0,00:00:00.000,2025-04-10 16:20:09.804
false,true,258,242,16,0,00:00:00.000,2025-04-10 16:20:14.809
false,false,259,243,16,33,00:00:33.000,2025-04-10 16:20:19.813
false,false,260,244,16,65,00:00:32.000,2025-04-10 16:20:24.816
false,false,261,245,16,97,00:00:32.000,2025-04-10 16:20:29.822
false,true,261,245,16,0,00:00:00.000,2025-04-10 16:20:34.826
false,true,261,245,16,0,00:00:00.000,2025-04-10 16:20:39.830
false,true,261,245,16,0,00:00:00.000,2025-04-10 16:20:44.834
false,true,261,245,16,0,00:00:00.000,2025-04-10 16:20:49.838
false,true,261,245,16,0,00:00:00.000,2025-04-10 16:20:54.840
false,false,258,242,16,570,00:00:32.000,2025-04-10 16:19:44.787
false,true,258,242,16,0,00:00:00.000,2025-04-10 16:19:49.790
false,true,258,242,16,0,00:00:00.000,2025-04-10 16:19:54.795
false,true,258,242,16,0,00:00:00.000,2025-04-10 16:19:59.801
false,true,258,242,16,0,00:00:00.000,2025-04-10 16:20:04.801
false,true,261,245,16,0,00:00:00.000,2025-04-10 16:20:59.843
false,false,262,246,16,31,00:00:31.000,2025-04-10 16:21:04.847
false,false,263,247,16,63,00:00:32.000,2025-04-10 16:21:09.852
false,false,264,248,16,93,00:00:30.000,2025-04-10 16:21:14.857
false,false,265,249,16,123,00:00:30.000,2025-04-10 16:21:19.861
false,false,275,258,17,125,00:00:32.000,2025-04-10 16:22:39.921
false,false,276,259,17,155,00:00:30.000,2025-04-10 16:22:44.924
false,false,277,260,17,188,00:00:33.000,2025-04-10 16:22:49.928
false,false,278,261,17,219,00:00:31.000,2025-04-10 16:22:54.933
false,false,279,262,17,249,00:00:30.000,2025-04-10 16:22:59.938
false,true,271,255,16,0,00:00:00.000,2025-04-10 16:22:14.905
false,true,271,255,16,0,00:00:00.000,2025-04-10 16:22:19.907
false,false,272,256,16,31,00:00:31.000,2025-04-10 16:22:24.910
false,false,273,257,16,61,00:00:30.000,2025-04-10 16:22:29.915
false,false,274,258,16,93,00:00:32.000,2025-04-10 16:22:34.919
false,false,271,255,16,310,00:00:31.000,2025-04-10 16:21:49.881
false,true,271,255,16,0,00:00:00.000,2025-04-10 16:21:54.887
false,true,271,255,16,0,00:00:00.000,2025-04-10 16:21:59.890
false,true,271,255,16,0,00:00:00.000,2025-04-10 16:22:04.893
false,true,271,255,16,0,00:00:00.000,2025-04-10 16:22:09.899
false,false,266,250,16,154,00:00:31.000,2025-04-10 16:21:24.864
false,false,267,251,16,186,00:00:32.000,2025-04-10 16:21:29.870
false,false,268,252,16,217,00:00:31.000,2025-04-10 16:21:34.873
false,false,269,253,16,249,00:00:32.000,2025-04-10 16:21:39.878
false,false,270,254,16,279,00:00:30.000,2025-04-10 16:21:44.878
false,true,279,262,17,0,00:00:00.000,2025-04-10 16:23:04.943
false,true,279,262,17,0,00:00:00.000,2025-04-10 16:23:09.946
false,true,279,262,17,0,00:00:00.000,2025-04-10 16:23:14.951
false,true,279,262,17,0,00:00:00.000,2025-04-10 16:23:19.954
false,true,279,262,17,0,00:00:00.000,2025-04-10 16:23:24.959
false,true,279,262,17,0,00:00:00.000,2025-04-10 16:23:29.961
false,false,280,263,17,31,00:00:31.000,2025-04-10 16:23:34.965
false,false,281,264,17,64,00:00:33.000,2025-04-10 16:23:39.970
false,false,282,265,17,97,00:00:33.000,2025-04-10 16:23:44.975
false,true,282,265,17,0,00:00:00.000,2025-04-10 16:23:49.979
false,false,283,266,17,30,00:00:30.000,2025-04-10 16:24:20.001
false,false,284,267,17,61,00:00:31.000,2025-04-10 16:24:25.006
false,false,285,268,17,92,00:00:31.000,2025-04-10 16:24:30.007
false,false,286,269,17,125,00:00:33.000,2025-04-10 16:24:35.012
false,false,287,270,17,156,00:00:31.000,2025-04-10 16:24:40.017
false,false,293,275,18,344,00:00:33.000,2025-04-10 16:25:10.035
false,false,294,276,18,376,00:00:32.000,2025-04-10 16:25:15.040
false,false,295,277,18,406,00:00:30.000,2025-04-10 16:25:20.042
false,false,296,278,18,436,00:00:30.000,2025-04-10 16:25:25.043
false,false,297,279,18,468,00:00:32.000,2025-04-10 16:25:30.046
false,false,288,271,17,186,00:00:30.000,2025-04-10 16:24:45.019
false,false,289,272,17,219,00:00:33.000,2025-04-10 16:24:50.024
false,false,290,272,18,250,00:00:31.000,2025-04-10 16:24:55.027
false,false,291,273,18,280,00:00:30.000,2025-04-10 16:25:00.030
false,false,292,274,18,311,00:00:31.000,2025-04-10 16:25:05.034
false,true,282,265,17,0,00:00:00.000,2025-04-10 16:23:54.984
false,true,282,265,17,0,00:00:00.000,2025-04-10 16:23:59.986
false,true,282,265,17,0,00:00:00.000,2025-04-10 16:24:04.989
false,true,282,265,17,0,00:00:00.000,2025-04-10 16:24:09.994
false,true,282,265,17,0,00:00:00.000,2025-04-10 16:24:14.997
false,false,313,294,19,974,00:00:33.000,2025-04-10 16:26:50.100
false,false,314,295,19,1007,00:00:33.000,2025-04-10 16:26:55.103
false,false,315,296,19,1040,00:00:33.000,2025-04-10 16:27:00.108
false,false,316,297,19,1071,00:00:31.000,2025-04-10 16:27:05.111
false,false,317,298,19,1101,00:00:30.000,2025-04-10 16:27:10.115
false,false,308,289,19,817,00:00:30.000,2025-04-10 16:26:25.091
false,false,309,290,19,849,00:00:32.000,2025-04-10 16:26:30.091
false,false,310,291,19,879,00:00:30.000,2025-04-10 16:26:35.095
false,false,311,292,19,909,00:00:30.000,2025-04-10 16:26:40.098
false,false,312,293,19,941,00:00:32.000,2025-04-10 16:26:45.097
false,false,318,299,19,1132,00:00:31.000,2025-04-10 16:27:15.121
false,false,319,300,19,1163,00:00:31.000,2025-04-10 16:27:20.123
false,false,320,301,19,1196,00:00:33.000,2025-04-10 16:27:25.127
false,false,321,302,19,1227,00:00:31.000,2025-04-10 16:27:30.130
false,false,322,303,19,1257,00:00:30.000,2025-04-10 16:27:35.131
false,false,298,280,18,501,00:00:33.000,2025-04-10 16:25:35.050
false,false,299,281,18,532,00:00:31.000,2025-04-10 16:25:40.055
false,false,300,282,18,563,00:00:31.000,2025-04-10 16:25:45.060
false,false,301,282,19,596,00:00:33.000,2025-04-10 16:25:50.064
false,false,302,283,19,627,00:00:31.000,2025-04-10 16:25:55.069
false,false,303,284,19,660,00:00:33.000,2025-04-10 16:26:00.073
false,false,304,285,19,691,00:00:31.000,2025-04-10 16:26:05.077
false,false,305,286,19,723,00:00:32.000,2025-04-10 16:26:10.080
false,false,306,287,19,755,00:00:32.000,2025-04-10 16:26:15.085
false,false,307,288,19,787,00:00:32.000,2025-04-10 16:26:20.089
false,false,323,304,19,1289,00:00:32.000,2025-04-10 16:27:40.136
false,false,324,305,19,1321,00:00:32.000,2025-04-10 16:27:45.141
false,false,325,306,19,1353,00:00:32.000,2025-04-10 16:27:50.143
false,false,326,307,19,1386,00:00:33.000,2025-04-10 16:27:55.148
false,false,327,308,19,1417,00:00:31.000,2025-04-10 16:28:00.153
false,false,333,312,21,1608,00:00:33.000,2025-04-10 16:28:30.177
false,false,334,313,21,1639,00:00:31.000,2025-04-10 16:28:35.180
false,false,335,314,21,1671,00:00:32.000,2025-04-10 16:28:40.181
false,false,336,315,21,1701,00:00:30.000,2025-04-10 16:28:45.183
false,false,337,315,22,1733,00:00:32.000,2025-04-10 16:28:50.185
false,true,337,315,22,0,00:00:00.000,2025-04-10 16:29:45.227
false,true,337,315,22,0,00:00:00.000,2025-04-10 16:29:50.231
false,false,338,316,22,32,00:00:32.000,2025-04-10 16:29:55.234
false,false,339,317,22,62,00:00:30.000,2025-04-10 16:30:00.237
false,false,340,318,22,94,00:00:32.000,2025-04-10 16:30:05.238
false,false,328,309,19,1450,00:00:33.000,2025-04-10 16:28:05.158
false,false,329,309,20,1481,00:00:31.000,2025-04-10 16:28:10.164
false,false,330,310,20,1513,00:00:32.000,2025-04-10 16:28:15.166
false,false,331,311,20,1545,00:00:32.000,2025-04-10 16:28:20.170
false,false,332,311,21,1575,00:00:30.000,2025-04-10 16:28:25.174
false,false,341,319,22,126,00:00:32.000,2025-04-10 16:30:10.240
false,false,342,320,22,158,00:00:32.000,2025-04-10 16:30:15.243
false,false,343,321,22,188,00:00:30.000,2025-04-10 16:30:20.244
false,false,344,322,22,218,00:00:30.000,2025-04-10 16:30:25.245
false,false,345,323,22,250,00:00:32.000,2025-04-10 16:30:30.247
false,true,337,315,22,0,00:00:00.000,2025-04-10 16:29:20.211
false,true,337,315,22,0,00:00:00.000,2025-04-10 16:29:25.212
false,true,337,315,22,0,00:00:00.000,2025-04-10 16:29:30.217
false,true,337,315,22,0,00:00:00.000,2025-04-10 16:29:35.221
false,true,337,315,22,0,00:00:00.000,2025-04-10 16:29:40.226
false,true,337,315,22,0,00:00:00.000,2025-04-10 16:28:55.190
false,true,337,315,22,0,00:00:00.000,2025-04-10 16:29:00.195
false,true,337,315,22,0,00:00:00.000,2025-04-10 16:29:05.200
false,true,337,315,22,0,00:00:00.000,2025-04-10 16:29:10.205
false,true,337,315,22,0,00:00:00.000,2025-04-10 16:29:15.209
false,false,346,324,22,282,00:00:32.000,2025-04-10 16:30:35.248
false,false,347,325,22,313,00:00:31.000,2025-04-10 16:30:40.253
false,false,348,326,22,343,00:00:30.000,2025-04-10 16:30:45.258
false,false,349,327,22,376,00:00:33.000,2025-04-10 16:30:50.262
false,false,350,328,22,406,00:00:30.000,2025-04-10 16:30:55.267
false,false,360,338,22,126,00:00:32.000,2025-04-10 16:32:15.325
false,false,361,339,22,158,00:00:32.000,2025-04-10 16:32:20.329
false,false,362,340,22,189,00:00:31.000,2025-04-10 16:32:25.335
false,true,362,340,22,0,00:00:00.000,2025-04-10 16:32:30.337
false,true,362,340,22,0,00:00:00.000,2025-04-10 16:32:35.341
false,true,356,334,22,0,00:00:00.000,2025-04-10 16:31:50.307
false,true,356,334,22,0,00:00:00.000,2025-04-10 16:31:55.309
false,false,357,335,22,30,00:00:30.000,2025-04-10 16:32:00.313
false,false,358,336,22,61,00:00:31.000,2025-04-10 16:32:05.317
false,false,359,337,22,94,00:00:33.000,2025-04-10 16:32:10.319
false,true,362,340,22,0,00:00:00.000,2025-04-10 16:32:40.342
false,true,362,340,22,0,00:00:00.000,2025-04-10 16:32:45.343
false,true,362,340,22,0,00:00:00.000,2025-04-10 16:32:50.344
false,true,362,340,22,0,00:00:00.000,2025-04-10 16:32:55.350
false,false,363,341,22,30,00:00:30.000,2025-04-10 16:33:00.355
false,false,351,329,22,438,00:00:32.000,2025-04-10 16:31:00.273
false,false,352,330,22,471,00:00:33.000,2025-04-10 16:31:05.275
false,false,353,331,22,502,00:00:31.000,2025-04-10 16:31:10.281
false,false,354,332,22,534,00:00:32.000,2025-04-10 16:31:15.285
false,false,355,333,22,565,00:00:31.000,2025-04-10 16:31:20.286
false,false,379,354,25,543,00:00:31.000,2025-04-10 16:34:20.409
false,false,380,355,25,574,00:00:31.000,2025-04-10 16:34:25.409
false,false,381,356,25,607,00:00:33.000,2025-04-10 16:34:30.412
false,false,382,357,25,638,00:00:31.000,2025-04-10 16:34:35.414
false,false,383,358,25,668,00:00:30.000,2025-04-10 16:34:40.417
false,false,364,341,23,63,00:00:33.000,2025-04-10 16:33:05.356
false,false,365,342,23,96,00:00:33.000,2025-04-10 16:33:10.361
false,false,366,343,23,126,00:00:30.000,2025-04-10 16:33:15.367
false,false,367,344,23,159,00:00:33.000,2025-04-10 16:33:20.371
false,false,368,345,23,191,00:00:32.000,2025-04-10 16:33:25.373
false,false,356,334,22,596,00:00:31.000,2025-04-10 16:31:25.289
false,true,356,334,22,0,00:00:00.000,2025-04-10 16:31:30.294
false,true,356,334,22,0,00:00:00.000,2025-04-10 16:31:35.296
false,true,356,334,22,0,00:00:00.000,2025-04-10 16:31:40.302
false,true,356,334,22,0,00:00:00.000,2025-04-10 16:31:45.306
false,false,384,359,25,699,00:00:31.000,2025-04-10 16:34:45.419
false,false,385,360,25,729,00:00:30.000,2025-04-10 16:34:50.421
false,false,386,361,25,760,00:00:31.000,2025-04-10 16:34:55.425
false,false,387,362,25,793,00:00:33.000,2025-04-10 16:35:00.428
false,false,388,363,25,826,00:00:33.000,2025-04-10 16:35:05.430
false,false,369,346,23,224,00:00:33.000,2025-04-10 16:33:30.378
false,false,370,347,23,257,00:00:33.000,2025-04-10 16:33:35.379
false,false,371,348,23,290,00:00:33.000,2025-04-10 16:33:40.384
false,false,372,348,24,323,00:00:33.000,2025-04-10 16:33:45.384
false,false,373,348,25,353,00:00:30.000,2025-04-10 16:33:50.385
false,false,374,349,25,385,00:00:32.000,2025-04-10 16:33:55.390
false,false,375,350,25,416,00:00:31.000,2025-04-10 16:34:00.394
false,false,376,351,25,447,00:00:31.000,2025-04-10 16:34:05.398
false,false,377,352,25,479,00:00:32.000,2025-04-10 16:34:10.400
false,false,378,353,25,512,00:00:33.000,2025-04-10 16:34:15.403
false,true,388,363,25,0,00:00:00.000,2025-04-10 16:35:10.435
false,true,388,363,25,0,00:00:00.000,2025-04-10 16:35:15.436
false,true,388,363,25,0,00:00:00.000,2025-04-10 16:35:20.440
false,true,388,363,25,0,00:00:00.000,2025-04-10 16:35:25.444
false,true,388,363,25,0,00:00:00.000,2025-04-10 16:35:30.450
false,false,393,368,25,156,00:00:31.000,2025-04-10 16:36:00.472
false,false,394,369,25,189,00:00:33.000,2025-04-10 16:36:05.475
false,false,395,370,25,221,00:00:32.000,2025-04-10 16:36:10.481
false,false,396,371,25,252,00:00:31.000,2025-04-10 16:36:15.486
false,false,397,372,25,285,00:00:33.000,2025-04-10 16:36:20.487
false,true,388,363,25,0,00:00:00.000,2025-04-10 16:35:35.452
false,false,389,364,25,32,00:00:32.000,2025-04-10 16:35:40.457
false,false,390,365,25,62,00:00:30.000,2025-04-10 16:35:45.459
false,false,391,366,25,94,00:00:32.000,2025-04-10 16:35:50.462
false,false,392,367,25,125,00:00:31.000,2025-04-10 16:35:55.467
false,true,398,373,25,0,00:00:00.000,2025-04-10 16:36:50.508
false,true,398,373,25,0,00:00:00.000,2025-04-10 16:36:55.512
false,false,399,374,25,33,00:00:33.000,2025-04-10 16:37:00.518
false,false,400,375,25,66,00:00:33.000,2025-04-10 16:37:05.521
false,false,401,376,25,98,00:00:32.000,2025-04-10 16:37:10.525
false,false,398,373,25,318,00:00:33.000,2025-04-10 16:36:25.492
false,true,398,373,25,0,00:00:00.000,2025-04-10 16:36:30.499
false,true,398,373,25,0,00:00:00.000,2025-04-10 16:36:35.501
false,true,398,373,25,0,00:00:00.000,2025-04-10 16:36:40.502
false,true,398,373,25,0,00:00:00.000,2025-04-10 16:36:45.505
false,false,407,380,27,284,00:00:31.000,2025-04-10 16:37:40.548
false,false,408,381,27,315,00:00:31.000,2025-04-10 16:37:45.550
false,false,409,382,27,348,00:00:33.000,2025-04-10 16:37:50.552
false,false,410,383,27,379,00:00:31.000,2025-04-10 16:37:55.558
false,false,411,384,27,409,00:00:30.000,2025-04-10 16:38:00.563
false,false,402,377,25,129,00:00:31.000,2025-04-10 16:37:15.527
false,false,403,378,25,162,00:00:33.000,2025-04-10 16:37:20.529
false,false,404,379,25,193,00:00:31.000,2025-04-10 16:37:25.535
false,false,405,380,25,223,00:00:30.000,2025-04-10 16:37:30.538
false,false,406,380,26,253,00:00:30.000,2025-04-10 16:37:35.542
false,false,412,385,27,439,00:00:30.000,2025-04-10 16:38:05.563
false,false,413,386,27,470,00:00:31.000,2025-04-10 16:38:10.566
false,false,414,387,27,502,00:00:32.000,2025-04-10 16:38:15.566
false,false,415,388,27,534,00:00:32.000,2025-04-10 16:38:20.571
false,false,416,389,27,567,00:00:33.000,2025-04-10 16:38:25.576
false,false,417,390,27,600,00:00:33.000,2025-04-10 16:38:30.581
false,false,418,391,27,630,00:00:30.000,2025-04-10 16:38:35.581
false,false,419,392,27,663,00:00:33.000,2025-04-10 16:38:40.584
false,false,420,393,27,693,00:00:30.000,2025-04-10 16:38:45.590
false,false,421,394,27,723,00:00:30.000,2025-04-10 16:38:50.593
false,false,422,395,27,756,00:00:33.000,2025-04-10 16:38:55.596
false,false,423,396,27,788,00:00:32.000,2025-04-10 16:39:00.600
false,false,424,397,27,818,00:00:30.000,2025-04-10 16:39:05.601
false,false,425,397,28,848,00:00:30.000,2025-04-10 16:39:10.606
false,false,426,398,28,880,00:00:32.000,2025-04-10 16:39:15.606
false,false,432,404,28,1069,00:00:31.000,2025-04-10 16:39:45.629
false,false,433,405,28,1100,00:00:31.000,2025-04-10 16:39:50.633
false,false,434,406,28,1132,00:00:32.000,2025-04-10 16:39:55.634
false,false,435,407,28,1162,00:00:30.000,2025-04-10 16:40:00.640
false,false,436,408,28,1192,00:00:30.000,2025-04-10 16:40:05.641
false,false,437,409,28,1223,00:00:31.000,2025-04-10 16:40:10.647
false,false,438,410,28,1254,00:00:31.000,2025-04-10 16:40:15.647
false,false,439,411,28,1285,00:00:31.000,2025-04-10 16:40:20.652
false,false,440,412,28,1316,00:00:31.000,2025-04-10 16:40:25.657
false,false,441,413,28,1349,00:00:33.000,2025-04-10 16:40:30.660
false,false,442,414,28,1380,00:00:31.000,2025-04-10 16:40:35.660
false,false,443,415,28,1413,00:00:33.000,2025-04-10 16:40:40.665
false,false,444,416,28,1444,00:00:31.000,2025-04-10 16:40:45.670
false,false,445,417,28,1474,00:00:30.000,2025-04-10 16:40:50.672
false,false,446,418,28,1506,00:00:32.000,2025-04-10 16:40:55.677
false,false,427,399,28,912,00:00:32.000,2025-04-10 16:39:20.607
false,false,428,400,28,943,00:00:31.000,2025-04-10 16:39:25.612
false,false,429,401,28,974,00:00:31.000,2025-04-10 16:39:30.617
false,false,430,402,28,1007,00:00:33.000,2025-04-10 16:39:35.621
false,false,431,403,28,1038,00:00:31.000,2025-04-10 16:39:40.627
false,true,446,418,28,0,00:00:00.000,2025-04-10 16:41:25.706
false,false,447,419,28,31,00:00:31.000,2025-04-10 16:41:30.711
false,false,448,420,28,62,00:00:31.000,2025-04-10 16:41:35.716
false,false,449,421,28,94,00:00:32.000,2025-04-10 16:41:40.722
false,false,450,422,28,126,00:00:32.000,2025-04-10 16:41:45.727
false,true,446,418,28,0,00:00:00.000,2025-04-10 16:41:00.683
false,true,446,418,28,0,00:00:00.000,2025-04-10 16:41:05.687
false,true,446,418,28,0,00:00:00.000,2025-04-10 16:41:10.691
false,true,446,418,28,0,00:00:00.000,2025-04-10 16:41:15.697
false,true,446,418,28,0,00:00:00.000,2025-04-10 16:41:20.700
false,true,450,422,28,0,00:00:00.000,2025-04-10 16:41:50.732
false,true,450,422,28,0,00:00:00.000,2025-04-10 16:41:55.737
false,true,450,422,28,0,00:00:00.000,2025-04-10 16:42:00.741
false,true,450,422,28,0,00:00:00.000,2025-04-10 16:42:05.745
false,true,450,422,28,0,00:00:00.000,2025-04-10 16:42:10.750
false,true,450,422,28,0,00:00:00.000,2025-04-10 16:42:15.756
false,false,451,422,29,31,00:00:31.000,2025-04-10 16:42:20.759
false,false,452,423,29,61,00:00:30.000,2025-04-10 16:42:25.765
false,false,453,424,29,91,00:00:30.000,2025-04-10 16:42:30.770
false,false,454,425,29,123,00:00:32.000,2025-04-10 16:42:35.772
false,true,459,430,29,0,00:00:00.000,2025-04-10 16:43:05.793
false,true,459,430,29,0,00:00:00.000,2025-04-10 16:43:10.798
false,true,459,430,29,0,00:00:00.000,2025-04-10 16:43:15.803
false,true,459,430,29,0,00:00:00.000,2025-04-10 16:43:20.805
false,true,459,430,29,0,00:00:00.000,2025-04-10 16:43:25.809
false,false,455,426,29,154,00:00:31.000,2025-04-10 16:42:40.777
false,false,456,427,29,187,00:00:33.000,2025-04-10 16:42:45.779
false,false,457,428,29,217,00:00:30.000,2025-04-10 16:42:50.782
false,false,458,429,29,250,00:00:33.000,2025-04-10 16:42:55.783
false,false,459,430,29,282,00:00:32.000,2025-04-10 16:43:00.789
false,true,459,430,29,0,00:00:00.000,2025-04-10 16:43:30.812
false,false,460,431,29,31,00:00:31.000,2025-04-10 16:43:35.816
false,false,461,432,29,62,00:00:31.000,2025-04-10 16:43:40.821
false,false,462,433,29,93,00:00:31.000,2025-04-10 16:43:45.822
false,false,463,434,29,125,00:00:32.000,2025-04-10 16:43:50.827
false,false,464,435,29,156,00:00:31.000,2025-04-10 16:43:55.833
false,false,465,436,29,187,00:00:31.000,2025-04-10 16:44:00.835
false,false,466,437,29,218,00:00:31.000,2025-04-10 16:44:05.837
false,true,466,437,29,0,00:00:00.000,2025-04-10 16:44:10.839
false,true,466,437,29,0,00:00:00.000,2025-04-10 16:44:15.840
false,false,478,449,29,379,00:00:32.000,2025-04-10 16:45:35.899
false,false,479,450,29,412,00:00:33.000,2025-04-10 16:45:40.904
false,false,480,451,29,445,00:00:33.000,2025-04-10 16:45:45.908
false,false,481,452,29,476,00:00:31.000,2025-04-10 16:45:50.913
false,false,482,453,29,506,00:00:30.000,2025-04-10 16:45:55.916
false,false,468,439,29,64,00:00:32.000,2025-04-10 16:44:45.860
false,false,469,440,29,94,00:00:30.000,2025-04-10 16:44:50.861
false,false,470,441,29,127,00:00:33.000,2025-04-10 16:44:55.863
false,false,471,442,29,157,00:00:30.000,2025-04-10 16:45:00.869
false,false,472,443,29,190,00:00:33.000,2025-04-10 16:45:05.873
false,false,473,444,29,221,00:00:31.000,2025-04-10 16:45:10.879
false,false,474,445,29,253,00:00:32.000,2025-04-10 16:45:15.884
false,false,475,446,29,284,00:00:31.000,2025-04-10 16:45:20.890
false,false,476,447,29,316,00:00:32.000,2025-04-10 16:45:25.893
false,false,477,448,29,347,00:00:31.000,2025-04-10 16:45:30.897
false,false,483,454,29,538,00:00:32.000,2025-04-10 16:46:00.917
false,false,484,455,29,570,00:00:32.000,2025-04-10 16:46:05.918
false,false,485,456,29,601,00:00:31.000,2025-04-10 16:46:10.923
false,true,485,456,29,0,00:00:00.000,2025-04-10 16:46:15.927
false,true,485,456,29,0,00:00:00.000,2025-04-10 16:46:20.931
false,true,485,456,29,0,00:00:00.000,2025-04-10 16:46:25.933
false,true,485,456,29,0,00:00:00.000,2025-04-10 16:46:30.938
false,true,485,456,29,0,00:00:00.000,2025-04-10 16:46:35.942
false,true,485,456,29,0,00:00:00.000,2025-04-10 16:46:40.947
false,false,486,457,29,33,00:00:33.000,2025-04-10 16:46:45.948
false,true,466,437,29,0,00:00:00.000,2025-04-10 16:44:20.842
false,true,466,437,29,0,00:00:00.000,2025-04-10 16:44:25.847
false,true,466,437,29,0,00:00:00.000,2025-04-10 16:44:30.849
false,true,466,437,29,0,00:00:00.000,2025-04-10 16:44:35.853
false,false,467,438,29,32,00:00:32.000,2025-04-10 16:44:40.859
false,false,487,458,29,65,00:00:32.000,2025-04-10 16:46:50.954
false,false,488,459,29,96,00:00:31.000,2025-04-10 16:46:55.959
false,false,489,460,29,127,00:00:31.000,2025-04-10 16:47:00.960
false,false,490,461,29,159,00:00:32.000,2025-04-10 16:47:05.962
false,false,491,462,29,190,00:00:31.000,2025-04-10 16:47:10.964
false,false,492,463,29,223,00:00:33.000,2025-04-10 16:47:15.969
false,false,493,464,29,253,00:00:30.000,2025-04-10 16:47:20.974
false,false,494,465,29,284,00:00:31.000,2025-04-10 16:47:25.975
false,false,495,466,29,315,00:00:31.000,2025-04-10 16:47:30.981
false,false,496,467,29,347,00:00:32.000,2025-04-10 16:47:35.986
false,false,497,468,29,379,00:00:32.000,2025-04-10 16:47:40.991
false,false,498,469,29,409,00:00:30.000,2025-04-10 16:47:45.996
false,false,499,470,29,441,00:00:32.000,2025-04-10 16:47:50.998
false,false,500,471,29,472,00:00:31.000,2025-04-10 16:47:56.003
false,false,501,472,29,503,00:00:31.000,2025-04-10 16:48:01.007
false,false,507,478,29,688,00:00:30.000,2025-04-10 16:48:31.033
false,false,508,479,29,721,00:00:33.000,2025-04-10 16:48:36.033
false,false,509,480,29,754,00:00:33.000,2025-04-10 16:48:41.035
false,false,510,481,29,786,00:00:32.000,2025-04-10 16:48:46.039
false,false,511,482,29,819,00:00:33.000,2025-04-10 16:48:51.041
false,false,502,473,29,533,00:00:30.000,2025-04-10 16:48:06.009
false,false,503,474,29,566,00:00:33.000,2025-04-10 16:48:11.014
false,false,504,475,29,598,00:00:32.000,2025-04-10 16:48:16.017
false,false,505,476,29,628,00:00:30.000,2025-04-10 16:48:21.022
false,false,506,477,29,658,00:00:30.000,2025-04-10 16:48:26.027
false,false,512,483,29,851,00:00:32.000,2025-04-10 16:48:56.046
false,false,513,484,29,884,00:00:33.000,2025-04-10 16:49:01.051
false,false,514,485,29,915,00:00:31.000,2025-04-10 16:49:06.055
false,false,515,486,29,945,00:00:30.000,2025-04-10 16:49:11.059
false,false,516,487,29,977,00:00:32.000,2025-04-10 16:49:16.064
false,false,517,488,29,1007,00:00:30.000,2025-04-10 16:49:21.069
false,false,518,489,29,1038,00:00:31.000,2025-04-10 16:49:26.074
false,false,519,489,30,1069,00:00:31.000,2025-04-10 16:49:31.079
false,false,520,489,31,1100,00:00:31.000,2025-04-10 16:49:36.085
false,false,521,490,31,1132,00:00:32.000,2025-04-10 16:49:41.090
false,false,522,491,31,1165,00:00:33.000,2025-04-10 16:49:46.096
false,false,523,492,31,1198,00:00:33.000,2025-04-10 16:49:51.096
false,false,524,493,31,1228,00:00:30.000,2025-04-10 16:49:56.102
false,false,525,494,31,1260,00:00:32.000,2025-04-10 16:50:01.103
false,false,526,495,31,1293,00:00:33.000,2025-04-10 16:50:06.108
false,false,532,501,31,1488,00:00:33.000,2025-04-10 16:50:36.127
false,false,533,502,31,1519,00:00:31.000,2025-04-10 16:50:41.131
false,false,534,503,31,1550,00:00:31.000,2025-04-10 16:50:46.133
false,false,535,504,31,1583,00:00:33.000,2025-04-10 16:50:51.134
false,false,536,505,31,1614,00:00:31.000,2025-04-10 16:50:56.139
false,false,527,496,31,1326,00:00:33.000,2025-04-10 16:50:11.109
false,false,528,497,31,1358,00:00:32.000,2025-04-10 16:50:16.109
false,false,529,498,31,1390,00:00:32.000,2025-04-10 16:50:21.114
false,false,530,499,31,1423,00:00:33.000,2025-04-10 16:50:26.120
false,false,531,500,31,1455,00:00:32.000,2025-04-10 16:50:31.123
false,false,542,511,31,1803,00:00:31.000,2025-04-10 16:51:26.153
false,false,543,512,31,1836,00:00:33.000,2025-04-10 16:51:31.158
false,false,544,512,32,1867,00:00:31.000,2025-04-10 16:51:36.160
false,false,545,513,32,1899,00:00:32.000,2025-04-10 16:51:41.161
false,false,546,514,32,1930,00:00:31.000,2025-04-10 16:51:46.166
false,false,547,515,32,1963,00:00:33.000,2025-04-10 16:51:51.170
false,false,548,516,32,1994,00:00:31.000,2025-04-10 16:51:56.174
false,false,549,517,32,2025,00:00:31.000,2025-04-10 16:52:01.179
false,false,550,518,32,2055,00:00:30.000,2025-04-10 16:52:06.184
false,false,551,519,32,2088,00:00:33.000,2025-04-10 16:52:11.189
false,true,551,519,32,0,00:00:00.000,2025-04-10 16:52:16.194
false,true,551,519,32,0,00:00:00.000,2025-04-10 16:52:21.199
false,true,551,519,32,0,00:00:00.000,2025-04-10 16:52:26.204
false,true,551,519,32,0,00:00:00.000,2025-04-10 16:52:31.209
false,true,551,519,32,0,00:00:00.000,2025-04-10 16:52:36.210
false,true,551,519,32,0,00:00:00.000,2025-04-10 16:52:41.216
false,false,552,520,32,32,00:00:32.000,2025-04-10 16:52:46.217
false,false,553,521,32,64,00:00:32.000,2025-04-10 16:52:51.222
false,false,554,522,32,95,00:00:31.000,2025-04-10 16:52:56.227
false,false,555,523,32,127,00:00:32.000,2025-04-10 16:53:01.231
false,false,537,506,31,1644,00:00:30.000,2025-04-10 16:51:01.141
false,false,538,507,31,1675,00:00:31.000,2025-04-10 16:51:06.145
false,false,539,508,31,1707,00:00:32.000,2025-04-10 16:51:11.145
false,false,540,509,31,1740,00:00:33.000,2025-04-10 16:51:16.148
false,false,541,510,31,1772,00:00:32.000,2025-04-10 16:51:21.148
false,false,556,524,32,157,00:00:30.000,2025-04-10 16:53:06.233
false,false,557,525,32,187,00:00:30.000,2025-04-10 16:53:11.235
false,true,557,525,32,0,00:00:00.000,2025-04-10 16:53:16.240
false,true,557,525,32,0,00:00:00.000,2025-04-10 16:53:21.246
false,true,557,525,32,0,00:00:00.000,2025-04-10 16:53:26.251
false,true,557,525,32,0,00:00:00.000,2025-04-10 16:53:31.255
false,true,557,525,32,0,00:00:00.000,2025-04-10 16:53:36.261
false,true,557,525,32,0,00:00:00.000,2025-04-10 16:53:41.266
false,false,558,526,32,30,00:00:30.000,2025-04-10 16:53:46.266
false,false,559,527,32,62,00:00:32.000,2025-04-10 16:53:51.269
false,false,570,536,34,405,00:00:32.000,2025-04-10 16:54:46.301
false,false,571,537,34,437,00:00:32.000,2025-04-10 16:54:51.307
false,false,572,538,34,467,00:00:30.000,2025-04-10 16:54:56.312
false,false,573,539,34,500,00:00:33.000,2025-04-10 16:55:01.317
false,false,574,540,34,532,00:00:32.000,2025-04-10 16:55:06.319
false,false,565,533,32,248,00:00:31.000,2025-04-10 16:54:21.288
false,false,566,534,32,278,00:00:30.000,2025-04-10 16:54:26.293
false,false,567,534,33,308,00:00:30.000,2025-04-10 16:54:31.293
false,false,568,534,34,340,00:00:32.000,2025-04-10 16:54:36.298
false,false,569,535,34,373,00:00:33.000,2025-04-10 16:54:41.301
false,false,560,528,32,92,00:00:30.000,2025-04-10 16:53:56.274
false,false,561,529,32,122,00:00:30.000,2025-04-10 16:54:01.276
false,false,562,530,32,153,00:00:31.000,2025-04-10 16:54:06.278
false,false,563,531,32,184,00:00:31.000,2025-04-10 16:54:11.283
false,false,564,532,32,217,00:00:33.000,2025-04-10 16:54:16.283
false,false,575,541,34,563,00:00:31.000,2025-04-10 16:55:11.319
false,false,576,542,34,594,00:00:31.000,2025-04-10 16:55:16.321
false,false,577,542,35,625,00:00:31.000,2025-04-10 16:55:21.323
false,false,578,543,35,657,00:00:32.000,2025-04-10 16:55:26.325
false,false,579,544,35,688,00:00:31.000,2025-04-10 16:55:31.326
false,false,585,550,35,874,00:00:30.000,2025-04-10 16:56:01.349
false,false,586,551,35,905,00:00:31.000,2025-04-10 16:56:06.353
false,false,587,552,35,936,00:00:31.000,2025-04-10 16:56:11.355
false,false,588,553,35,967,00:00:31.000,2025-04-10 16:56:16.355
false,false,589,554,35,999,00:00:32.000,2025-04-10 16:56:21.359
false,false,580,545,35,719,00:00:31.000,2025-04-10 16:55:36.332
false,false,581,546,35,749,00:00:30.000,2025-04-10 16:55:41.338
false,false,582,547,35,781,00:00:32.000,2025-04-10 16:55:46.338
false,false,583,548,35,814,00:00:33.000,2025-04-10 16:55:51.343
false,false,584,549,35,844,00:00:30.000,2025-04-10 16:55:56.344
false,false,590,555,35,1030,00:00:31.000,2025-04-10 16:56:26.362
false,false,591,556,35,1060,00:00:30.000,2025-04-10 16:56:31.368
false,false,592,557,35,1092,00:00:32.000,2025-04-10 16:56:36.373
false,false,593,558,35,1125,00:00:33.000,2025-04-10 16:56:41.378
false,false,594,559,35,1155,00:00:30.000,2025-04-10 16:56:46.379
false,false,595,559,36,1186,00:00:31.000,2025-04-10 16:56:51.383
false,false,596,560,36,1216,00:00:30.000,2025-04-10 16:56:56.387
false,false,597,561,36,1246,00:00:30.000,2025-04-10 16:57:01.389
false,false,598,562,36,1278,00:00:32.000,2025-04-10 16:57:06.394
false,true,598,562,36,0,00:00:00.000,2025-04-10 16:57:11.395
false,true,598,562,36,0,00:00:00.000,2025-04-10 16:57:16.396
false,true,598,562,36,0,00:00:00.000,2025-04-10 16:57:21.401
false,true,598,562,36,0,00:00:00.000,2025-04-10 16:57:26.406
false,true,598,562,36,0,00:00:00.000,2025-04-10 16:57:31.410
false,true,598,562,36,0,00:00:00.000,2025-04-10 16:57:36.416
false,false,599,563,36,32,00:00:32.000,2025-04-10 16:57:41.417
false,false,600,563,37,64,00:00:32.000,2025-04-10 16:57:46.417
false,false,601,564,37,96,00:00:32.000,2025-04-10 16:57:51.418
false,false,602,565,37,126,00:00:30.000,2025-04-10 16:57:56.424
false,false,603,566,37,158,00:00:32.000,2025-04-10 16:58:01.427
false,false,609,572,37,345,00:00:32.000,2025-04-10 16:58:31.449
false,false,610,573,37,376,00:00:31.000,2025-04-10 16:58:36.454
false,false,611,574,37,407,00:00:31.000,2025-04-10 16:58:41.458
false,false,612,575,37,439,00:00:32.000,2025-04-10 16:58:46.458
false,false,613,575,38,472,00:00:33.000,2025-04-10 16:58:51.463
false,false,614,576,38,505,00:00:33.000,2025-04-10 16:58:56.468
false,false,615,577,38,536,00:00:31.000,2025-04-10 16:59:01.473
false,true,615,577,38,0,00:00:00.000,2025-04-10 16:59:06.476
false,true,615,577,38,0,00:00:00.000,2025-04-10 16:59:11.476
false,true,615,577,38,0,00:00:00.000,2025-04-10 16:59:16.475
false,false,604,567,37,188,00:00:30.000,2025-04-10 16:58:06.432
false,false,605,568,37,220,00:00:32.000,2025-04-10 16:58:11.438
false,false,606,569,37,250,00:00:30.000,2025-04-10 16:58:16.438
false,false,607,570,37,281,00:00:31.000,2025-04-10 16:58:21.444
false,false,608,571,37,313,00:00:32.000,2025-04-10 16:58:26.447
false,true,600,569,31,0,00:00:00.000,2025-04-05 03:30:54.364
false,false,603,572,31,94,00:00:31.000,2025-04-05 03:32:24.402
false,false,601,570,31,31,00:00:31.000,2025-04-05 03:31:24.378
false,false,602,571,31,63,00:00:32.000,2025-04-05 03:31:54.391
false,true,600,569,31,0,00:00:00.000,2025-04-05 03:29:54.350
false,true,600,569,31,0,00:00:00.000,2025-04-05 03:30:24.362
false,true,606,575,31,0,00:00:00.000,2025-04-05 03:34:54.462
false,false,605,574,31,157,00:00:33.000,2025-04-05 03:33:24.429
false,false,604,573,31,124,00:00:30.000,2025-04-05 03:32:54.415
false,true,606,575,31,0,00:00:00.000,2025-04-05 03:34:24.453
false,false,606,575,31,187,00:00:30.000,2025-04-05 03:33:54.443
false,true,606,575,31,0,00:00:00.000,2025-04-05 03:36:54.506
false,true,606,575,31,0,00:00:00.000,2025-04-05 03:35:54.488
false,true,606,575,31,0,00:00:00.000,2025-04-05 03:35:24.475
false,true,606,575,31,0,00:00:00.000,2025-04-05 03:36:24.500
false,false,608,577,31,60,00:00:30.000,2025-04-05 03:37:54.526
false,false,612,581,31,187,00:00:32.000,2025-04-05 03:39:54.574
false,false,607,576,31,30,00:00:30.000,2025-04-05 03:37:24.517
false,false,611,580,31,155,00:00:33.000,2025-04-05 03:39:24.561
false,false,609,578,31,90,00:00:30.000,2025-04-05 03:38:24.539
false,true,612,581,31,0,00:00:00.000,2025-04-05 03:40:24.583
false,false,610,579,31,122,00:00:32.000,2025-04-05 03:38:54.550
false,true,612,581,31,0,00:00:00.000,2025-04-05 03:40:54.594
false,true,612,581,31,0,00:00:00.000,2025-04-05 03:41:24.602
false,true,612,581,31,0,00:00:00.000,2025-04-05 03:42:24.624
false,true,612,581,31,0,00:00:00.000,2025-04-05 03:41:54.613
false,true,612,581,31,0,00:00:00.000,2025-04-05 03:42:54.637
false,false,613,582,31,33,00:00:33.000,2025-04-05 03:43:24.645
false,false,615,583,32,96,00:00:31.000,2025-04-05 03:44:24.665
false,false,614,582,32,65,00:00:32.000,2025-04-05 03:43:54.659
false,false,616,584,32,127,00:00:31.000,2025-04-05 03:44:54.679
false,false,617,585,32,158,00:00:31.000,2025-04-05 03:45:24.690
false,false,618,586,32,189,00:00:31.000,2025-04-05 03:45:54.705
false,false,620,588,32,253,00:00:31.000,2025-04-05 03:46:54.729
false,false,621,589,32,285,00:00:32.000,2025-04-05 03:47:24.735
false,false,619,587,32,222,00:00:33.000,2025-04-05 03:46:24.715
false,false,622,590,32,316,00:00:31.000,2025-04-05 03:47:54.747
false,false,623,591,32,349,00:00:33.000,2025-04-05 03:48:24.760
false,false,626,594,32,442,00:00:32.000,2025-04-05 03:49:54.793
false,false,625,593,32,410,00:00:31.000,2025-04-05 03:49:24.779
false,false,624,592,32,379,00:00:30.000,2025-04-05 03:48:54.770
false,false,627,594,33,473,00:00:31.000,2025-04-05 03:50:24.805
false,false,628,595,33,505,00:00:32.000,2025-04-05 03:50:54.816
false,false,629,596,33,535,00:00:30.000,2025-04-05 03:51:24.827
false,true,629,596,33,0,00:00:00.000,2025-04-05 03:52:24.853
false,true,629,596,33,0,00:00:00.000,2025-04-05 03:53:24.881
false,true,629,596,33,0,00:00:00.000,2025-04-05 03:51:54.839
false,true,629,596,33,0,00:00:00.000,2025-04-05 03:52:54.868
false,true,629,596,33,0,00:00:00.000,2025-04-05 03:54:24.907
false,true,629,596,33,0,00:00:00.000,2025-04-05 03:53:54.896
false,false,630,597,33,32,00:00:32.000,2025-04-05 03:54:54.910
false,false,631,598,33,63,00:00:31.000,2025-04-05 03:55:24.922
false,false,632,599,33,94,00:00:31.000,2025-04-05 03:55:54.935
false,false,633,600,33,127,00:00:33.000,2025-04-05 03:56:24.949
false,false,634,601,33,157,00:00:30.000,2025-04-05 03:56:54.954
false,false,636,603,33,218,00:00:30.000,2025-04-05 03:57:54.975
false,false,635,602,33,188,00:00:31.000,2025-04-05 03:57:24.964
false,false,639,606,33,312,00:00:30.000,2025-04-05 03:59:25.006
false,false,637,604,33,250,00:00:32.000,2025-04-05 03:58:24.986
false,false,638,605,33,282,00:00:32.000,2025-04-05 03:58:54.994
false,false,641,608,33,373,00:00:30.000,2025-04-05 04:00:25.027
false,false,642,609,33,403,00:00:30.000,2025-04-05 04:00:55.036
false,false,643,610,33,434,00:00:31.000,2025-04-05 04:01:25.042
false,false,640,607,33,343,00:00:31.000,2025-04-05 03:59:55.014
false,false,645,612,33,495,00:00:31.000,2025-04-05 04:02:25.065
false,false,644,611,33,464,00:00:30.000,2025-04-05 04:01:55.051
false,false,646,613,33,526,00:00:31.000,2025-04-05 04:02:55.072
false,false,648,615,33,588,00:00:30.000,2025-04-05 04:03:55.097
false,false,647,614,33,558,00:00:32.000,2025-04-05 04:03:25.086
false,false,649,616,33,618,00:00:30.000,2025-04-05 04:04:25.106
false,false,651,618,33,680,00:00:32.000,2025-04-05 04:05:25.127
false,true,651,618,33,0,00:00:00.000,2025-04-05 04:06:25.151
false,true,651,618,33,0,00:00:00.000,2025-04-05 04:05:55.139
false,false,650,617,33,648,00:00:30.000,2025-04-05 04:04:55.117
false,true,651,618,33,0,00:00:00.000,2025-04-05 04:07:25.176
false,true,651,618,33,0,00:00:00.000,2025-04-05 04:06:55.162
false,true,651,618,33,0,00:00:00.000,2025-04-05 04:07:55.189
false,true,651,618,33,0,00:00:00.000,2025-04-05 04:08:25.192
false,false,652,619,33,32,00:00:32.000,2025-04-05 04:08:55.194
false,false,653,620,33,62,00:00:30.000,2025-04-05 04:09:25.205
false,false,654,621,33,93,00:00:31.000,2025-04-05 04:09:55.216
false,false,655,622,33,126,00:00:33.000,2025-04-05 04:10:25.224
false,true,655,622,33,0,00:00:00.000,2025-04-05 04:10:55.232
false,true,655,622,33,0,00:00:00.000,2025-04-05 04:11:25.237
false,true,655,622,33,0,00:00:00.000,2025-04-05 04:11:55.249
false,true,655,622,33,0,00:00:00.000,2025-04-05 04:12:55.262
false,true,655,622,33,0,00:00:00.000,2025-04-05 04:12:25.249
false,true,655,622,33,0,00:00:00.000,2025-04-05 04:13:25.270
false,false,656,623,33,31,00:00:31.000,2025-04-05 04:13:55.285
false,false,660,627,33,159,00:00:32.000,2025-04-05 04:15:55.328
false,false,659,626,33,127,00:00:33.000,2025-04-05 04:15:25.318
false,false,661,628,33,190,00:00:31.000,2025-04-05 04:16:25.341
false,false,663,630,33,252,00:00:32.000,2025-04-05 04:17:25.363
false,false,657,624,33,61,00:00:30.000,2025-04-05 04:14:25.297
false,false,658,625,33,94,00:00:33.000,2025-04-05 04:14:55.309
false,false,662,629,33,220,00:00:30.000,2025-04-05 04:16:55.355
false,false,664,631,33,285,00:00:33.000,2025-04-05 04:17:55.374
false,false,665,632,33,317,00:00:32.000,2025-04-05 04:18:25.389
false,false,667,633,34,380,00:00:30.000,2025-04-05 04:19:25.412
false,false,666,632,34,350,00:00:33.000,2025-04-05 04:18:55.399
false,false,669,635,34,440,00:00:30.000,2025-04-05 04:20:25.437
false,false,668,634,34,410,00:00:30.000,2025-04-05 04:19:55.423
false,false,670,636,34,473,00:00:33.000,2025-04-05 04:20:55.445
false,false,672,638,34,534,00:00:30.000,2025-04-05 04:21:55.466
false,false,671,637,34,504,00:00:31.000,2025-04-05 04:21:25.458
false,false,673,639,34,566,00:00:32.000,2025-04-05 04:22:25.474
false,false,675,641,34,628,00:00:30.000,2025-04-05 04:23:25.482
false,false,676,642,34,659,00:00:31.000,2025-04-05 04:23:55.493
false,false,674,640,34,598,00:00:32.000,2025-04-05 04:22:55.476
false,false,679,645,34,750,00:00:30.000,2025-04-05 04:25:25.527
false,false,680,646,34,782,00:00:32.000,2025-04-05 04:25:55.536
false,false,678,644,34,720,00:00:30.000,2025-04-05 04:24:55.518
false,false,681,647,34,812,00:00:30.000,2025-04-05 04:26:25.546
false,false,682,648,34,845,00:00:33.000,2025-04-05 04:26:55.550
false,false,677,643,34,690,00:00:31.000,2025-04-05 04:24:25.507
false,false,683,649,34,878,00:00:33.000,2025-04-05 04:27:25.563
false,false,684,650,34,910,00:00:32.000,2025-04-05 04:27:55.575
false,false,687,652,35,1004,00:00:32.000,2025-04-05 04:29:25.595
false,false,686,651,35,972,00:00:32.000,2025-04-05 04:28:55.581
false,false,685,651,34,940,00:00:30.000,2025-04-05 04:28:25.580
false,false,1978,1869,109,342,00:00:30.000,2025-04-05 19:30:15.885
false,false,1982,1873,109,471,00:00:32.000,2025-04-05 19:32:15.936
false,false,1977,1868,109,312,00:00:32.000,2025-04-05 19:29:45.872
false,false,1980,1871,109,407,00:00:33.000,2025-04-05 19:31:15.914
false,false,1979,1870,109,374,00:00:32.000,2025-04-05 19:30:45.899
false,false,1981,1872,109,439,00:00:32.000,2025-04-05 19:31:45.925
false,false,1985,1875,110,564,00:00:30.000,2025-04-05 19:33:45.981
false,false,1986,1876,110,594,00:00:30.000,2025-04-05 19:34:15.993
false,false,1983,1874,109,504,00:00:33.000,2025-04-05 19:32:45.952
false,false,1984,1874,110,534,00:00:30.000,2025-04-05 19:33:15.967
false,false,1987,1876,111,627,00:00:33.000,2025-04-05 19:34:46.002
false,false,1988,1877,111,658,00:00:31.000,2025-04-05 19:35:16.015
false,false,1990,1879,111,723,00:00:32.000,2025-04-05 19:36:16.044
false,false,1992,1881,111,785,00:00:32.000,2025-04-05 19:37:16.067
false,false,1993,1882,111,817,00:00:32.000,2025-04-05 19:37:46.069
false,false,1991,1880,111,753,00:00:30.000,2025-04-05 19:36:46.053
false,false,1994,1883,111,848,00:00:31.000,2025-04-05 19:38:16.079
false,false,1995,1884,111,880,00:00:32.000,2025-04-05 19:38:46.093
false,false,1996,1885,111,910,00:00:30.000,2025-04-05 19:39:16.107
false,false,1997,1886,111,941,00:00:31.000,2025-04-05 19:39:46.118
false,false,1999,1888,111,1002,00:00:31.000,2025-04-05 19:40:46.142
false,false,1989,1878,111,691,00:00:33.000,2025-04-05 19:35:46.030
false,false,2000,1889,111,1032,00:00:30.000,2025-04-05 19:41:16.149
false,false,1998,1887,111,971,00:00:30.000,2025-04-05 19:40:16.133
false,false,2001,1890,111,1065,00:00:33.000,2025-04-05 19:41:46.161
false,false,2003,1892,111,1127,00:00:32.000,2025-04-05 19:42:46.184
false,false,2002,1891,111,1095,00:00:30.000,2025-04-05 19:42:16.171
false,false,2005,1894,111,1190,00:00:30.000,2025-04-05 19:43:46.208
false,false,2004,1893,111,1160,00:00:33.000,2025-04-05 19:43:16.197
false,false,2006,1895,111,1222,00:00:32.000,2025-04-05 19:44:16.219
false,false,2007,1896,111,1255,00:00:33.000,2025-04-05 19:44:46.225
false,false,2009,1898,111,1319,00:00:33.000,2025-04-05 19:45:46.238
false,false,2008,1897,111,1286,00:00:31.000,2025-04-05 19:45:16.229
false,true,2010,1899,111,0,00:00:00.000,2025-04-05 19:47:16.280
false,true,2010,1899,111,0,00:00:00.000,2025-04-05 19:46:46.265
false,false,2010,1899,111,1351,00:00:32.000,2025-04-05 19:46:16.254
false,true,2010,1899,111,0,00:00:00.000,2025-04-05 19:48:16.299
false,true,2010,1899,111,0,00:00:00.000,2025-04-05 19:47:46.285
false,true,2010,1899,111,0,00:00:00.000,2025-04-05 19:48:46.309
false,true,2010,1899,111,0,00:00:00.000,2025-04-05 19:49:16.319
false,false,2011,1900,111,30,00:00:30.000,2025-04-05 19:49:46.330
false,false,2013,1902,111,95,00:00:32.000,2025-04-05 19:50:46.350
false,false,2014,1903,111,126,00:00:31.000,2025-04-05 19:51:16.358
false,false,2012,1901,111,63,00:00:33.000,2025-04-05 19:50:16.340
false,false,2015,1904,111,159,00:00:33.000,2025-04-05 19:51:46.373
false,false,2016,1905,111,191,00:00:32.000,2025-04-05 19:52:16.378
false,false,2018,1907,111,251,00:00:30.000,2025-04-05 19:53:16.396
false,false,2020,1909,111,312,00:00:31.000,2025-04-05 19:54:16.418
false,false,2021,1910,111,344,00:00:32.000,2025-04-05 19:54:46.430
false,false,2019,1908,111,281,00:00:30.000,2025-04-05 19:53:46.406
false,false,2017,1906,111,221,00:00:30.000,2025-04-05 19:52:46.386
false,false,2023,1911,112,407,00:00:31.000,2025-04-05 19:55:46.445
false,false,2022,1910,112,376,00:00:32.000,2025-04-05 19:55:16.434
false,false,2024,1912,112,439,00:00:32.000,2025-04-05 19:56:16.461
false,false,2026,1914,112,502,00:00:30.000,2025-04-05 19:57:16.490
false,false,2025,1913,112,472,00:00:33.000,2025-04-05 19:56:46.474
false,false,2028,1916,112,565,00:00:33.000,2025-04-05 19:58:16.514
false,false,2030,1918,112,628,00:00:33.000,2025-04-05 19:59:16.537
false,false,2029,1917,112,595,00:00:30.000,2025-04-05 19:58:46.525
false,false,2027,1915,112,532,00:00:30.000,2025-04-05 19:57:46.502
false,false,2031,1919,112,660,00:00:32.000,2025-04-05 19:59:46.549
false,false,2032,1920,112,691,00:00:31.000,2025-04-05 20:00:16.561
false,false,2033,1921,112,722,00:00:31.000,2025-04-05 20:00:46.566
false,false,2035,1923,112,784,00:00:32.000,2025-04-05 20:01:46.588
false,false,2034,1922,112,752,00:00:30.000,2025-04-05 20:01:16.578
false,false,2036,1924,112,815,00:00:31.000,2025-04-05 20:02:16.603
false,false,2037,1925,112,847,00:00:32.000,2025-04-05 20:02:46.617
false,false,2038,1926,112,878,00:00:31.000,2025-04-05 20:03:16.630
false,false,2041,1929,112,973,00:00:33.000,2025-04-05 20:04:46.671
false,false,2039,1927,112,908,00:00:30.000,2025-04-05 20:03:46.642
false,false,2040,1928,112,940,00:00:32.000,2025-04-05 20:04:16.657
false,false,2042,1929,113,1004,00:00:31.000,2025-04-05 20:05:16.680
false,false,2043,1930,113,1035,00:00:31.000,2025-04-05 20:05:46.693
false,false,2044,1930,114,1065,00:00:30.000,2025-04-05 20:06:16.703
false,false,2047,1933,114,1160,00:00:31.000,2025-04-05 20:07:46.727
false,false,2045,1931,114,1097,00:00:32.000,2025-04-05 20:06:46.717
false,false,2046,1932,114,1129,00:00:32.000,2025-04-05 20:07:16.718
false,false,2048,1934,114,1192,00:00:32.000,2025-04-05 20:08:16.736
false,false,2050,1935,115,1252,00:00:30.000,2025-04-05 20:09:16.752
false,false,2049,1935,114,1222,00:00:30.000,2025-04-05 20:08:46.749
false,false,2051,1936,115,1282,00:00:30.000,2025-04-05 20:09:46.767
false,false,2052,1937,115,1313,00:00:31.000,2025-04-05 20:10:16.781
false,false,2055,1940,115,1408,00:00:33.000,2025-04-05 20:11:46.819
false,false,2056,1941,115,1440,00:00:32.000,2025-04-05 20:12:16.833
false,false,2053,1938,115,1345,00:00:32.000,2025-04-05 20:10:46.789
false,false,2054,1939,115,1375,00:00:30.000,2025-04-05 20:11:16.804
false,false,2057,1941,116,1473,00:00:33.000,2025-04-05 20:12:46.847
false,false,2058,1942,116,1505,00:00:32.000,2025-04-05 20:13:16.857
false,false,2060,1944,116,1569,00:00:33.000,2025-04-05 20:14:16.883
false,false,2061,1945,116,1599,00:00:30.000,2025-04-05 20:14:46.891
false,false,2059,1943,116,1536,00:00:31.000,2025-04-05 20:13:46.872
false,false,2062,1946,116,1631,00:00:32.000,2025-04-05 20:15:16.906
false,false,2063,1947,116,1664,00:00:33.000,2025-04-05 20:15:46.917
false,false,2065,1949,116,1727,00:00:30.000,2025-04-05 20:16:46.945
false,false,2064,1948,116,1697,00:00:33.000,2025-04-05 20:16:16.930
false,true,2065,1949,116,0,00:00:00.000,2025-04-05 20:17:16.960
false,true,2065,1949,116,0,00:00:00.000,2025-04-05 20:18:46.984
false,true,2065,1949,116,0,00:00:00.000,2025-04-05 20:17:46.967
false,true,2065,1949,116,0,00:00:00.000,2025-04-05 20:18:16.979
false,true,2065,1949,116,0,00:00:00.000,2025-04-05 20:19:16.997
false,false,2066,1950,116,33,00:00:33.000,2025-04-05 20:20:17.022
false,false,2069,1952,117,129,00:00:31.000,2025-04-05 20:21:47.062
false,false,2068,1951,117,98,00:00:33.000,2025-04-05 20:21:17.050
false,false,2067,1950,117,65,00:00:32.000,2025-04-05 20:20:47.036
false,false,2071,1954,117,193,00:00:32.000,2025-04-05 20:22:47.087
false,false,2070,1953,117,161,00:00:32.000,2025-04-05 20:22:17.074
false,true,2065,1949,116,0,00:00:00.000,2025-04-05 20:19:47.009
false,false,2072,1955,117,225,00:00:32.000,2025-04-05 20:23:17.102
false,false,2073,1956,117,257,00:00:32.000,2025-04-05 20:23:47.112
false,false,2074,1957,117,287,00:00:30.000,2025-04-05 20:24:17.125
false,false,2075,1958,117,317,00:00:30.000,2025-04-05 20:24:47.140
false,false,2076,1959,117,348,00:00:31.000,2025-04-05 20:25:17.154
false,false,2077,1960,117,381,00:00:33.000,2025-04-05 20:25:47.165
false,false,2079,1962,117,445,00:00:32.000,2025-04-05 20:26:47.193
false,false,2078,1961,117,413,00:00:32.000,2025-04-05 20:26:17.178
false,false,2080,1963,117,475,00:00:30.000,2025-04-05 20:27:17.204
false,true,2082,1965,117,0,00:00:00.000,2025-04-05 20:29:17.253
false,false,2081,1964,117,505,00:00:30.000,2025-04-05 20:27:47.217
false,true,2082,1965,117,0,00:00:00.000,2025-04-05 20:28:47.241
false,true,2082,1965,117,0,00:00:00.000,2025-04-05 20:30:17.273
false,true,2082,1965,117,0,00:00:00.000,2025-04-05 20:29:47.262
false,false,2082,1965,117,537,00:00:32.000,2025-04-05 20:28:17.231
false,true,2082,1965,117,0,00:00:00.000,2025-04-05 20:31:17.295
false,false,2083,1966,117,30,00:00:30.000,2025-04-05 20:31:47.307
false,false,2085,1967,118,91,00:00:30.000,2025-04-05 20:32:47.334
false,true,2082,1965,117,0,00:00:00.000,2025-04-05 20:30:47.285
false,false,2084,1966,118,61,00:00:31.000,2025-04-05 20:32:17.322
false,false,2086,1968,118,122,00:00:31.000,2025-04-05 20:33:17.345
false,false,2087,1969,118,152,00:00:30.000,2025-04-05 20:33:47.358
false,false,1,1,0,31,00:00:31.000,2025-04-04 20:46:19.398
false,false,3,2,1,94,00:00:33.000,2025-04-04 20:47:19.405
false,false,4,3,1,126,00:00:32.000,2025-04-04 20:47:49.406
false,false,2,2,0,61,00:00:30.000,2025-04-04 20:46:49.402
false,false,5,4,1,158,00:00:32.000,2025-04-04 20:48:19.410
false,true,5,4,1,0,00:00:00.000,2025-04-04 20:48:49.411
false,true,5,4,1,0,00:00:00.000,2025-04-04 20:50:19.421
false,true,5,4,1,0,00:00:00.000,2025-04-04 20:49:19.415
false,true,5,4,1,0,00:00:00.000,2025-04-04 20:49:49.417
false,true,5,4,1,0,00:00:00.000,2025-04-04 20:50:49.423
false,false,6,5,1,30,00:00:30.000,2025-04-04 20:51:49.428
false,true,5,4,1,0,00:00:00.000,2025-04-04 20:51:19.427
false,false,9,8,1,127,00:00:33.000,2025-04-04 20:53:19.436
false,false,8,7,1,94,00:00:33.000,2025-04-04 20:52:49.435
false,false,7,6,1,61,00:00:31.000,2025-04-04 20:52:19.433
false,false,10,9,1,160,00:00:33.000,2025-04-04 20:53:49.440
false,false,11,10,1,193,00:00:33.000,2025-04-04 20:54:19.444
false,false,12,11,1,226,00:00:33.000,2025-04-04 20:54:49.448
false,false,15,14,1,319,00:00:33.000,2025-04-04 20:56:19.459
false,false,13,12,1,256,00:00:30.000,2025-04-04 20:55:19.450
false,false,14,13,1,286,00:00:30.000,2025-04-04 20:55:49.455
false,false,17,16,1,381,00:00:32.000,2025-04-04 20:57:19.464
false,true,18,17,1,0,00:00:00.000,2025-04-04 20:58:49.470
false,false,18,17,1,414,00:00:33.000,2025-04-04 20:57:49.468
false,false,16,15,1,349,00:00:30.000,2025-04-04 20:56:49.462
false,true,18,17,1,0,00:00:00.000,2025-04-04 20:58:19.469
false,true,18,17,1,0,00:00:00.000,2025-04-04 20:59:19.470
false,true,18,17,1,0,00:00:00.000,2025-04-04 20:59:49.474
false,true,18,17,1,0,00:00:00.000,2025-04-04 21:00:49.483
false,false,21,20,1,95,00:00:31.000,2025-04-04 21:02:19.493
false,false,20,19,1,64,00:00:33.000,2025-04-04 21:01:49.490
false,true,18,17,1,0,00:00:00.000,2025-04-04 21:00:19.478
false,false,19,18,1,31,00:00:31.000,2025-04-04 21:01:19.485
false,false,3713,3498,215,698,00:00:30.000,2025-04-06 15:31:13.880
false,false,3716,3501,215,794,00:00:31.000,2025-04-06 15:32:43.914
false,false,3711,3496,215,636,00:00:31.000,2025-04-06 15:30:13.863
false,false,3714,3499,215,730,00:00:32.000,2025-04-06 15:31:43.893
false,false,3715,3500,215,763,00:00:33.000,2025-04-06 15:32:13.907
false,false,3712,3497,215,668,00:00:32.000,2025-04-06 15:30:43.869
false,false,3719,3504,215,888,00:00:31.000,2025-04-06 15:34:13.945
false,false,3720,3505,215,920,00:00:32.000,2025-04-06 15:34:43.952
false,false,3721,3506,215,952,00:00:32.000,2025-04-06 15:35:13.965
false,false,3717,3502,215,825,00:00:31.000,2025-04-06 15:33:13.924
false,false,3722,3507,215,985,00:00:33.000,2025-04-06 15:35:43.977
false,false,3718,3503,215,857,00:00:32.000,2025-04-06 15:33:43.931
false,false,3723,3508,215,1018,00:00:33.000,2025-04-06 15:36:13.990
false,false,3726,3511,215,1111,00:00:33.000,2025-04-06 15:37:44.026
false,false,3727,3512,215,1142,00:00:31.000,2025-04-06 15:38:14.038
false,false,3725,3510,215,1078,00:00:30.000,2025-04-06 15:37:14.015
false,false,3724,3509,215,1048,00:00:30.000,2025-04-06 15:36:44.002
false,false,3728,3513,215,1175,00:00:33.000,2025-04-06 15:38:44.045
false,false,3729,3514,215,1206,00:00:31.000,2025-04-06 15:39:14.056
false,false,3730,3515,215,1237,00:00:31.000,2025-04-06 15:39:44.068
false,false,3731,3516,215,1270,00:00:33.000,2025-04-06 15:40:14.080
false,false,3732,3517,215,1301,00:00:31.000,2025-04-06 15:40:44.093
false,true,3732,3517,215,0,00:00:00.000,2025-04-06 15:41:44.115
false,true,3732,3517,215,0,00:00:00.000,2025-04-06 15:41:14.106
false,true,3732,3517,215,0,00:00:00.000,2025-04-06 15:42:14.126
false,true,3732,3517,215,0,00:00:00.000,2025-04-06 15:43:14.151
false,true,3732,3517,215,0,00:00:00.000,2025-04-06 15:43:44.162
false,true,3732,3517,215,0,00:00:00.000,2025-04-06 15:42:44.140
false,false,3734,3519,215,63,00:00:33.000,2025-04-06 15:44:44.187
false,false,3733,3518,215,30,00:00:30.000,2025-04-06 15:44:14.175
false,false,3735,3520,215,94,00:00:31.000,2025-04-06 15:45:14.195
false,false,3736,3521,215,125,00:00:31.000,2025-04-06 15:45:44.202
false,false,3737,3522,215,158,00:00:33.000,2025-04-06 15:46:14.214
false,false,3738,3523,215,190,00:00:32.000,2025-04-06 15:46:44.223
false,false,3739,3524,215,222,00:00:32.000,2025-04-06 15:47:14.236
false,false,3741,3526,215,285,00:00:33.000,2025-04-06 15:48:14.258
false,false,3740,3525,215,252,00:00:30.000,2025-04-06 15:47:44.246
false,false,3742,3527,215,318,00:00:33.000,2025-04-06 15:48:44.270
false,false,3744,3529,215,382,00:00:31.000,2025-04-06 15:49:44.296
false,false,3743,3528,215,351,00:00:33.000,2025-04-06 15:49:14.283
false,false,3746,3531,215,448,00:00:33.000,2025-04-06 15:50:44.318
false,true,3746,3531,215,0,00:00:00.000,2025-04-06 15:51:14.324
false,false,3745,3530,215,415,00:00:33.000,2025-04-06 15:50:14.304
false,true,3746,3531,215,0,00:00:00.000,2025-04-06 15:51:44.338
false,true,3746,3531,215,0,00:00:00.000,2025-04-06 15:52:44.358
false,true,3746,3531,215,0,00:00:00.000,2025-04-06 15:53:44.379
false,true,3746,3531,215,0,00:00:00.000,2025-04-06 15:53:14.368
false,false,3747,3532,215,31,00:00:31.000,2025-04-06 15:54:14.391
false,true,3746,3531,215,0,00:00:00.000,2025-04-06 15:52:14.350
false,false,3750,3535,215,129,00:00:33.000,2025-04-06 15:55:44.432
false,false,3748,3533,215,63,00:00:32.000,2025-04-06 15:54:44.404
false,false,3751,3536,215,162,00:00:33.000,2025-04-06 15:56:14.446
false,false,3749,3534,215,96,00:00:33.000,2025-04-06 15:55:14.418
false,false,3752,3537,215,195,00:00:33.000,2025-04-06 15:56:44.458
false,false,3753,3537,216,228,00:00:33.000,2025-04-06 15:57:14.468
false,false,3755,3539,216,294,00:00:33.000,2025-04-06 15:58:14.492
false,false,3754,3538,216,261,00:00:33.000,2025-04-06 15:57:44.479
false,false,3756,3540,216,326,00:00:32.000,2025-04-06 15:58:44.504
false,false,3758,3542,216,388,00:00:32.000,2025-04-06 15:59:44.526
false,false,3757,3541,216,356,00:00:30.000,2025-04-06 15:59:14.513
false,false,3759,3543,216,421,00:00:33.000,2025-04-06 16:00:14.538
false,false,3762,3546,216,517,00:00:30.000,2025-04-06 16:01:44.576
false,false,3764,3548,216,581,00:00:33.000,2025-04-06 16:02:44.602
false,false,3761,3545,216,487,00:00:33.000,2025-04-06 16:01:14.564
false,false,3763,3547,216,548,00:00:31.000,2025-04-06 16:02:14.588
false,false,3760,3544,216,454,00:00:33.000,2025-04-06 16:00:44.552
false,false,3767,3551,216,676,00:00:31.000,2025-04-06 16:04:14.635
false,false,3765,3549,216,613,00:00:32.000,2025-04-06 16:03:14.612
false,false,3766,3550,216,645,00:00:32.000,2025-04-06 16:03:44.622
false,true,3768,3552,216,0,00:00:00.000,2025-04-06 16:05:14.658
false,true,3768,3552,216,0,00:00:00.000,2025-04-06 16:05:44.669
false,false,3768,3552,216,707,00:00:31.000,2025-04-06 16:04:44.646
false,true,3768,3552,216,0,00:00:00.000,2025-04-06 16:06:14.678
false,true,3768,3552,216,0,00:00:00.000,2025-04-06 16:06:44.690
false,true,3768,3552,216,0,00:00:00.000,2025-04-06 16:07:14.701
false,true,3768,3552,216,0,00:00:00.000,2025-04-06 16:07:44.711
false,false,3769,3553,216,33,00:00:33.000,2025-04-06 16:08:14.723
false,false,3771,3555,216,96,00:00:30.000,2025-04-06 16:09:14.742
false,false,3770,3554,216,66,00:00:33.000,2025-04-06 16:08:44.736
false,false,3772,3556,216,126,00:00:30.000,2025-04-06 16:09:44.754
false,false,3774,3558,216,191,00:00:33.000,2025-04-06 16:10:44.774
false,false,3773,3557,216,158,00:00:32.000,2025-04-06 16:10:14.764
false,false,3775,3559,216,224,00:00:33.000,2025-04-06 16:11:14.781
false,false,3776,3560,216,254,00:00:30.000,2025-04-06 16:11:44.791
false,false,3777,3561,216,286,00:00:32.000,2025-04-06 16:12:14.799
false,false,3778,3562,216,316,00:00:30.000,2025-04-06 16:12:44.805
false,false,3780,3564,216,380,00:00:32.000,2025-04-06 16:13:44.829
false,false,3779,3563,216,348,00:00:32.000,2025-04-06 16:13:14.816
false,true,3780,3564,216,0,00:00:00.000,2025-04-06 16:14:44.850
false,true,3780,3564,216,0,00:00:00.000,2025-04-06 16:14:14.840
false,true,3780,3564,216,0,00:00:00.000,2025-04-06 16:15:14.862
false,true,3780,3564,216,0,00:00:00.000,2025-04-06 16:15:44.863
false,false,3781,3565,216,32,00:00:32.000,2025-04-06 16:17:14.886
false,true,3780,3564,216,0,00:00:00.000,2025-04-06 16:16:14.866
false,true,3781,3565,216,0,00:00:00.000,2025-04-06 16:18:44.914
false,true,3781,3565,216,0,00:00:00.000,2025-04-06 16:17:44.899
false,true,3781,3565,216,0,00:00:00.000,2025-04-06 16:18:14.910
false,true,3780,3564,216,0,00:00:00.000,2025-04-06 16:16:44.873
false,true,3781,3565,216,0,00:00:00.000,2025-04-06 16:19:44.939
false,true,3781,3565,216,0,00:00:00.000,2025-04-06 16:19:14.927
false,true,3781,3565,216,0,00:00:00.000,2025-04-06 16:20:14.952
false,false,3783,3566,217,64,00:00:33.000,2025-04-06 16:21:14.978
false,false,3782,3565,217,31,00:00:31.000,2025-04-06 16:20:44.966
false,false,3784,3567,217,94,00:00:30.000,2025-04-06 16:21:44.989
false,false,3786,3569,217,158,00:00:32.000,2025-04-06 16:22:45.012
false,false,3787,3570,217,188,00:00:30.000,2025-04-06 16:23:15.026
false,false,3785,3568,217,126,00:00:32.000,2025-04-06 16:22:15.001
false,false,3788,3571,217,220,00:00:32.000,2025-04-06 16:23:45.036
false,false,3789,3572,217,252,00:00:32.000,2025-04-06 16:24:15.045
false,false,3791,3574,217,316,00:00:31.000,2025-04-06 16:25:15.068
false,false,3790,3573,217,285,00:00:33.000,2025-04-06 16:24:45.056
false,false,3793,3576,217,379,00:00:30.000,2025-04-06 16:26:15.088
false,false,3792,3575,217,349,00:00:33.000,2025-04-06 16:25:45.079
false,false,3794,3577,217,412,00:00:33.000,2025-04-06 16:26:45.101
false,false,3796,3579,217,475,00:00:33.000,2025-04-06 16:27:45.121
false,false,3797,3580,217,508,00:00:33.000,2025-04-06 16:28:15.130
false,false,3795,3578,217,442,00:00:30.000,2025-04-06 16:27:15.111
false,false,3798,3581,217,538,00:00:30.000,2025-04-06 16:28:45.142
false,false,3799,3582,217,570,00:00:32.000,2025-04-06 16:29:15.155
false,false,3800,3583,217,600,00:00:30.000,2025-04-06 16:29:45.167
false,false,3804,3587,217,728,00:00:33.000,2025-04-06 16:31:45.215
false,false,3801,3584,217,630,00:00:30.000,2025-04-06 16:30:15.179
false,false,3805,3588,217,760,00:00:32.000,2025-04-06 16:32:15.228
false,false,3802,3585,217,662,00:00:32.000,2025-04-06 16:30:45.188
false,false,3806,3589,217,792,00:00:32.000,2025-04-06 16:32:45.239
false,false,3807,3590,217,823,00:00:31.000,2025-04-06 16:33:15.250
false,false,3808,3591,217,855,00:00:32.000,2025-04-06 16:33:45.262
false,false,3809,3592,217,885,00:00:30.000,2025-04-06 16:34:15.275
false,false,3810,3593,217,915,00:00:30.000,2025-04-06 16:34:45.284
false,false,3803,3586,217,695,00:00:33.000,2025-04-06 16:31:15.202
false,true,3810,3593,217,0,00:00:00.000,2025-04-06 16:35:15.294
false,true,3810,3593,217,0,00:00:00.000,2025-04-06 16:35:45.306
false,true,3810,3593,217,0,00:00:00.000,2025-04-06 16:37:15.336
false,true,3810,3593,217,0,00:00:00.000,2025-04-06 16:36:45.328
false,true,3810,3593,217,0,00:00:00.000,2025-04-06 16:36:15.319
false,false,1704,1607,97,602,00:00:33.000,2025-04-05 16:19:11.541
false,false,1701,1604,97,506,00:00:31.000,2025-04-05 16:17:41.505
false,false,1706,1609,97,663,00:00:30.000,2025-04-05 16:20:11.566
false,false,1703,1606,97,569,00:00:32.000,2025-04-05 16:18:41.529
false,false,1702,1605,97,537,00:00:31.000,2025-04-05 16:18:11.520
false,false,1705,1608,97,633,00:00:31.000,2025-04-05 16:19:41.554
false,false,1708,1611,97,727,00:00:31.000,2025-04-05 16:21:11.588
false,false,1707,1610,97,696,00:00:33.000,2025-04-05 16:20:41.576
false,false,1709,1612,97,760,00:00:33.000,2025-04-05 16:21:41.597
false,false,1710,1613,97,790,00:00:30.000,2025-04-05 16:22:11.608
false,false,1711,1614,97,823,00:00:33.000,2025-04-05 16:22:41.621
false,false,1712,1615,97,854,00:00:31.000,2025-04-05 16:23:11.636
false,false,1714,1617,97,918,00:00:31.000,2025-04-05 16:24:11.650
false,false,1715,1618,97,951,00:00:33.000,2025-04-05 16:24:41.665
false,false,1713,1616,97,887,00:00:33.000,2025-04-05 16:23:41.649
false,false,1716,1619,97,983,00:00:32.000,2025-04-05 16:25:11.680
false,false,1717,1620,97,1016,00:00:33.000,2025-04-05 16:25:41.695
false,false,1718,1621,97,1049,00:00:33.000,2025-04-05 16:26:11.709
false,false,1719,1621,98,1081,00:00:32.000,2025-04-05 16:26:41.714
false,true,1719,1621,98,0,00:00:00.000,2025-04-05 16:27:41.741
false,true,1719,1621,98,0,00:00:00.000,2025-04-05 16:27:11.729
false,true,1719,1621,98,0,00:00:00.000,2025-04-05 16:28:11.753
false,true,1719,1621,98,0,00:00:00.000,2025-04-05 16:28:41.764
false,true,1719,1621,98,0,00:00:00.000,2025-04-05 16:29:41.786
false,true,1719,1621,98,0,00:00:00.000,2025-04-05 16:29:11.775
false,false,1720,1622,98,31,00:00:31.000,2025-04-05 16:30:11.797
false,false,1721,1623,98,61,00:00:30.000,2025-04-05 16:30:41.808
false,false,1722,1624,98,91,00:00:30.000,2025-04-05 16:31:11.820
false,false,1724,1626,98,154,00:00:32.000,2025-04-05 16:32:11.846
false,false,1723,1625,98,122,00:00:31.000,2025-04-05 16:31:41.833
false,false,1726,1628,98,220,00:00:33.000,2025-04-05 16:33:11.869
false,false,1725,1627,98,187,00:00:33.000,2025-04-05 16:32:41.858
false,false,1728,1630,98,281,00:00:31.000,2025-04-05 16:34:11.894
false,false,1727,1629,98,250,00:00:30.000,2025-04-05 16:33:41.884
false,false,1729,1631,98,311,00:00:30.000,2025-04-05 16:34:41.909
false,false,1730,1632,98,341,00:00:30.000,2025-04-05 16:35:11.916
false,false,1731,1633,98,372,00:00:31.000,2025-04-05 16:35:41.924
false,false,1732,1634,98,402,00:00:30.000,2025-04-05 16:36:11.936
false,false,1734,1636,98,465,00:00:33.000,2025-04-05 16:37:11.961
false,false,1733,1635,98,432,00:00:30.000,2025-04-05 16:36:41.950
false,false,1736,1637,99,527,00:00:31.000,2025-04-05 16:38:11.986
false,false,1735,1636,99,496,00:00:31.000,2025-04-05 16:37:41.975
false,false,1738,1639,99,591,00:00:33.000,2025-04-05 16:39:12.002
false,true,1738,1639,99,0,00:00:00.000,2025-04-05 16:39:42.012
false,false,1737,1638,99,558,00:00:31.000,2025-04-05 16:38:41.988
false,true,1738,1639,99,0,00:00:00.000,2025-04-05 16:40:12.023
false,true,1738,1639,99,0,00:00:00.000,2025-04-05 16:40:42.036
false,true,1738,1639,99,0,00:00:00.000,2025-04-05 16:41:12.051
false,true,1738,1639,99,0,00:00:00.000,2025-04-05 16:41:42.064
false,false,1739,1640,99,32,00:00:32.000,2025-04-05 16:42:42.085
false,true,1738,1639,99,0,00:00:00.000,2025-04-05 16:42:12.072
false,false,1740,1641,99,65,00:00:33.000,2025-04-05 16:43:12.097
false,false,1741,1642,99,96,00:00:31.000,2025-04-05 16:43:42.112
false,false,1743,1644,99,161,00:00:33.000,2025-04-05 16:44:42.137
false,false,1742,1643,99,128,00:00:32.000,2025-04-05 16:44:12.124
false,false,1745,1646,99,223,00:00:30.000,2025-04-05 16:45:42.157
false,false,1746,1647,99,255,00:00:32.000,2025-04-05 16:46:12.167
false,false,1747,1648,99,288,00:00:33.000,2025-04-05 16:46:42.180
false,false,1750,1651,99,385,00:00:31.000,2025-04-05 16:48:12.216
false,false,1752,1653,99,451,00:00:33.000,2025-04-05 16:49:12.242
false,false,1751,1652,99,418,00:00:33.000,2025-04-05 16:48:42.228
false,false,1748,1649,99,321,00:00:33.000,2025-04-05 16:47:12.192
false,false,1753,1654,99,482,00:00:31.000,2025-04-05 16:49:42.251
false,false,1744,1645,99,193,00:00:32.000,2025-04-05 16:45:12.143
false,false,1754,1655,99,512,00:00:30.000,2025-04-05 16:50:12.256
false,false,1755,1656,99,543,00:00:31.000,2025-04-05 16:50:42.262
false,false,1756,1657,99,574,00:00:31.000,2025-04-05 16:51:12.265
false,false,1758,1659,99,638,00:00:33.000,2025-04-05 16:52:12.292
false,false,1757,1658,99,605,00:00:31.000,2025-04-05 16:51:42.281
false,false,1749,1650,99,354,00:00:33.000,2025-04-05 16:47:42.206
false,false,1761,1662,99,732,00:00:33.000,2025-04-05 16:53:42.334
false,false,1760,1661,99,699,00:00:31.000,2025-04-05 16:53:12.321
false,false,1759,1660,99,668,00:00:30.000,2025-04-05 16:52:42.308
false,false,1762,1663,99,765,00:00:33.000,2025-04-05 16:54:12.335
false,false,1764,1665,99,830,00:00:32.000,2025-04-05 16:55:12.351
false,false,1763,1664,99,798,00:00:33.000,2025-04-05 16:54:42.347
false,false,1765,1666,99,860,00:00:30.000,2025-04-05 16:55:42.361
false,false,1767,1667,100,924,00:00:33.000,2025-04-05 16:56:42.380
false,false,1766,1666,100,891,00:00:31.000,2025-04-05 16:56:12.374
false,false,1770,1670,100,1017,00:00:31.000,2025-04-05 16:58:12.408
false,false,1769,1669,100,986,00:00:30.000,2025-04-05 16:57:42.398
false,true,1770,1670,100,0,00:00:00.000,2025-04-05 16:58:42.413
false,true,1770,1670,100,0,00:00:00.000,2025-04-05 16:59:12.428
false,false,1768,1668,100,956,00:00:32.000,2025-04-05 16:57:12.389
false,true,1770,1670,100,0,00:00:00.000,2025-04-05 17:00:12.457
false,true,1770,1670,100,0,00:00:00.000,2025-04-05 16:59:42.444
false,true,1770,1670,100,0,00:00:00.000,2025-04-05 17:00:42.469
false,false,1771,1671,100,33,00:00:33.000,2025-04-05 17:01:42.497
false,false,1772,1672,100,66,00:00:33.000,2025-04-05 17:02:12.507
false,true,1770,1670,100,0,00:00:00.000,2025-04-05 17:01:12.483
false,true,1772,1672,100,0,00:00:00.000,2025-04-05 17:02:42.519
false,true,1772,1672,100,0,00:00:00.000,2025-04-05 17:03:12.533
false,true,1772,1672,100,0,00:00:00.000,2025-04-05 17:03:42.544
false,true,1772,1672,100,0,00:00:00.000,2025-04-05 17:04:12.555
false,true,1772,1672,100,0,00:00:00.000,2025-04-05 17:04:42.570
false,true,1772,1672,100,0,00:00:00.000,2025-04-05 17:05:12.577
false,false,1773,1673,100,32,00:00:32.000,2025-04-05 17:05:42.589
false,true,1773,1673,100,0,00:00:00.000,2025-04-05 17:06:12.603
false,true,1773,1673,100,0,00:00:00.000,2025-04-05 17:06:42.615
false,true,1773,1673,100,0,00:00:00.000,2025-04-05 17:07:42.637
false,true,1773,1673,100,0,00:00:00.000,2025-04-05 17:07:12.625
false,true,1773,1673,100,0,00:00:00.000,2025-04-05 17:08:12.648
false,true,1773,1673,100,0,00:00:00.000,2025-04-05 17:08:42.659
false,false,1774,1674,100,33,00:00:33.000,2025-04-05 17:09:12.666
false,false,1776,1676,100,99,00:00:33.000,2025-04-05 17:10:12.685
false,false,1777,1677,100,129,00:00:30.000,2025-04-05 17:10:42.698
false,false,1775,1675,100,66,00:00:33.000,2025-04-05 17:09:42.680
false,false,1778,1678,100,161,00:00:32.000,2025-04-05 17:11:12.701
false,false,1781,1681,100,257,00:00:30.000,2025-04-05 17:12:42.736
false,false,1779,1679,100,194,00:00:33.000,2025-04-05 17:11:42.711
false,false,1780,1680,100,227,00:00:33.000,2025-04-05 17:12:12.726
false,false,1782,1682,100,288,00:00:31.000,2025-04-05 17:13:12.748
false,false,1783,1683,100,320,00:00:32.000,2025-04-05 17:13:42.762
false,false,1786,1686,100,414,00:00:32.000,2025-04-05 17:15:12.801
false,false,1785,1685,100,382,00:00:30.000,2025-04-05 17:14:42.788
false,false,1787,1687,100,446,00:00:32.000,2025-04-05 17:15:42.815
false,false,1788,1688,100,478,00:00:32.000,2025-04-05 17:16:12.829
false,false,1784,1684,100,352,00:00:32.000,2025-04-05 17:14:12.777
false,false,1789,1689,100,511,00:00:33.000,2025-04-05 17:16:42.844
false,true,1789,1689,100,0,00:00:00.000,2025-04-05 17:18:12.883
false,true,1789,1689,100,0,00:00:00.000,2025-04-05 17:17:42.871
false,true,1789,1689,100,0,00:00:00.000,2025-04-05 17:17:12.860
false,true,1789,1689,100,0,00:00:00.000,2025-04-05 17:19:12.902
false,true,1789,1689,100,0,00:00:00.000,2025-04-05 17:18:42.894
false,true,1789,1689,100,0,00:00:00.000,2025-04-05 17:19:42.916
false,false,1790,1690,100,33,00:00:33.000,2025-04-05 17:20:12.925
false,false,1791,1691,100,63,00:00:30.000,2025-04-05 17:20:42.939
false,false,1792,1692,100,96,00:00:33.000,2025-04-05 17:21:12.945
false,false,4173,3933,240,192,00:00:31.000,2025-04-06 20:51:20.559
false,false,4172,3933,239,161,00:00:31.000,2025-04-06 20:50:50.551
false,false,4175,3935,240,255,00:00:33.000,2025-04-06 20:52:20.581
false,false,4176,3936,240,288,00:00:33.000,2025-04-06 20:52:50.592
false,false,4174,3934,240,222,00:00:30.000,2025-04-06 20:51:50.571
false,false,4177,3937,240,321,00:00:33.000,2025-04-06 20:53:20.603
false,false,4180,3940,240,420,00:00:33.000,2025-04-06 20:54:50.633
false,true,4180,3940,240,0,00:00:00.000,2025-04-06 20:55:50.646
false,false,4178,3938,240,354,00:00:33.000,2025-04-06 20:53:50.614
false,false,4179,3939,240,387,00:00:33.000,2025-04-06 20:54:20.623
false,true,4180,3940,240,0,00:00:00.000,2025-04-06 20:55:20.642
false,true,4180,3940,240,0,00:00:00.000,2025-04-06 20:57:20.669
false,true,4180,3940,240,0,00:00:00.000,2025-04-06 20:56:20.654
false,true,4180,3940,240,0,00:00:00.000,2025-04-06 20:57:50.679
false,true,4180,3940,240,0,00:00:00.000,2025-04-06 20:56:50.660
false,false,4181,3941,240,30,00:00:30.000,2025-04-06 20:58:20.690
false,false,4183,3943,240,92,00:00:31.000,2025-04-06 20:59:20.711
false,false,4184,3944,240,125,00:00:33.000,2025-04-06 20:59:50.722
false,false,4182,3942,240,61,00:00:31.000,2025-04-06 20:58:50.701
false,false,4185,3944,241,156,00:00:31.000,2025-04-06 21:00:20.731
false,false,4186,3945,241,187,00:00:31.000,2025-04-06 21:00:50.740
false,false,4187,3946,241,218,00:00:31.000,2025-04-06 21:01:20.750
false,false,4188,3947,241,250,00:00:32.000,2025-04-06 21:01:50.759
false,false,4189,3948,241,281,00:00:31.000,2025-04-06 21:02:20.770
false,false,4190,3949,241,313,00:00:32.000,2025-04-06 21:02:50.778
false,false,4191,3950,241,343,00:00:30.000,2025-04-06 21:03:20.788
false,false,4192,3951,241,374,00:00:31.000,2025-04-06 21:03:50.795
false,false,4193,3952,241,407,00:00:33.000,2025-04-06 21:04:20.807
false,false,4197,3955,242,532,00:00:30.000,2025-04-06 21:06:20.842
false,false,4194,3953,241,437,00:00:30.000,2025-04-06 21:04:50.816
false,false,4198,3956,242,564,00:00:32.000,2025-04-06 21:06:50.854
false,false,4195,3954,241,470,00:00:33.000,2025-04-06 21:05:20.827
false,false,4200,3958,242,628,00:00:32.000,2025-04-06 21:07:50.862
false,false,4196,3955,241,502,00:00:32.000,2025-04-06 21:05:50.837
false,false,4202,3960,242,692,00:00:31.000,2025-04-06 21:08:50.868
false,false,4199,3957,242,596,00:00:32.000,2025-04-06 21:07:20.854
false,false,4201,3959,242,661,00:00:33.000,2025-04-06 21:08:20.866
false,false,4203,3961,242,723,00:00:31.000,2025-04-06 21:09:20.878
false,false,4205,3963,242,784,00:00:31.000,2025-04-06 21:10:20.897
false,false,4204,3962,242,753,00:00:30.000,2025-04-06 21:09:50.890
false,false,4207,3965,242,846,00:00:30.000,2025-04-06 21:11:20.919
false,false,4208,3965,243,879,00:00:33.000,2025-04-06 21:11:50.925
false,false,4206,3964,242,816,00:00:32.000,2025-04-06 21:10:50.907
false,false,4214,3971,243,1069,00:00:33.000,2025-04-06 21:14:50.979
false,false,4210,3967,243,942,00:00:31.000,2025-04-06 21:12:50.947
false,false,4213,3970,243,1036,00:00:31.000,2025-04-06 21:14:20.975
false,false,4209,3966,243,911,00:00:32.000,2025-04-06 21:12:20.936
false,false,4212,3969,243,1005,00:00:33.000,2025-04-06 21:13:50.968
false,false,4215,3972,243,1099,00:00:30.000,2025-04-06 21:15:20.990
false,false,4217,3974,243,1159,00:00:30.000,2025-04-06 21:16:21.010
false,false,4211,3968,243,972,00:00:30.000,2025-04-06 21:13:20.958
false,false,4218,3975,243,1189,00:00:30.000,2025-04-06 21:16:51.018
false,false,4219,3976,243,1222,00:00:33.000,2025-04-06 21:17:21.028
false,false,4216,3973,243,1129,00:00:30.000,2025-04-06 21:15:51.000
false,false,4224,3981,243,1378,00:00:31.000,2025-04-06 21:19:51.071
false,false,4221,3978,243,1283,00:00:30.000,2025-04-06 21:18:21.041
false,false,4225,3982,243,1410,00:00:32.000,2025-04-06 21:20:21.080
false,false,4222,3979,243,1316,00:00:33.000,2025-04-06 21:18:51.051
false,false,4220,3977,243,1253,00:00:31.000,2025-04-06 21:17:51.033
false,false,4223,3980,243,1347,00:00:31.000,2025-04-06 21:19:21.061
false,false,4226,3983,243,1443,00:00:33.000,2025-04-06 21:20:51.080
false,false,4228,3985,243,1506,00:00:30.000,2025-04-06 21:21:51.094
false,true,4228,3985,243,0,00:00:00.000,2025-04-06 21:22:51.110
false,true,4228,3985,243,0,00:00:00.000,2025-04-06 21:22:21.103
false,false,4227,3984,243,1476,00:00:33.000,2025-04-06 21:21:21.090
false,true,4228,3985,243,0,00:00:00.000,2025-04-06 21:23:21.119
false,true,4228,3985,243,0,00:00:00.000,2025-04-06 21:23:51.126
false,true,4228,3985,243,0,00:00:00.000,2025-04-06 21:24:21.132
false,true,4228,3985,243,0,00:00:00.000,2025-04-06 21:24:51.140
false,false,4231,3987,244,91,00:00:30.000,2025-04-06 21:26:21.167
false,false,4230,3987,243,61,00:00:31.000,2025-04-06 21:25:51.157
false,false,4229,3986,243,30,00:00:30.000,2025-04-06 21:25:21.150
false,true,4231,3987,244,0,00:00:00.000,2025-04-06 21:27:21.176
false,true,4231,3987,244,0,00:00:00.000,2025-04-06 21:27:51.181
false,true,4231,3987,244,0,00:00:00.000,2025-04-06 21:28:21.191
false,true,4231,3987,244,0,00:00:00.000,2025-04-06 21:29:21.204
false,true,4231,3987,244,0,00:00:00.000,2025-04-06 21:26:51.175
false,true,4231,3987,244,0,00:00:00.000,2025-04-06 21:28:51.195
false,false,4232,3988,244,32,00:00:32.000,2025-04-06 21:29:51.215
false,false,4233,3989,244,63,00:00:31.000,2025-04-06 21:30:21.225
false,false,4235,3991,244,126,00:00:32.000,2025-04-06 21:31:21.237
false,false,4234,3990,244,94,00:00:31.000,2025-04-06 21:30:51.230
false,false,4236,3992,244,159,00:00:33.000,2025-04-06 21:31:51.246
false,false,4237,3992,245,191,00:00:32.000,2025-04-06 21:32:21.256
false,false,4238,3993,245,224,00:00:33.000,2025-04-06 21:32:51.265
false,false,4239,3994,245,256,00:00:32.000,2025-04-06 21:33:21.270
false,false,4240,3995,245,288,00:00:32.000,2025-04-06 21:33:51.272
false,false,4241,3996,245,318,00:00:30.000,2025-04-06 21:34:21.281
false,false,4243,3998,245,384,00:00:33.000,2025-04-06 21:35:21.297
false,false,4242,3997,245,351,00:00:33.000,2025-04-06 21:34:51.290
false,false,4244,3999,245,416,00:00:32.000,2025-04-06 21:35:51.304
false,false,4245,4000,245,446,00:00:30.000,2025-04-06 21:36:21.313
false,false,4247,4002,245,510,00:00:32.000,2025-04-06 21:37:21.333
false,false,4246,4001,245,478,00:00:32.000,2025-04-06 21:36:51.323
false,false,4248,4003,245,540,00:00:30.000,2025-04-06 21:37:51.338
false,false,4250,4005,245,604,00:00:31.000,2025-04-06 21:38:51.357
false,false,4249,4004,245,573,00:00:33.000,2025-04-06 21:38:21.347
false,false,4251,4006,245,637,00:00:33.000,2025-04-06 21:39:21.366
false,false,4252,4007,245,669,00:00:32.000,2025-04-06 21:39:51.376
false,false,4253,4008,245,702,00:00:33.000,2025-04-06 21:40:21.383
false,false,4255,4010,245,763,00:00:31.000,2025-04-06 21:41:21.389
false,false,4256,4011,245,794,00:00:31.000,2025-04-06 21:41:51.397
false,false,4257,4012,245,826,00:00:32.000,2025-04-06 21:42:21.406
false,false,4254,4009,245,732,00:00:30.000,2025-04-06 21:40:51.387
false,false,4258,4013,245,859,00:00:33.000,2025-04-06 21:42:51.417
false,false,4259,4014,245,890,00:00:31.000,2025-04-06 21:43:21.426
false,false,4260,4015,245,920,00:00:30.000,2025-04-06 21:43:51.432
false,false,4261,4016,245,950,00:00:30.000,2025-04-06 21:44:21.441
false,true,4261,4016,245,0,00:00:00.000,2025-04-06 21:44:51.451
false,true,4261,4016,245,0,00:00:00.000,2025-04-06 21:45:21.453
false,true,4261,4016,245,0,00:00:00.000,2025-04-06 21:46:21.470
false,true,4261,4016,245,0,00:00:00.000,2025-04-06 21:45:51.462
false,true,4261,4016,245,0,00:00:00.000,2025-04-06 21:46:51.477
false,false,4263,4018,245,64,00:00:33.000,2025-04-06 21:48:21.504
false,false,4262,4017,245,31,00:00:31.000,2025-04-06 21:47:51.495
false,true,4261,4016,245,0,00:00:00.000,2025-04-06 21:47:21.486
false,false,4265,4020,245,129,00:00:32.000,2025-04-06 21:49:21.517
false,false,4266,4020,246,159,00:00:30.000,2025-04-06 21:49:51.525
false,false,4267,4020,247,189,00:00:30.000,2025-04-06 21:50:21.534
false,false,4264,4019,245,97,00:00:33.000,2025-04-06 21:48:51.513
false,false,4268,4021,247,221,00:00:32.000,2025-04-06 21:50:51.536
false,false,4270,4023,247,284,00:00:30.000,2025-04-06 21:51:51.551
false,false,4269,4022,247,254,00:00:33.000,2025-04-06 21:51:21.545
false,false,4271,4024,247,314,00:00:30.000,2025-04-06 21:52:21.561
false,false,4273,4026,247,377,00:00:32.000,2025-04-06 21:53:21.580
false,false,4272,4025,247,345,00:00:31.000,2025-04-06 21:52:51.571
false,false,2837,2675,162,476,00:00:33.000,2025-04-06 04:57:59.141
false,false,2840,2678,162,572,00:00:30.000,2025-04-06 04:59:29.181
false,false,2839,2677,162,542,00:00:33.000,2025-04-06 04:58:59.166
false,false,2841,2679,162,603,00:00:31.000,2025-04-06 04:59:59.196
false,false,2842,2680,162,636,00:00:33.000,2025-04-06 05:00:29.207
false,false,2838,2676,162,509,00:00:33.000,2025-04-06 04:58:29.154
false,false,2843,2681,162,668,00:00:32.000,2025-04-06 05:00:59.219
false,false,2844,2682,162,701,00:00:33.000,2025-04-06 05:01:29.232
false,false,2845,2683,162,734,00:00:33.000,2025-04-06 05:01:59.241
false,false,2846,2684,162,764,00:00:30.000,2025-04-06 05:02:29.251
false,false,2847,2685,162,794,00:00:30.000,2025-04-06 05:02:59.259
false,true,2848,2686,162,0,00:00:00.000,2025-04-06 05:03:59.278
false,false,2848,2686,162,827,00:00:33.000,2025-04-06 05:03:29.269
false,true,2848,2686,162,0,00:00:00.000,2025-04-06 05:04:59.306
false,true,2848,2686,162,0,00:00:00.000,2025-04-06 05:05:29.320
false,true,2848,2686,162,0,00:00:00.000,2025-04-06 05:04:29.292
false,true,2848,2686,162,0,00:00:00.000,2025-04-06 05:05:59.331
false,true,2848,2686,162,0,00:00:00.000,2025-04-06 05:06:29.343
false,true,2848,2686,162,0,00:00:00.000,2025-04-06 05:08:29.396
false,true,2848,2686,162,0,00:00:00.000,2025-04-06 05:06:59.358
false,true,2848,2686,162,0,00:00:00.000,2025-04-06 05:07:59.380
false,true,2848,2686,162,0,00:00:00.000,2025-04-06 05:07:29.371
false,false,2851,2689,162,98,00:00:33.000,2025-04-06 05:10:59.465
false,false,2852,2690,162,128,00:00:30.000,2025-04-06 05:11:29.478
false,false,2849,2687,162,33,00:00:33.000,2025-04-06 05:09:59.441
false,false,2850,2688,162,65,00:00:32.000,2025-04-06 05:10:29.454
false,true,2848,2686,162,0,00:00:00.000,2025-04-06 05:08:59.410
false,true,2848,2686,162,0,00:00:00.000,2025-04-06 05:09:29.426
false,false,2853,2691,162,158,00:00:30.000,2025-04-06 05:11:59.490
false,false,2854,2692,162,189,00:00:31.000,2025-04-06 05:12:29.501
false,false,2856,2694,162,251,00:00:32.000,2025-04-06 05:13:29.523
false,false,2855,2693,162,219,00:00:30.000,2025-04-06 05:12:59.513
false,false,2859,2697,162,346,00:00:32.000,2025-04-06 05:14:59.563
false,false,2858,2696,162,314,00:00:32.000,2025-04-06 05:14:29.549
false,false,2857,2695,162,282,00:00:31.000,2025-04-06 05:13:59.536
false,false,2863,2701,162,467,00:00:30.000,2025-04-06 05:16:59.615
false,false,2862,2700,162,437,00:00:30.000,2025-04-06 05:16:29.602
false,true,2863,2701,162,0,00:00:00.000,2025-04-06 05:17:29.627
false,false,2860,2698,162,377,00:00:31.000,2025-04-06 05:15:29.576
false,false,2861,2699,162,407,00:00:30.000,2025-04-06 05:15:59.590
false,true,2863,2701,162,0,00:00:00.000,2025-04-06 05:18:29.655
false,true,2863,2701,162,0,00:00:00.000,2025-04-06 05:19:29.673
false,true,2863,2701,162,0,00:00:00.000,2025-04-06 05:18:59.661
false,true,2863,2701,162,0,00:00:00.000,2025-04-06 05:17:59.640
false,true,2863,2701,162,0,00:00:00.000,2025-04-06 05:19:59.682
false,false,2865,2703,162,64,00:00:33.000,2025-04-06 05:20:59.709
false,false,2864,2702,162,31,00:00:31.000,2025-04-06 05:20:29.695
false,false,2867,2705,162,127,00:00:33.000,2025-04-06 05:21:59.733
false,false,2868,2706,162,160,00:00:33.000,2025-04-06 05:22:29.741
false,false,2866,2704,162,94,00:00:30.000,2025-04-06 05:21:29.720
false,false,2869,2706,163,193,00:00:33.000,2025-04-06 05:22:59.757
false,false,2870,2707,163,225,00:00:32.000,2025-04-06 05:23:29.770
false,true,2870,2707,163,0,00:00:00.000,2025-04-06 05:24:29.799
false,true,2870,2707,163,0,00:00:00.000,2025-04-06 05:23:59.784
false,true,2870,2707,163,0,00:00:00.000,2025-04-06 05:25:29.827
false,true,2870,2707,163,0,00:00:00.000,2025-04-06 05:26:29.855
false,false,2871,2708,163,33,00:00:33.000,2025-04-06 05:26:59.869
false,true,2870,2707,163,0,00:00:00.000,2025-04-06 05:24:59.815
false,false,2872,2709,163,64,00:00:31.000,2025-04-06 05:27:29.881
false,true,2870,2707,163,0,00:00:00.000,2025-04-06 05:25:59.840
false,false,2873,2710,163,97,00:00:33.000,2025-04-06 05:27:59.890
false,false,2876,2713,163,191,00:00:32.000,2025-04-06 05:29:29.920
false,false,2875,2712,163,159,00:00:30.000,2025-04-06 05:28:59.906
false,false,2878,2715,163,256,00:00:32.000,2025-04-06 05:30:29.944
false,false,2877,2714,163,224,00:00:33.000,2025-04-06 05:29:59.935
false,false,2874,2711,163,129,00:00:32.000,2025-04-06 05:28:29.902
false,false,2879,2716,163,287,00:00:31.000,2025-04-06 05:30:59.958
false,false,2881,2718,163,349,00:00:31.000,2025-04-06 05:31:59.983
false,false,2882,2719,163,379,00:00:30.000,2025-04-06 05:32:29.989
false,false,2883,2720,163,412,00:00:33.000,2025-04-06 05:33:00.002
false,false,2884,2721,163,443,00:00:31.000,2025-04-06 05:33:30.017
false,false,2880,2717,163,318,00:00:31.000,2025-04-06 05:31:29.972
false,false,2886,2723,163,508,00:00:32.000,2025-04-06 05:34:30.038
false,false,2885,2722,163,476,00:00:33.000,2025-04-06 05:34:00.027
false,false,2887,2724,163,541,00:00:33.000,2025-04-06 05:35:00.051
false,false,2888,2725,163,572,00:00:31.000,2025-04-06 05:35:30.064
false,false,2889,2726,163,602,00:00:30.000,2025-04-06 05:36:00.073
false,false,2891,2728,163,665,00:00:32.000,2025-04-06 05:37:00.097
false,false,2890,2727,163,633,00:00:31.000,2025-04-06 05:36:30.086
false,false,2892,2729,163,697,00:00:32.000,2025-04-06 05:37:30.108
false,false,2895,2731,164,794,00:00:33.000,2025-04-06 05:39:00.150
false,false,2896,2732,164,826,00:00:32.000,2025-04-06 05:39:30.165
false,false,2897,2733,164,859,00:00:33.000,2025-04-06 05:40:00.173
false,false,2893,2729,164,729,00:00:32.000,2025-04-06 05:38:00.122
false,true,2897,2733,164,0,00:00:00.000,2025-04-06 05:40:30.183
false,true,2897,2733,164,0,00:00:00.000,2025-04-06 05:41:00.198
false,false,2894,2730,164,761,00:00:32.000,2025-04-06 05:38:30.137
false,true,2897,2733,164,0,00:00:00.000,2025-04-06 05:42:00.226
false,true,2897,2733,164,0,00:00:00.000,2025-04-06 05:41:30.211
false,true,2897,2733,164,0,00:00:00.000,2025-04-06 05:43:00.244
false,true,2897,2733,164,0,00:00:00.000,2025-04-06 05:42:30.237
false,false,2899,2735,164,60,00:00:30.000,2025-04-06 05:44:00.273
false,false,2900,2736,164,92,00:00:32.000,2025-04-06 05:44:30.284
false,false,2898,2734,164,30,00:00:30.000,2025-04-06 05:43:30.257
false,false,2901,2737,164,123,00:00:31.000,2025-04-06 05:45:00.299
false,false,2902,2738,164,155,00:00:32.000,2025-04-06 05:45:30.314
false,false,2903,2739,164,188,00:00:33.000,2025-04-06 05:46:00.327
false,false,2906,2741,165,285,00:00:33.000,2025-04-06 05:47:30.371
false,false,2905,2740,165,252,00:00:31.000,2025-04-06 05:47:00.356
false,false,2904,2739,165,221,00:00:33.000,2025-04-06 05:46:30.342
false,false,2908,2742,166,347,00:00:31.000,2025-04-06 05:48:30.392
false,false,2909,2743,166,380,00:00:33.000,2025-04-06 05:49:00.408
false,false,2910,2744,166,413,00:00:33.000,2025-04-06 05:49:30.423
false,false,2907,2742,165,316,00:00:31.000,2025-04-06 05:48:00.380
false,false,2911,2745,166,445,00:00:32.000,2025-04-06 05:50:00.437
false,false,2913,2747,166,508,00:00:32.000,2025-04-06 05:51:00.458
false,false,2916,2750,166,604,00:00:31.000,2025-04-06 05:52:30.493
false,false,2915,2749,166,573,00:00:33.000,2025-04-06 05:52:00.481
false,false,2917,2751,166,634,00:00:30.000,2025-04-06 05:53:00.495
false,false,2912,2746,166,476,00:00:31.000,2025-04-06 05:50:30.448
false,false,2914,2748,166,540,00:00:32.000,2025-04-06 05:51:30.469
false,false,2918,2752,166,666,00:00:32.000,2025-04-06 05:53:30.507
false,false,2920,2754,166,727,00:00:31.000,2025-04-06 05:54:30.534
false,false,2921,2755,166,759,00:00:32.000,2025-04-06 05:55:00.547
false,false,2919,2753,166,696,00:00:30.000,2025-04-06 05:54:00.519
false,false,2922,2755,167,792,00:00:33.000,2025-04-06 05:55:30.562
false,false,2923,2756,167,823,00:00:31.000,2025-04-06 05:56:00.575
false,false,2924,2757,167,855,00:00:32.000,2025-04-06 05:56:30.590
false,true,2925,2758,167,0,00:00:00.000,2025-04-06 05:58:00.626
false,true,2925,2758,167,0,00:00:00.000,2025-04-06 05:57:30.611
false,true,2925,2758,167,0,00:00:00.000,2025-04-06 05:58:30.639
false,false,2925,2758,167,885,00:00:30.000,2025-04-06 05:57:00.602
false,true,2925,2758,167,0,00:00:00.000,2025-04-06 05:59:00.653
false,true,2925,2758,167,0,00:00:00.000,2025-04-06 05:59:30.666
false,true,2925,2758,167,0,00:00:00.000,2025-04-06 06:00:00.682
false,false,2926,2759,167,32,00:00:32.000,2025-04-06 06:00:30.693
false,false,2927,2760,167,64,00:00:32.000,2025-04-06 06:01:00.708
false,false,2928,2761,167,94,00:00:30.000,2025-04-06 06:01:30.720
false,false,4625,4365,260,188,00:00:31.000,2025-04-07 02:10:24.507
false,false,4623,4363,260,125,00:00:32.000,2025-04-07 02:09:24.500
false,false,4624,4364,260,157,00:00:32.000,2025-04-07 02:09:54.504
false,false,4627,4367,260,251,00:00:32.000,2025-04-07 02:11:24.514
false,false,4622,4362,260,93,00:00:31.000,2025-04-07 02:08:54.497
false,false,4626,4366,260,219,00:00:31.000,2025-04-07 02:10:54.512
false,true,4627,4367,260,0,00:00:00.000,2025-04-07 02:12:54.524
false,true,4627,4367,260,0,00:00:00.000,2025-04-07 02:12:24.519
false,true,4627,4367,260,0,00:00:00.000,2025-04-07 02:13:54.530
false,true,4627,4367,260,0,00:00:00.000,2025-04-07 02:13:24.529
false,true,4627,4367,260,0,00:00:00.000,2025-04-07 02:11:54.515
false,true,4627,4367,260,0,00:00:00.000,2025-04-07 02:14:24.533
false,true,4627,4367,260,0,00:00:00.000,2025-04-07 02:14:54.535
false,true,4627,4367,260,0,00:00:00.000,2025-04-07 02:16:54.544
false,true,4627,4367,260,0,00:00:00.000,2025-04-07 02:15:24.539
false,true,4627,4367,260,0,00:00:00.000,2025-04-07 02:15:54.539
false,true,4627,4367,260,0,00:00:00.000,2025-04-07 02:16:24.541
false,true,4627,4367,260,0,00:00:00.000,2025-04-07 02:17:24.547
false,false,4629,4368,261,64,00:00:31.000,2025-04-07 02:18:24.554
false,false,4630,4369,261,95,00:00:31.000,2025-04-07 02:18:54.557
false,false,4628,4367,261,33,00:00:33.000,2025-04-07 02:17:54.550
false,false,4632,4371,261,157,00:00:30.000,2025-04-07 02:19:54.561
false,false,4631,4370,261,127,00:00:32.000,2025-04-07 02:19:24.561
false,false,4633,4372,261,188,00:00:31.000,2025-04-07 02:20:24.565
false,false,4636,4375,261,281,00:00:30.000,2025-04-07 02:21:54.575
false,false,4634,4373,261,219,00:00:31.000,2025-04-07 02:20:54.567
false,false,4635,4374,261,251,00:00:32.000,2025-04-07 02:21:24.571
false,true,4636,4375,261,0,00:00:00.000,2025-04-07 02:22:24.576
false,true,4636,4375,261,0,00:00:00.000,2025-04-07 02:22:54.579
false,true,4636,4375,261,0,00:00:00.000,2025-04-07 02:23:24.581
false,true,4636,4375,261,0,00:00:00.000,2025-04-07 02:24:24.585
false,true,4636,4375,261,0,00:00:00.000,2025-04-07 02:24:54.589
false,true,4636,4375,261,0,00:00:00.000,2025-04-07 02:25:24.592
false,true,4636,4375,261,0,00:00:00.000,2025-04-07 02:25:54.594
false,true,4636,4375,261,0,00:00:00.000,2025-04-07 02:26:24.596
false,true,4636,4375,261,0,00:00:00.000,2025-04-07 02:23:54.582
false,true,4636,4375,261,0,00:00:00.000,2025-04-07 02:26:54.598
false,true,4636,4375,261,0,00:00:00.000,2025-04-07 02:27:54.601
false,false,4639,4378,261,95,00:00:32.000,2025-04-07 02:29:24.608
false,false,4637,4376,261,32,00:00:32.000,2025-04-07 02:28:24.604
false,true,4636,4375,261,0,00:00:00.000,2025-04-07 02:27:24.600
false,false,4638,4377,261,63,00:00:31.000,2025-04-07 02:28:54.606
false,false,4640,4379,261,128,00:00:33.000,2025-04-07 02:29:54.608
false,false,4641,4380,261,158,00:00:30.000,2025-04-07 02:30:24.610
false,true,4641,4380,261,0,00:00:00.000,2025-04-07 02:32:24.617
false,true,4641,4380,261,0,00:00:00.000,2025-04-07 02:30:54.613
false,true,4641,4380,261,0,00:00:00.000,2025-04-07 02:31:54.617
false,true,4641,4380,261,0,00:00:00.000,2025-04-07 02:32:54.620
false,true,4641,4380,261,0,00:00:00.000,2025-04-07 02:33:24.623
false,true,4641,4380,261,0,00:00:00.000,2025-04-07 02:31:24.616
false,false,4644,4383,261,94,00:00:32.000,2025-04-07 02:34:54.633
false,false,4642,4381,261,30,00:00:30.000,2025-04-07 02:33:54.626
false,false,4645,4384,261,124,00:00:30.000,2025-04-07 02:35:24.634
false,false,4643,4382,261,62,00:00:32.000,2025-04-07 02:34:24.630
false,false,4649,4388,261,247,00:00:30.000,2025-04-07 02:37:24.642
false,false,4647,4386,261,187,00:00:31.000,2025-04-07 02:36:24.636
false,false,4646,4385,261,156,00:00:32.000,2025-04-07 02:35:54.634
false,false,4648,4387,261,217,00:00:30.000,2025-04-07 02:36:54.639
false,false,4650,4389,261,280,00:00:33.000,2025-04-07 02:37:54.644
false,false,4651,4390,261,312,00:00:32.000,2025-04-07 02:38:24.646
false,false,4653,4392,261,374,00:00:32.000,2025-04-07 02:39:24.651
false,false,4654,4393,261,406,00:00:32.000,2025-04-07 02:39:54.653
false,false,4652,4391,261,342,00:00:30.000,2025-04-07 02:38:54.648
false,false,4655,4394,261,439,00:00:33.000,2025-04-07 02:40:24.655
false,false,4656,4395,261,470,00:00:31.000,2025-04-07 02:40:54.655
false,false,4658,4397,261,536,00:00:33.000,2025-04-07 02:41:54.661
false,false,4657,4396,261,503,00:00:33.000,2025-04-07 02:41:24.658
false,false,4659,4398,261,566,00:00:30.000,2025-04-07 02:42:24.663
false,false,4660,4399,261,598,00:00:32.000,2025-04-07 02:42:54.665
false,false,4661,4400,261,629,00:00:31.000,2025-04-07 02:43:24.667
false,false,4664,4403,261,727,00:00:33.000,2025-04-07 02:44:54.674
false,false,4663,4402,261,694,00:00:33.000,2025-04-07 02:44:24.673
false,false,4662,4401,261,661,00:00:32.000,2025-04-07 02:43:54.670
false,false,4665,4404,261,758,00:00:31.000,2025-04-07 02:45:24.677
false,false,4666,4405,261,791,00:00:33.000,2025-04-07 02:45:54.680
false,false,4667,4406,261,821,00:00:30.000,2025-04-07 02:46:24.683
false,true,4667,4406,261,0,00:00:00.000,2025-04-07 02:46:54.684
false,true,4667,4406,261,0,00:00:00.000,2025-04-07 02:47:24.686
false,true,4667,4406,261,0,00:00:00.000,2025-04-07 02:47:54.689
false,true,4667,4406,261,0,00:00:00.000,2025-04-07 02:48:24.691
false,true,4667,4406,261,0,00:00:00.000,2025-04-07 02:49:24.694
false,false,4669,4408,261,63,00:00:30.000,2025-04-07 02:50:24.697
false,true,4667,4406,261,0,00:00:00.000,2025-04-07 02:48:54.694
false,false,4668,4407,261,33,00:00:33.000,2025-04-07 02:49:54.696
false,false,4670,4409,261,93,00:00:30.000,2025-04-07 02:50:54.698
false,false,4671,4410,261,123,00:00:30.000,2025-04-07 02:51:24.701
false,true,4672,4411,261,0,00:00:00.000,2025-04-07 02:52:24.704
false,true,4672,4411,261,0,00:00:00.000,2025-04-07 02:53:24.708
false,false,4672,4411,261,153,00:00:30.000,2025-04-07 02:51:54.702
false,true,4672,4411,261,0,00:00:00.000,2025-04-07 02:52:54.706
false,true,4672,4411,261,0,00:00:00.000,2025-04-07 02:53:54.711
false,true,4672,4411,261,0,00:00:00.000,2025-04-07 02:54:54.711
false,true,4672,4411,261,0,00:00:00.000,2025-04-07 02:54:24.711
false,false,4674,4413,261,64,00:00:33.000,2025-04-07 02:55:54.716
false,false,4673,4412,261,31,00:00:31.000,2025-04-07 02:55:24.713
false,false,4676,4415,261,125,00:00:31.000,2025-04-07 02:56:54.719
false,false,4678,4417,261,187,00:00:32.000,2025-04-07 02:57:54.724
false,false,4677,4416,261,155,00:00:30.000,2025-04-07 02:57:24.722
false,false,4675,4414,261,94,00:00:30.000,2025-04-07 02:56:24.717
false,false,4679,4418,261,218,00:00:31.000,2025-04-07 02:58:24.726
false,false,4681,4420,261,280,00:00:32.000,2025-04-07 02:59:24.730
false,false,4680,4419,261,248,00:00:30.000,2025-04-07 02:58:54.729
false,false,4683,4422,261,341,00:00:31.000,2025-04-07 03:00:24.734
false,false,4684,4423,261,372,00:00:31.000,2025-04-07 03:00:54.737
false,false,4685,4424,261,405,00:00:33.000,2025-04-07 03:01:24.738
false,false,4686,4425,261,437,00:00:32.000,2025-04-07 03:01:54.740
false,false,4688,4427,261,501,00:00:33.000,2025-04-07 03:02:54.744
false,false,4687,4426,261,468,00:00:31.000,2025-04-07 03:02:24.742
false,false,4689,4428,261,531,00:00:30.000,2025-04-07 03:03:24.745
false,false,4682,4421,261,310,00:00:30.000,2025-04-07 02:59:54.733
false,false,4690,4428,262,564,00:00:33.000,2025-04-07 03:03:54.748
false,false,4692,4430,262,626,00:00:31.000,2025-04-07 03:04:54.752
false,false,4693,4431,262,659,00:00:33.000,2025-04-07 03:05:24.754
false,false,4691,4429,262,595,00:00:31.000,2025-04-07 03:04:24.750
false,false,4696,4433,263,752,00:00:32.000,2025-04-07 03:06:54.759
false,false,4694,4432,262,689,00:00:30.000,2025-04-07 03:05:54.756
false,false,4697,4434,263,783,00:00:31.000,2025-04-07 03:07:24.761
false,false,4695,4433,262,720,00:00:31.000,2025-04-07 03:06:24.757
false,true,4697,4434,263,0,00:00:00.000,2025-04-07 03:07:54.762
false,true,4697,4434,263,0,00:00:00.000,2025-04-07 03:08:24.764
false,true,4697,4434,263,0,00:00:00.000,2025-04-07 03:09:24.768
false,true,4697,4434,263,0,00:00:00.000,2025-04-07 03:08:54.766
false,true,4697,4434,263,0,00:00:00.000,2025-04-07 03:10:24.769
false,true,4697,4434,263,0,00:00:00.000,2025-04-07 03:09:54.769
false,false,4699,4436,263,62,00:00:30.000,2025-04-07 03:11:24.773
false,false,4701,4438,263,128,00:00:33.000,2025-04-07 03:12:24.777
false,false,4698,4435,263,32,00:00:32.000,2025-04-07 03:10:54.771
false,false,4702,4439,263,158,00:00:30.000,2025-04-07 03:12:54.777
false,false,4700,4437,263,95,00:00:33.000,2025-04-07 03:11:54.775
false,true,4985,4706,279,0,00:00:00.000,2025-04-07 06:27:28.936
false,true,4985,4706,279,0,00:00:00.000,2025-04-07 06:28:28.961
false,true,4985,4706,279,0,00:00:00.000,2025-04-07 06:25:58.896
false,true,4985,4706,279,0,00:00:00.000,2025-04-07 06:26:58.921
false,true,4985,4706,279,0,00:00:00.000,2025-04-07 06:27:58.950
false,true,4985,4706,279,0,00:00:00.000,2025-04-07 06:26:28.910
false,false,4986,4707,279,30,00:00:30.000,2025-04-07 06:28:58.972
false,false,4988,4709,279,96,00:00:33.000,2025-04-07 06:29:58.993
false,false,4987,4708,279,63,00:00:33.000,2025-04-07 06:29:28.982
false,false,4990,4711,279,160,00:00:33.000,2025-04-07 06:30:59.018
false,false,4989,4710,279,127,00:00:31.000,2025-04-07 06:30:29.008
false,false,4991,4712,279,191,00:00:31.000,2025-04-07 06:31:29.032
false,false,4993,4714,279,251,00:00:30.000,2025-04-07 06:32:29.061
false,false,4992,4713,279,221,00:00:30.000,2025-04-07 06:31:59.046
false,false,4994,4715,279,282,00:00:31.000,2025-04-07 06:32:59.075
false,false,4997,4718,279,374,00:00:31.000,2025-04-07 06:34:29.100
false,false,4999,4720,279,435,00:00:31.000,2025-04-07 06:35:29.130
false,false,4998,4719,279,404,00:00:30.000,2025-04-07 06:34:59.115
false,false,4996,4717,279,343,00:00:31.000,2025-04-07 06:33:59.092
false,false,4995,4716,279,312,00:00:30.000,2025-04-07 06:33:29.086
false,false,5000,4721,279,468,00:00:33.000,2025-04-07 06:35:59.140
false,false,5001,4722,279,498,00:00:30.000,2025-04-07 06:36:29.153
false,false,5003,4724,279,562,00:00:33.000,2025-04-07 06:37:29.179
false,false,5005,4726,279,624,00:00:30.000,2025-04-07 06:38:29.184
false,false,5004,4725,279,594,00:00:32.000,2025-04-07 06:37:59.182
false,false,5002,4723,279,529,00:00:31.000,2025-04-07 06:36:59.167
false,false,5006,4727,279,654,00:00:30.000,2025-04-07 06:38:59.189
false,false,5008,4729,279,718,00:00:33.000,2025-04-07 06:39:59.216
false,false,5007,4728,279,685,00:00:31.000,2025-04-07 06:39:29.201
false,false,5009,4730,279,751,00:00:33.000,2025-04-07 06:40:29.228
false,false,5011,4732,279,811,00:00:30.000,2025-04-07 06:41:29.251
false,false,5010,4731,279,781,00:00:30.000,2025-04-07 06:40:59.239
false,false,5013,4734,279,874,00:00:32.000,2025-04-07 06:42:29.272
false,false,5012,4733,279,842,00:00:31.000,2025-04-07 06:41:59.265
false,false,5015,4736,279,937,00:00:32.000,2025-04-07 06:43:29.297
false,true,5015,4736,279,0,00:00:00.000,2025-04-07 06:43:59.309
false,true,5015,4736,279,0,00:00:00.000,2025-04-07 06:44:29.323
false,false,5014,4735,279,905,00:00:31.000,2025-04-07 06:42:59.285
false,true,5015,4736,279,0,00:00:00.000,2025-04-07 06:44:59.336
false,true,5015,4736,279,0,00:00:00.000,2025-04-07 06:46:29.375
false,true,5015,4736,279,0,00:00:00.000,2025-04-07 06:45:59.362
false,false,5017,4738,279,65,00:00:33.000,2025-04-07 06:47:29.404
false,false,5018,4739,279,95,00:00:30.000,2025-04-07 06:47:59.409
false,false,5016,4737,279,32,00:00:32.000,2025-04-07 06:46:59.389
false,false,5019,4740,279,125,00:00:30.000,2025-04-07 06:48:29.423
false,true,5015,4736,279,0,00:00:00.000,2025-04-07 06:45:29.351
false,false,5020,4741,279,157,00:00:32.000,2025-04-07 06:48:59.436
false,false,5022,4743,279,221,00:00:32.000,2025-04-07 06:49:59.461
false,false,5023,4743,280,251,00:00:30.000,2025-04-07 06:50:29.475
false,false,5021,4742,279,189,00:00:32.000,2025-04-07 06:49:29.447
false,true,5024,4744,280,0,00:00:00.000,2025-04-07 06:51:29.502
false,false,5024,4744,280,282,00:00:31.000,2025-04-07 06:50:59.489
false,true,5024,4744,280,0,00:00:00.000,2025-04-07 06:52:59.539
false,true,5024,4744,280,0,00:00:00.000,2025-04-07 06:52:29.530
false,true,5024,4744,280,0,00:00:00.000,2025-04-07 06:51:59.517
false,true,5024,4744,280,0,00:00:00.000,2025-04-07 06:53:29.551
false,true,5024,4744,280,0,00:00:00.000,2025-04-07 06:53:59.562
false,false,5025,4745,280,33,00:00:33.000,2025-04-07 06:54:29.577
false,false,5026,4746,280,63,00:00:30.000,2025-04-07 06:54:59.592
false,false,5028,4748,280,128,00:00:33.000,2025-04-07 06:55:59.617
false,false,5030,4750,280,190,00:00:30.000,2025-04-07 06:56:59.638
false,false,5027,4747,280,95,00:00:32.000,2025-04-07 06:55:29.603
false,false,5033,4752,281,286,00:00:30.000,2025-04-07 06:58:29.666
false,false,5029,4749,280,160,00:00:32.000,2025-04-07 06:56:29.625
false,false,5031,4751,280,223,00:00:33.000,2025-04-07 06:57:29.646
false,false,5035,4753,282,349,00:00:31.000,2025-04-07 06:59:29.690
false,false,5032,4751,281,256,00:00:33.000,2025-04-07 06:57:59.656
false,false,5036,4754,282,381,00:00:32.000,2025-04-07 06:59:59.703
false,false,5034,4753,281,318,00:00:32.000,2025-04-07 06:58:59.678
false,false,5037,4755,282,414,00:00:33.000,2025-04-07 07:00:29.715
false,false,5038,4756,282,444,00:00:30.000,2025-04-07 07:00:59.729
false,false,5039,4757,282,476,00:00:32.000,2025-04-07 07:01:29.737
false,false,5041,4759,282,536,00:00:30.000,2025-04-07 07:02:29.763
false,false,5042,4760,282,566,00:00:30.000,2025-04-07 07:02:59.770
false,false,5043,4761,282,596,00:00:30.000,2025-04-07 07:03:29.783
false,false,5040,4758,282,506,00:00:30.000,2025-04-07 07:01:59.750
false,false,5044,4762,282,627,00:00:31.000,2025-04-07 07:03:59.793
false,false,5045,4763,282,659,00:00:32.000,2025-04-07 07:04:29.804
false,false,5047,4765,282,723,00:00:32.000,2025-04-07 07:05:29.820
false,false,5046,4764,282,691,00:00:32.000,2025-04-07 07:04:59.810
false,false,5049,4767,282,789,00:00:33.000,2025-04-07 07:06:29.847
false,false,5048,4766,282,756,00:00:33.000,2025-04-07 07:05:59.835
false,false,5051,4769,282,852,00:00:33.000,2025-04-07 07:07:29.875
false,false,5050,4768,282,819,00:00:30.000,2025-04-07 07:06:59.861
false,false,5052,4769,283,884,00:00:32.000,2025-04-07 07:07:59.890
false,false,5053,4770,283,915,00:00:31.000,2025-04-07 07:08:29.905
false,true,5053,4770,283,0,00:00:00.000,2025-04-07 07:08:59.921
false,true,5053,4770,283,0,00:00:00.000,2025-04-07 07:10:59.968
false,true,5053,4770,283,0,00:00:00.000,2025-04-07 07:09:59.942
false,true,5053,4770,283,0,00:00:00.000,2025-04-07 07:09:29.931
false,true,5053,4770,283,0,00:00:00.000,2025-04-07 07:11:29.977
false,false,5054,4771,283,33,00:00:33.000,2025-04-07 07:11:59.989
false,true,5053,4770,283,0,00:00:00.000,2025-04-07 07:10:29.954
false,false,5055,4772,283,63,00:00:30.000,2025-04-07 07:12:30.003
false,false,5056,4773,283,95,00:00:32.000,2025-04-07 07:13:00.016
false,false,5057,4774,283,126,00:00:31.000,2025-04-07 07:13:30.026
false,false,5059,4776,283,188,00:00:32.000,2025-04-07 07:14:30.056
false,false,5061,4777,284,249,00:00:30.000,2025-04-07 07:15:30.082
false,false,5058,4775,283,156,00:00:30.000,2025-04-07 07:14:00.041
false,false,5060,4777,283,219,00:00:31.000,2025-04-07 07:15:00.070
false,false,5062,4778,284,280,00:00:31.000,2025-04-07 07:16:00.094
false,false,5065,4780,285,375,00:00:32.000,2025-04-07 07:17:30.130
false,false,5067,4782,285,436,00:00:30.000,2025-04-07 07:18:30.151
false,false,5063,4778,285,312,00:00:32.000,2025-04-07 07:16:30.105
false,false,5066,4781,285,406,00:00:31.000,2025-04-07 07:18:00.142
false,false,5064,4779,285,343,00:00:31.000,2025-04-07 07:17:00.118
false,false,5068,4783,285,467,00:00:31.000,2025-04-07 07:19:00.163
false,false,5070,4785,285,529,00:00:30.000,2025-04-07 07:20:00.186
false,false,5073,4788,285,625,00:00:33.000,2025-04-07 07:21:30.221
false,false,5072,4787,285,592,00:00:32.000,2025-04-07 07:21:00.210
false,false,5071,4786,285,560,00:00:31.000,2025-04-07 07:20:30.201
false,false,5069,4784,285,499,00:00:32.000,2025-04-07 07:19:30.175
false,false,5074,4789,285,658,00:00:33.000,2025-04-07 07:22:00.234
false,false,5078,4793,285,788,00:00:33.000,2025-04-07 07:24:00.283
false,false,5076,4791,285,722,00:00:33.000,2025-04-07 07:23:00.257
false,false,5075,4790,285,689,00:00:31.000,2025-04-07 07:22:30.247
false,false,5077,4792,285,755,00:00:33.000,2025-04-07 07:23:30.270
false,false,5080,4794,286,854,00:00:33.000,2025-04-07 07:25:00.311
false,false,5081,4795,286,886,00:00:32.000,2025-04-07 07:25:30.322
false,true,5081,4795,286,0,00:00:00.000,2025-04-07 07:26:00.336
false,false,5079,4794,285,821,00:00:33.000,2025-04-07 07:24:30.296
false,true,5081,4795,286,0,00:00:00.000,2025-04-07 07:26:30.349
false,true,5081,4795,286,0,00:00:00.000,2025-04-07 07:27:00.364
false,false,5198,4909,289,2346,00:00:30.000,2025-04-07 08:36:01.957
false,false,5193,4904,289,2191,00:00:32.000,2025-04-07 08:33:31.905
false,false,5194,4905,289,2221,00:00:30.000,2025-04-07 08:34:01.915
false,false,5196,4907,289,2285,00:00:32.000,2025-04-07 08:35:01.936
false,false,5195,4906,289,2253,00:00:32.000,2025-04-07 08:34:31.928
false,false,5197,4908,289,2316,00:00:31.000,2025-04-07 08:35:31.949
false,false,5199,4910,289,2378,00:00:32.000,2025-04-07 08:36:31.962
false,false,5201,4912,289,2440,00:00:30.000,2025-04-07 08:37:31.989
false,false,5200,4911,289,2410,00:00:32.000,2025-04-07 08:37:01.977
false,false,5202,4913,289,2471,00:00:31.000,2025-04-07 08:38:01.998
false,true,5202,4913,289,0,00:00:00.000,2025-04-07 08:38:32.013
false,true,5202,4913,289,0,00:00:00.000,2025-04-07 08:39:32.037
false,true,5202,4913,289,0,00:00:00.000,2025-04-07 08:39:02.023
false,true,5202,4913,289,0,00:00:00.000,2025-04-07 08:41:02.071
false,true,5202,4913,289,0,00:00:00.000,2025-04-07 08:40:02.051
false,false,5203,4913,290,30,00:00:30.000,2025-04-07 08:41:32.086
false,false,5206,4916,290,122,00:00:31.000,2025-04-07 08:43:02.121
false,true,5202,4913,289,0,00:00:00.000,2025-04-07 08:40:32.061
false,false,5207,4917,290,154,00:00:32.000,2025-04-07 08:43:32.133
false,false,5204,4914,290,60,00:00:30.000,2025-04-07 08:42:02.095
false,false,5205,4915,290,91,00:00:31.000,2025-04-07 08:42:32.109
false,false,5208,4918,290,186,00:00:32.000,2025-04-07 08:44:02.148
false,true,5208,4918,290,0,00:00:00.000,2025-04-07 08:44:32.160
false,true,5208,4918,290,0,00:00:00.000,2025-04-07 08:45:02.173
false,true,5208,4918,290,0,00:00:00.000,2025-04-07 08:45:32.184
false,true,5208,4918,290,0,00:00:00.000,2025-04-07 08:47:32.221
false,true,5208,4918,290,0,00:00:00.000,2025-04-07 08:46:32.200
false,true,5208,4918,290,0,00:00:00.000,2025-04-07 08:46:02.187
false,true,5208,4918,290,0,00:00:00.000,2025-04-07 08:47:02.211
false,true,5208,4918,290,0,00:00:00.000,2025-04-07 08:48:02.235
false,true,5208,4918,290,0,00:00:00.000,2025-04-07 08:49:02.258
false,true,5208,4918,290,0,00:00:00.000,2025-04-07 08:50:02.282
false,true,5208,4918,290,0,00:00:00.000,2025-04-07 08:49:32.271
false,false,5209,4919,290,33,00:00:33.000,2025-04-07 08:50:32.296
false,true,5208,4918,290,0,00:00:00.000,2025-04-07 08:48:32.245
false,false,5211,4921,290,96,00:00:33.000,2025-04-07 08:51:32.321
false,false,5212,4922,290,126,00:00:30.000,2025-04-07 08:52:02.336
false,false,5214,4924,290,191,00:00:33.000,2025-04-07 08:53:02.352
false,false,5210,4920,290,63,00:00:30.000,2025-04-07 08:51:02.307
false,false,5215,4925,290,224,00:00:33.000,2025-04-07 08:53:32.356
false,false,5216,4926,290,254,00:00:30.000,2025-04-07 08:54:02.370
false,false,5213,4923,290,158,00:00:32.000,2025-04-07 08:52:32.349
false,false,5217,4927,290,286,00:00:32.000,2025-04-07 08:54:32.381
false,false,5220,4930,290,379,00:00:30.000,2025-04-07 08:56:02.419
false,false,5218,4928,290,317,00:00:31.000,2025-04-07 08:55:02.394
false,false,5221,4931,290,410,00:00:31.000,2025-04-07 08:56:32.431
false,false,5219,4929,290,349,00:00:32.000,2025-04-07 08:55:32.408
false,false,5223,4933,290,471,00:00:30.000,2025-04-07 08:57:32.455
false,false,5222,4932,290,441,00:00:31.000,2025-04-07 08:57:02.442
false,false,5224,4934,290,504,00:00:33.000,2025-04-07 08:58:02.468
false,false,5225,4935,290,537,00:00:33.000,2025-04-07 08:58:32.483
false,false,5227,4936,291,602,00:00:32.000,2025-04-07 08:59:32.508
false,false,5228,4937,291,634,00:00:32.000,2025-04-07 09:00:02.514
false,false,5226,4935,291,570,00:00:33.000,2025-04-07 08:59:02.496
false,false,5230,4939,291,699,00:00:32.000,2025-04-07 09:01:02.537
false,false,5231,4940,291,730,00:00:31.000,2025-04-07 09:01:32.548
false,false,5229,4938,291,667,00:00:33.000,2025-04-07 09:00:32.525
false,false,5234,4943,291,824,00:00:30.000,2025-04-07 09:03:02.579
false,false,5232,4941,291,761,00:00:31.000,2025-04-07 09:02:02.555
false,false,5235,4944,291,854,00:00:30.000,2025-04-07 09:03:32.590
false,false,5233,4942,291,794,00:00:33.000,2025-04-07 09:02:32.566
false,false,5236,4945,291,884,00:00:30.000,2025-04-07 09:04:02.601
false,false,5238,4947,291,947,00:00:31.000,2025-04-07 09:05:02.630
false,false,5240,4948,292,1013,00:00:33.000,2025-04-07 09:06:02.651
false,false,5241,4949,292,1043,00:00:30.000,2025-04-07 09:06:32.666
false,false,5237,4946,291,916,00:00:32.000,2025-04-07 09:04:32.615
false,false,5239,4947,292,980,00:00:33.000,2025-04-07 09:05:32.644
false,false,5243,4951,292,1105,00:00:30.000,2025-04-07 09:07:32.689
false,false,5242,4950,292,1075,00:00:32.000,2025-04-07 09:07:02.680
false,false,5246,4953,293,1201,00:00:32.000,2025-04-07 09:09:02.716
false,false,5244,4952,292,1136,00:00:31.000,2025-04-07 09:08:02.692
false,false,5248,4955,293,1264,00:00:33.000,2025-04-07 09:10:02.741
false,false,5247,4954,293,1231,00:00:30.000,2025-04-07 09:09:32.727
false,false,5249,4956,293,1294,00:00:30.000,2025-04-07 09:10:32.754
false,false,5245,4953,292,1169,00:00:33.000,2025-04-07 09:08:32.703
false,false,5250,4957,293,1326,00:00:32.000,2025-04-07 09:11:02.767
false,false,5252,4959,293,1387,00:00:31.000,2025-04-07 09:12:02.789
false,false,5253,4960,293,1418,00:00:31.000,2025-04-07 09:12:32.802
false,false,5251,4958,293,1356,00:00:30.000,2025-04-07 09:11:32.777
false,false,5255,4962,293,1482,00:00:33.000,2025-04-07 09:13:32.824
false,false,5256,4963,293,1514,00:00:32.000,2025-04-07 09:14:02.838
false,false,5254,4961,293,1449,00:00:31.000,2025-04-07 09:13:02.813
false,false,5259,4966,293,1609,00:00:33.000,2025-04-07 09:15:32.876
false,false,5257,4964,293,1544,00:00:30.000,2025-04-07 09:14:32.849
false,false,5258,4965,293,1576,00:00:32.000,2025-04-07 09:15:02.861
false,false,5260,4967,293,1641,00:00:32.000,2025-04-07 09:16:02.889
false,false,5263,4970,293,1737,00:00:31.000,2025-04-07 09:17:32.929
false,false,5261,4968,293,1673,00:00:32.000,2025-04-07 09:16:32.904
false,false,5265,4972,293,1799,00:00:30.000,2025-04-07 09:18:32.953
false,false,5264,4971,293,1769,00:00:32.000,2025-04-07 09:18:02.941
false,false,5262,4969,293,1706,00:00:33.000,2025-04-07 09:17:02.918
false,false,5267,4974,293,1861,00:00:32.000,2025-04-07 09:19:32.979
false,false,5268,4975,293,1893,00:00:32.000,2025-04-07 09:20:02.992
false,false,5266,4973,293,1829,00:00:30.000,2025-04-07 09:19:02.965
false,false,5269,4976,293,1923,00:00:30.000,2025-04-07 09:20:33.001
false,false,5271,4978,293,1987,00:00:33.000,2025-04-07 09:21:33.019
false,false,5270,4977,293,1954,00:00:31.000,2025-04-07 09:21:03.008
false,false,5272,4979,293,2018,00:00:31.000,2025-04-07 09:22:03.033
false,false,5273,4980,293,2049,00:00:31.000,2025-04-07 09:22:33.046
false,false,5274,4981,293,2082,00:00:33.000,2025-04-07 09:23:03.057
false,false,5275,4982,293,2113,00:00:31.000,2025-04-07 09:23:33.069
false,true,5278,4985,293,0,00:00:00.000,2025-04-07 09:25:33.112
false,true,5278,4985,293,0,00:00:00.000,2025-04-07 09:26:03.122
false,false,5278,4985,293,2206,00:00:31.000,2025-04-07 09:25:03.104
false,true,5278,4985,293,0,00:00:00.000,2025-04-07 09:26:33.136
false,false,5276,4983,293,2145,00:00:32.000,2025-04-07 09:24:03.082
false,true,5278,4985,293,0,00:00:00.000,2025-04-07 09:28:03.166
false,true,5278,4985,293,0,00:00:00.000,2025-04-07 09:27:33.157
false,false,5277,4984,293,2175,00:00:30.000,2025-04-07 09:24:33.090
false,false,5280,4987,293,64,00:00:33.000,2025-04-07 09:29:03.192
false,false,5279,4986,293,31,00:00:31.000,2025-04-07 09:28:33.178
false,true,5278,4985,293,0,00:00:00.000,2025-04-07 09:27:03.142
false,false,5282,4989,293,125,00:00:31.000,2025-04-07 09:30:03.209
false,false,5283,4990,293,155,00:00:30.000,2025-04-07 09:30:33.223
false,false,5281,4988,293,94,00:00:30.000,2025-04-07 09:29:33.203
false,false,5284,4991,293,185,00:00:30.000,2025-04-07 09:31:03.233
false,false,5285,4992,293,217,00:00:32.000,2025-04-07 09:31:33.242
false,false,5286,4993,293,249,00:00:32.000,2025-04-07 09:32:03.251
false,false,5288,4995,293,314,00:00:32.000,2025-04-07 09:33:03.273
false,false,5289,4996,293,344,00:00:30.000,2025-04-07 09:33:33.286
false,false,5290,4997,293,375,00:00:31.000,2025-04-07 09:34:03.295
false,false,5291,4998,293,406,00:00:31.000,2025-04-07 09:34:33.307
false,false,5292,4999,293,436,00:00:30.000,2025-04-07 09:35:03.315
false,true,5294,5001,293,0,00:00:00.000,2025-04-07 09:37:03.362
false,false,5287,4994,293,282,00:00:33.000,2025-04-07 09:32:33.262
false,true,5294,5001,293,0,00:00:00.000,2025-04-07 09:36:33.348
false,false,5294,5001,293,498,00:00:31.000,2025-04-07 09:36:03.341
false,false,5293,5000,293,467,00:00:31.000,2025-04-07 09:35:33.328
false,true,2494,2354,140,0,00:00:00.000,2025-04-06 00:47:53.235
false,true,2494,2354,140,0,00:00:00.000,2025-04-06 00:45:53.190
false,true,2494,2354,140,0,00:00:00.000,2025-04-06 00:46:23.202
false,true,2494,2354,140,0,00:00:00.000,2025-04-06 00:46:53.215
false,true,2494,2354,140,0,00:00:00.000,2025-04-06 00:48:23.251
false,true,2494,2354,140,0,00:00:00.000,2025-04-06 00:47:23.230
false,true,2494,2354,140,0,00:00:00.000,2025-04-06 00:49:53.283
false,true,2494,2354,140,0,00:00:00.000,2025-04-06 00:48:53.256
false,true,2494,2354,140,0,00:00:00.000,2025-04-06 00:50:53.306
false,true,2494,2354,140,0,00:00:00.000,2025-04-06 00:51:23.315
false,true,2494,2354,140,0,00:00:00.000,2025-04-06 00:50:23.292
false,true,2494,2354,140,0,00:00:00.000,2025-04-06 00:49:23.271
false,true,2494,2354,140,0,00:00:00.000,2025-04-06 00:52:23.342
false,true,2494,2354,140,0,00:00:00.000,2025-04-06 00:51:53.329
false,true,2494,2354,140,0,00:00:00.000,2025-04-06 00:52:53.356
false,true,2494,2354,140,0,00:00:00.000,2025-04-06 00:53:53.378
false,true,2494,2354,140,0,00:00:00.000,2025-04-06 00:54:23.385
false,true,2494,2354,140,0,00:00:00.000,2025-04-06 00:53:23.365
false,false,2495,2355,140,31,00:00:31.000,2025-04-06 00:54:53.393
false,false,2499,2359,140,157,00:00:31.000,2025-04-06 00:56:53.437
false,false,2500,2359,141,189,00:00:32.000,2025-04-06 00:57:23.446
false,false,2497,2357,140,93,00:00:32.000,2025-04-06 00:55:53.413
false,false,2496,2356,140,61,00:00:30.000,2025-04-06 00:55:23.400
false,false,2498,2358,140,126,00:00:33.000,2025-04-06 00:56:23.426
false,false,2501,2360,141,219,00:00:30.000,2025-04-06 00:57:53.456
false,false,2504,2363,141,312,00:00:31.000,2025-04-06 00:59:23.490
false,false,2506,2364,142,378,00:00:33.000,2025-04-06 01:00:23.515
false,false,2505,2363,142,345,00:00:33.000,2025-04-06 00:59:53.503
false,false,2503,2362,141,281,00:00:32.000,2025-04-06 00:58:53.476
false,false,2507,2365,142,408,00:00:30.000,2025-04-06 01:00:53.524
false,false,2502,2361,141,249,00:00:30.000,2025-04-06 00:58:23.470
false,false,2509,2367,142,472,00:00:32.000,2025-04-06 01:01:53.537
false,false,2510,2368,142,504,00:00:32.000,2025-04-06 01:02:23.553
false,false,2512,2370,142,565,00:00:31.000,2025-04-06 01:03:23.571
false,false,2508,2366,142,440,00:00:32.000,2025-04-06 01:01:23.529
false,true,2512,2370,142,0,00:00:00.000,2025-04-06 01:03:53.582
false,false,2511,2369,142,534,00:00:30.000,2025-04-06 01:02:53.565
false,true,2512,2370,142,0,00:00:00.000,2025-04-06 01:04:23.596
false,true,2512,2370,142,0,00:00:00.000,2025-04-06 01:05:23.620
false,true,2512,2370,142,0,00:00:00.000,2025-04-06 01:04:53.607
false,false,2514,2371,143,63,00:00:33.000,2025-04-06 01:07:23.660
false,true,2512,2370,142,0,00:00:00.000,2025-04-06 01:05:53.631
false,true,2512,2370,142,0,00:00:00.000,2025-04-06 01:06:23.644
false,false,2515,2372,143,94,00:00:31.000,2025-04-06 01:07:53.675
false,false,2513,2370,143,30,00:00:30.000,2025-04-06 01:06:53.657
false,false,2517,2374,143,156,00:00:30.000,2025-04-06 01:08:53.700
false,false,2516,2373,143,126,00:00:32.000,2025-04-06 01:08:23.688
false,true,2517,2374,143,0,00:00:00.000,2025-04-06 01:09:53.724
false,true,2517,2374,143,0,00:00:00.000,2025-04-06 01:10:23.736
false,true,2517,2374,143,0,00:00:00.000,2025-04-06 01:11:53.761
false,false,2518,2375,143,31,00:00:31.000,2025-04-06 01:12:23.773
false,true,2517,2374,143,0,00:00:00.000,2025-04-06 01:11:23.749
false,false,2519,2376,143,63,00:00:32.000,2025-04-06 01:12:53.785
false,true,2517,2374,143,0,00:00:00.000,2025-04-06 01:10:53.741
false,true,2517,2374,143,0,00:00:00.000,2025-04-06 01:09:23.712
false,false,2520,2377,143,96,00:00:33.000,2025-04-06 01:13:23.799
false,false,2523,2380,143,190,00:00:32.000,2025-04-06 01:14:53.845
false,false,2524,2381,143,221,00:00:31.000,2025-04-06 01:15:23.861
false,false,2522,2379,143,158,00:00:31.000,2025-04-06 01:14:23.829
false,false,2521,2378,143,127,00:00:31.000,2025-04-06 01:13:53.814
false,false,2525,2382,143,253,00:00:32.000,2025-04-06 01:15:53.869
false,true,2525,2382,143,0,00:00:00.000,2025-04-06 01:16:23.883
false,true,2525,2382,143,0,00:00:00.000,2025-04-06 01:17:23.903
false,true,2525,2382,143,0,00:00:00.000,2025-04-06 01:16:53.890
false,true,2525,2382,143,0,00:00:00.000,2025-04-06 01:17:53.913
false,true,2525,2382,143,0,00:00:00.000,2025-04-06 01:18:23.927
false,true,2525,2382,143,0,00:00:00.000,2025-04-06 01:18:53.942
false,false,2526,2383,143,31,00:00:31.000,2025-04-06 01:19:23.957
false,false,2529,2386,143,124,00:00:31.000,2025-04-06 01:20:53.988
false,false,2528,2385,143,93,00:00:31.000,2025-04-06 01:20:23.982
false,false,2530,2387,143,155,00:00:31.000,2025-04-06 01:21:24.001
false,false,2527,2384,143,62,00:00:31.000,2025-04-06 01:19:53.972
false,false,2531,2388,143,187,00:00:32.000,2025-04-06 01:21:54.015
false,false,2534,2391,143,282,00:00:30.000,2025-04-06 01:23:24.049
false,false,2533,2390,143,252,00:00:33.000,2025-04-06 01:22:54.036
false,false,2532,2389,143,219,00:00:32.000,2025-04-06 01:22:24.030
false,false,2535,2392,143,314,00:00:32.000,2025-04-06 01:23:54.059
false,false,2536,2392,144,346,00:00:32.000,2025-04-06 01:24:24.074
false,false,2537,2393,144,376,00:00:30.000,2025-04-06 01:24:54.079
false,false,2540,2396,144,467,00:00:30.000,2025-04-06 01:26:24.115
false,false,2538,2394,144,406,00:00:30.000,2025-04-06 01:25:24.091
false,false,2539,2395,144,437,00:00:31.000,2025-04-06 01:25:54.103
false,false,2542,2398,144,528,00:00:31.000,2025-04-06 01:27:24.143
false,false,2541,2397,144,497,00:00:30.000,2025-04-06 01:26:54.129
false,false,2543,2399,144,559,00:00:31.000,2025-04-06 01:27:54.157
false,false,2546,2402,144,652,00:00:32.000,2025-04-06 01:29:24.200
false,false,2545,2401,144,620,00:00:30.000,2025-04-06 01:28:54.188
false,false,2544,2400,144,590,00:00:31.000,2025-04-06 01:28:24.173
false,false,2547,2403,144,683,00:00:31.000,2025-04-06 01:29:54.211
false,false,2549,2405,144,743,00:00:30.000,2025-04-06 01:30:54.239
false,false,2548,2404,144,713,00:00:30.000,2025-04-06 01:30:24.224
false,false,2550,2406,144,773,00:00:30.000,2025-04-06 01:31:24.247
false,false,2552,2407,145,834,00:00:31.000,2025-04-06 01:32:24.274
false,false,2553,2408,145,866,00:00:32.000,2025-04-06 01:32:54.288
false,false,2551,2407,144,803,00:00:30.000,2025-04-06 01:31:54.262
false,false,2554,2409,145,896,00:00:30.000,2025-04-06 01:33:24.299
false,false,2555,2410,145,927,00:00:31.000,2025-04-06 01:33:54.306
false,false,2558,2413,145,1021,00:00:30.000,2025-04-06 01:35:24.342
false,false,2556,2411,145,960,00:00:33.000,2025-04-06 01:34:24.320
false,true,2558,2413,145,0,00:00:00.000,2025-04-06 01:35:54.351
false,false,2557,2412,145,991,00:00:31.000,2025-04-06 01:34:54.330
false,true,2558,2413,145,0,00:00:00.000,2025-04-06 01:37:54.405
false,true,2558,2413,145,0,00:00:00.000,2025-04-06 01:36:24.365
false,true,2558,2413,145,0,00:00:00.000,2025-04-06 01:36:54.377
false,true,2558,2413,145,0,00:00:00.000,2025-04-06 01:38:24.416
false,false,2559,2414,145,33,00:00:33.000,2025-04-06 01:38:54.429
false,true,2558,2413,145,0,00:00:00.000,2025-04-06 01:37:24.392
false,false,2562,2417,145,129,00:00:32.000,2025-04-06 01:40:24.464
false,false,2560,2415,145,66,00:00:33.000,2025-04-06 01:39:24.441
false,false,2561,2416,145,97,00:00:31.000,2025-04-06 01:39:54.451
false,false,2564,2419,145,191,00:00:32.000,2025-04-06 01:41:24.489
false,false,2563,2418,145,159,00:00:30.000,2025-04-06 01:40:54.479
false,false,2568,2423,145,321,00:00:33.000,2025-04-06 01:43:24.531
false,false,2565,2420,145,224,00:00:33.000,2025-04-06 01:41:54.499
false,false,2566,2421,145,256,00:00:32.000,2025-04-06 01:42:24.510
false,false,2570,2425,145,383,00:00:30.000,2025-04-06 01:44:24.548
false,false,2569,2424,145,353,00:00:32.000,2025-04-06 01:43:54.543
false,false,2567,2422,145,288,00:00:32.000,2025-04-06 01:42:54.521
false,false,2571,2426,145,413,00:00:30.000,2025-04-06 01:44:54.562
false,false,2572,2427,145,444,00:00:31.000,2025-04-06 01:45:24.575
false,false,2573,2427,146,474,00:00:30.000,2025-04-06 01:45:54.586
false,true,2573,2427,146,0,00:00:00.000,2025-04-06 01:46:54.605
false,true,2573,2427,146,0,00:00:00.000,2025-04-06 01:47:24.619
false,true,2573,2427,146,0,00:00:00.000,2025-04-06 01:46:24.598
false,true,2573,2427,146,0,00:00:00.000,2025-04-06 01:47:54.634
false,true,2573,2427,146,0,00:00:00.000,2025-04-06 01:48:24.644
false,true,2573,2427,146,0,00:00:00.000,2025-04-06 01:48:54.657
false,false,2574,2428,146,30,00:00:30.000,2025-04-06 01:49:24.667
false,false,2575,2429,146,61,00:00:31.000,2025-04-06 01:49:54.680
